pickuptime,precip_in,Month,Hour,Day,holiday,green,yellow,total
2014-01-01 00:00:00-05:00,0,1,0,2,1,2595,30887,33482
2014-01-01 01:00:00-05:00,0,1,1,2,1,2630,33650,36280
2014-01-01 02:00:00-05:00,0,1,2,2,1,2409,30745,33154
2014-01-01 03:00:00-05:00,0,1,3,2,1,2276,26244,28520
2014-01-01 04:00:00-05:00,0,1,4,2,1,1911,18792,20703
2014-01-01 05:00:00-05:00,0,1,5,2,1,1329,11009,12338
2014-01-01 06:00:00-05:00,0,1,6,2,1,836,7995,8831
2014-01-01 07:00:00-05:00,0,1,7,2,1,502,6927,7429
2014-01-01 08:00:00-05:00,0,1,8,2,1,323,6230,6553
2014-01-01 09:00:00-05:00,0,1,9,2,1,300,7961,8261
2014-01-01 10:00:00-05:00,0,1,10,2,1,337,11281,11618
2014-01-01 11:00:00-05:00,0,1,11,2,1,412,15397,15809
2014-01-01 12:00:00-05:00,0,1,12,2,1,533,18698,19231
2014-01-01 13:00:00-05:00,0,1,13,2,1,565,20220,20785
2014-01-01 14:00:00-05:00,0,1,14,2,1,697,21111,21808
2014-01-01 15:00:00-05:00,0,1,15,2,1,839,20550,21389
2014-01-01 16:00:00-05:00,0,1,16,2,1,978,18069,19047
2014-01-01 17:00:00-05:00,0,1,17,2,1,986,19612,20598
2014-01-01 18:00:00-05:00,0,1,18,2,1,1052,20185,21237
2014-01-01 19:00:00-05:00,0,1,19,2,1,988,19137,20125
2014-01-01 20:00:00-05:00,0,1,20,2,1,932,15964,16896
2014-01-01 21:00:00-05:00,0,1,21,2,1,806,15016,15822
2014-01-01 22:00:00-05:00,0,1,22,2,1,715,14316,15031
2014-01-01 23:00:00-05:00,0,1,23,2,1,657,10814,11471
2014-01-02 00:00:00-05:00,0,1,0,3,0,491,7863,8354
2014-01-02 01:00:00-05:00,0,1,1,3,0,307,4871,5178
2014-01-02 02:00:00-05:00,0,1,2,3,0,208,3210,3418
2014-01-02 03:00:00-05:00,0,1,3,3,0,156,2203,2359
2014-01-02 04:00:00-05:00,0,1,4,3,0,161,2372,2533
2014-01-02 05:00:00-05:00,0.01,1,5,3,0,130,3748,3878
2014-01-02 06:00:00-05:00,0,1,6,3,0,234,8962,9196
2014-01-02 07:00:00-05:00,0,1,7,3,0,627,15047,15674
2014-01-02 08:00:00-05:00,0,1,8,3,0,1031,19893,20924
2014-01-02 09:00:00-05:00,0,1,9,3,0,1012,20271,21283
2014-01-02 10:00:00-05:00,0,1,10,3,0,934,18601,19535
2014-01-02 11:00:00-05:00,0,1,11,3,0,942,19578,20520
2014-01-02 12:00:00-05:00,0,1,12,3,0,982,21101,22083
2014-01-02 13:00:00-05:00,0,1,13,3,0,1076,21638,22714
2014-01-02 14:00:00-05:00,0,1,14,3,0,1213,22154,23367
2014-01-02 15:00:00-05:00,0,1,15,3,0,1311,21220,22531
2014-01-02 16:00:00-05:00,0,1,16,3,0,1463,18545,20008
2014-01-02 17:00:00-05:00,0,1,17,3,0,1481,22310,23791
2014-01-02 18:00:00-05:00,0,1,18,3,0,1567,25957,27524
2014-01-02 19:00:00-05:00,0,1,19,3,0,1431,24907,26338
2014-01-02 20:00:00-05:00,0.03,1,20,3,0,906,18258,19164
2014-01-02 21:00:00-05:00,0.05,1,21,3,0,617,14882,15499
2014-01-02 22:00:00-05:00,0.04,1,22,3,0,426,12641,13067
2014-01-02 23:00:00-05:00,0.04,1,23,3,0,355,9726,10081
2014-01-03 00:00:00-05:00,0.04,1,0,4,0,240,7077,7317
2014-01-03 01:00:00-05:00,0.03,1,1,4,0,151,4553,4704
2014-01-03 02:00:00-05:00,0.03,1,2,4,0,96,3037,3133
2014-01-03 03:00:00-05:00,0.01,1,3,4,0,54,1912,1966
2014-01-03 04:00:00-05:00,0.02,1,4,4,0,41,1288,1329
2014-01-03 05:00:00-05:00,0.01,1,5,4,0,22,1183,1205
2014-01-03 06:00:00-05:00,0,1,6,4,0,38,2009,2047
2014-01-03 07:00:00-05:00,0,1,7,4,0,100,3714,3814
2014-01-03 08:00:00-05:00,0,1,8,4,0,174,5845,6019
2014-01-03 09:00:00-05:00,0,1,9,4,0,278,7953,8231
2014-01-03 10:00:00-05:00,0,1,10,4,0,333,9631,9964
2014-01-03 11:00:00-05:00,0,1,11,4,0,419,10681,11100
2014-01-03 12:00:00-05:00,0,1,12,4,0,491,11541,12032
2014-01-03 13:00:00-05:00,0,1,13,4,0,583,11454,12037
2014-01-03 14:00:00-05:00,0,1,14,4,0,673,14586,15259
2014-01-03 15:00:00-05:00,0,1,15,4,0,901,15879,16780
2014-01-03 16:00:00-05:00,0,1,16,4,0,1035,15174,16209
2014-01-03 17:00:00-05:00,0,1,17,4,0,1071,18541,19612
2014-01-03 18:00:00-05:00,0,1,18,4,0,1197,23243,24440
2014-01-03 19:00:00-05:00,0,1,19,4,0,1225,24333,25558
2014-01-03 20:00:00-05:00,0,1,20,4,0,1164,20784,21948
2014-01-03 21:00:00-05:00,0,1,21,4,0,1115,19660,20775
2014-01-03 22:00:00-05:00,0,1,22,4,0,1052,21470,22522
2014-01-03 23:00:00-05:00,0,1,23,4,0,983,19922,20905
2014-01-04 00:00:00-05:00,0,1,0,5,0,872,18324,19196
2014-01-04 01:00:00-05:00,0,1,1,5,0,706,14908,15614
2014-01-04 02:00:00-05:00,0,1,2,5,0,513,11234,11747
2014-01-04 03:00:00-05:00,0,1,3,5,0,430,8036,8466
2014-01-04 04:00:00-05:00,0,1,4,5,0,335,5710,6045
2014-01-04 05:00:00-05:00,0,1,5,5,0,219,3104,3323
2014-01-04 06:00:00-05:00,0,1,6,5,0,190,3874,4064
2014-01-04 07:00:00-05:00,0,1,7,5,0,325,5425,5750
2014-01-04 08:00:00-05:00,0,1,8,5,0,463,8464,8927
2014-01-04 09:00:00-05:00,0,1,9,5,0,599,13160,13759
2014-01-04 10:00:00-05:00,0,1,10,5,0,746,16774,17520
2014-01-04 11:00:00-05:00,0,1,11,5,0,865,19804,20669
2014-01-04 12:00:00-05:00,0,1,12,5,0,977,22029,23006
2014-01-04 13:00:00-05:00,0,1,13,5,0,1024,22516,23540
2014-01-04 14:00:00-05:00,0,1,14,5,0,1107,21555,22662
2014-01-04 15:00:00-05:00,0,1,15,5,0,1308,22902,24210
2014-01-04 16:00:00-05:00,0,1,16,5,0,1480,20261,21741
2014-01-04 17:00:00-05:00,0,1,17,5,0,1502,22273,23775
2014-01-04 18:00:00-05:00,0,1,18,5,0,1719,26890,28609
2014-01-04 19:00:00-05:00,0,1,19,5,0,1764,28526,30290
2014-01-04 20:00:00-05:00,0,1,20,5,0,1726,24763,26489
2014-01-04 21:00:00-05:00,0,1,21,5,0,1657,23293,24950
2014-01-04 22:00:00-05:00,0,1,22,5,0,1586,25827,27413
2014-01-04 23:00:00-05:00,0,1,23,5,0,1584,27847,29431
2014-01-05 00:00:00-05:00,0,1,0,6,0,1432,26052,27484
2014-01-05 01:00:00-05:00,0,1,1,6,0,1250,22375,23625
2014-01-05 02:00:00-05:00,0,1,2,6,0,1055,18742,19797
2014-01-05 03:00:00-05:00,0,1,3,6,0,918,14041,14959
2014-01-05 04:00:00-05:00,0,1,4,6,0,698,9023,9721
2014-01-05 05:00:00-05:00,0,1,5,6,0,361,4231,4592
2014-01-05 06:00:00-05:00,0,1,6,6,0,227,4025,4252
2014-01-05 07:00:00-05:00,0,1,7,6,0,261,4937,5198
2014-01-05 08:00:00-05:00,0,1,8,6,0,363,7677,8040
2014-01-05 09:00:00-05:00,0.03,1,9,6,0,492,12309,12801
2014-01-05 10:00:00-05:00,0.03,1,10,6,0,664,18364,19028
2014-01-05 11:00:00-05:00,0.01,1,11,6,0,778,22139,22917
2014-01-05 12:00:00-05:00,0.02,1,12,6,0,853,24705,25558
2014-01-05 13:00:00-05:00,0,1,13,6,0,957,22622,23579
2014-01-05 14:00:00-05:00,0,1,14,6,0,1003,22145,23148
2014-01-05 15:00:00-05:00,0,1,15,6,0,1160,20949,22109
2014-01-05 16:00:00-05:00,0,1,16,6,0,1191,19589,20780
2014-01-05 17:00:00-05:00,0,1,17,6,0,1253,20312,21565
2014-01-05 18:00:00-05:00,0,1,18,6,0,1202,21158,22360
2014-01-05 19:00:00-05:00,0,1,19,6,0,1090,18525,19615
2014-01-05 20:00:00-05:00,0,1,20,6,0,1059,17190,18249
2014-01-05 21:00:00-05:00,0.01,1,21,6,0,908,14691,15599
2014-01-05 22:00:00-05:00,0,1,22,6,0,804,12816,13620
2014-01-05 23:00:00-05:00,0,1,23,6,0,581,9925,10506
2014-01-06 00:00:00-05:00,0.03,1,0,0,0,484,7616,8100
2014-01-06 01:00:00-05:00,0.02,1,1,0,0,319,5015,5334
2014-01-06 02:00:00-05:00,0.01,1,2,0,0,206,3717,3923
2014-01-06 03:00:00-05:00,0,1,3,0,0,166,2533,2699
2014-01-06 04:00:00-05:00,0,1,4,0,0,191,2782,2973
2014-01-06 05:00:00-05:00,0,1,5,0,0,188,4522,4710
2014-01-06 06:00:00-05:00,0.01,1,6,0,0,264,11297,11561
2014-01-06 07:00:00-05:00,0.02,1,7,0,0,779,20742,21521
2014-01-06 08:00:00-05:00,0.06,1,8,0,0,1305,25428,26733
2014-01-06 09:00:00-05:00,0.06,1,9,0,0,1161,23213,24374
2014-01-06 10:00:00-05:00,0.08,1,10,0,0,954,19520,20474
2014-01-06 11:00:00-05:00,0,1,11,0,0,841,18027,18868
2014-01-06 12:00:00-05:00,0.01,1,12,0,0,930,19836,20766
2014-01-06 13:00:00-05:00,0.01,1,13,0,0,957,19476,20433
2014-01-06 14:00:00-05:00,0,1,14,0,0,1089,19920,21009
2014-01-06 15:00:00-05:00,0,1,15,0,0,1186,20115,21301
2014-01-06 16:00:00-05:00,0,1,16,0,0,1370,18039,19409
2014-01-06 17:00:00-05:00,0,1,17,0,0,1422,22210,23632
2014-01-06 18:00:00-05:00,0,1,18,0,0,1457,27274,28731
2014-01-06 19:00:00-05:00,0,1,19,0,0,1376,26509,27885
2014-01-06 20:00:00-05:00,0,1,20,0,0,1268,23547,24815
2014-01-06 21:00:00-05:00,0,1,21,0,0,1022,21056,22078
2014-01-06 22:00:00-05:00,0,1,22,0,0,917,19277,20194
2014-01-06 23:00:00-05:00,0,1,23,0,0,754,13774,14528
2014-01-07 00:00:00-05:00,0,1,0,1,0,689,11768,12457
2014-01-07 01:00:00-05:00,0,1,1,1,0,394,6085,6479
2014-01-07 02:00:00-05:00,0,1,2,1,0,236,3899,4135
2014-01-07 03:00:00-05:00,0,1,3,1,0,164,2675,2839
2014-01-07 04:00:00-05:00,0,1,4,1,0,172,2639,2811
2014-01-07 05:00:00-05:00,0,1,5,1,0,178,4244,4422
2014-01-07 06:00:00-05:00,0,1,6,1,0,281,12486,12767
2014-01-07 07:00:00-05:00,0,1,7,1,0,814,23458,24272
2014-01-07 08:00:00-05:00,0,1,8,1,0,1354,28949,30303
2014-01-07 09:00:00-05:00,0,1,9,1,0,1205,27184,28389
2014-01-07 10:00:00-05:00,0,1,10,1,0,1069,22697,23766
2014-01-07 11:00:00-05:00,0,1,11,1,0,997,21341,22338
2014-01-07 12:00:00-05:00,0,1,12,1,0,1015,22163,23178
2014-01-07 13:00:00-05:00,0,1,13,1,0,945,21259,22204
2014-01-07 14:00:00-05:00,0,1,14,1,0,1094,23401,24495
2014-01-07 15:00:00-05:00,0,1,15,1,0,1347,24224,25571
2014-01-07 16:00:00-05:00,0,1,16,1,0,1581,20358,21939
2014-01-07 17:00:00-05:00,0,1,17,1,0,1748,25013,26761
2014-01-07 18:00:00-05:00,0,1,18,1,0,1773,31508,33281
2014-01-07 19:00:00-05:00,0,1,19,1,0,1569,31022,32591
2014-01-07 20:00:00-05:00,0,1,20,1,0,1334,27917,29251
2014-01-07 21:00:00-05:00,0,1,21,1,0,1088,26674,27762
2014-01-07 22:00:00-05:00,0,1,22,1,0,975,22959,23934
2014-01-07 23:00:00-05:00,0,1,23,1,0,697,16129,16826
2014-01-08 00:00:00-05:00,0,1,0,2,0,498,9894,10392
2014-01-08 01:00:00-05:00,0,1,1,2,0,309,5662,5971
2014-01-08 02:00:00-05:00,0,1,2,2,0,176,3630,3806
2014-01-08 03:00:00-05:00,0,1,3,2,0,154,2437,2591
2014-01-08 04:00:00-05:00,0,1,4,2,0,159,2412,2571
2014-01-08 05:00:00-05:00,0,1,5,2,0,150,4128,4278
2014-01-08 06:00:00-05:00,0,1,6,2,0,302,12404,12706
2014-01-08 07:00:00-05:00,0,1,7,2,0,827,23656,24483
2014-01-08 08:00:00-05:00,0,1,8,2,0,1308,29502,30810
2014-01-08 09:00:00-05:00,0,1,9,2,0,1212,27715,28927
2014-01-08 10:00:00-05:00,0,1,10,2,0,1027,23628,24655
2014-01-08 11:00:00-05:00,0,1,11,2,0,970,22668,23638
2014-01-08 12:00:00-05:00,0,1,12,2,0,1018,23716,24734
2014-01-08 13:00:00-05:00,0,1,13,2,0,1000,22731,23731
2014-01-08 14:00:00-05:00,0,1,14,2,0,1221,24336,25557
2014-01-08 15:00:00-05:00,0,1,15,2,0,1431,24377,25808
2014-01-08 16:00:00-05:00,0,1,16,2,0,1493,19776,21269
2014-01-08 17:00:00-05:00,0,1,17,2,0,1599,24603,26202
2014-01-08 18:00:00-05:00,0,1,18,2,0,1655,31090,32745
2014-01-08 19:00:00-05:00,0,1,19,2,0,1571,32232,33803
2014-01-08 20:00:00-05:00,0,1,20,2,0,1417,29856,31273
2014-01-08 21:00:00-05:00,0,1,21,2,0,1231,28629,29860
2014-01-08 22:00:00-05:00,0,1,22,2,0,1011,26080,27091
2014-01-08 23:00:00-05:00,0,1,23,2,0,840,18449,19289
2014-01-09 00:00:00-05:00,0,1,0,3,0,702,12381,13083
2014-01-09 01:00:00-05:00,0,1,1,3,0,407,7392,7799
2014-01-09 02:00:00-05:00,0,1,2,3,0,277,4672,4949
2014-01-09 03:00:00-05:00,0,1,3,3,0,216,3182,3398
2014-01-09 04:00:00-05:00,0,1,4,3,0,215,2835,3050
2014-01-09 05:00:00-05:00,0,1,5,3,0,188,4190,4378
2014-01-09 06:00:00-05:00,0,1,6,3,0,330,12215,12545
2014-01-09 07:00:00-05:00,0,1,7,3,0,853,23379,24232
2014-01-09 08:00:00-05:00,0,1,8,3,0,1217,28665,29882
2014-01-09 09:00:00-05:00,0,1,9,3,0,1218,26532,27750
2014-01-09 10:00:00-05:00,0,1,10,3,0,1032,22496,23528
2014-01-09 11:00:00-05:00,0,1,11,3,0,1006,21552,22558
2014-01-09 12:00:00-05:00,0,1,12,3,0,958,22726,23684
2014-01-09 13:00:00-05:00,0,1,13,3,0,965,21996,22961
2014-01-09 14:00:00-05:00,0,1,14,3,0,1127,23919,25046
2014-01-09 15:00:00-05:00,0,1,15,3,0,1281,23532,24813
2014-01-09 16:00:00-05:00,0,1,16,3,0,1501,18554,20055
2014-01-09 17:00:00-05:00,0,1,17,3,0,1598,23137,24735
2014-01-09 18:00:00-05:00,0,1,18,3,0,1698,30459,32157
2014-01-09 19:00:00-05:00,0,1,19,3,0,1659,32099,33758
2014-01-09 20:00:00-05:00,0,1,20,3,0,1484,30733,32217
2014-01-09 21:00:00-05:00,0,1,21,3,0,1319,30452,31771
2014-01-09 22:00:00-05:00,0,1,22,3,0,1200,28932,30132
2014-01-09 23:00:00-05:00,0,1,23,3,0,1032,23684,24716
2014-01-10 00:00:00-05:00,0,1,0,4,0,839,16876,17715
2014-01-10 01:00:00-05:00,0,1,1,4,0,558,10607,11165
2014-01-10 02:00:00-05:00,0,1,2,4,0,335,6967,7302
2014-01-10 03:00:00-05:00,0,1,3,4,0,283,4774,5057
2014-01-10 04:00:00-05:00,0,1,4,4,0,226,4013,4239
2014-01-10 05:00:00-05:00,0,1,5,4,0,198,4527,4725
2014-01-10 06:00:00-05:00,0,1,6,4,0,279,11744,12023
2014-01-10 07:00:00-05:00,0,1,7,4,0,819,22338,23157
2014-01-10 08:00:00-05:00,0,1,8,4,0,1247,27311,28558
2014-01-10 09:00:00-05:00,0.05,1,9,4,0,1263,26141,27404
2014-01-10 10:00:00-05:00,0.05,1,10,4,0,1116,23198,24314
2014-01-10 11:00:00-05:00,0,1,11,4,0,1029,22118,23147
2014-01-10 12:00:00-05:00,0,1,12,4,0,934,22522,23456
2014-01-10 13:00:00-05:00,0,1,13,4,0,990,23047,24037
2014-01-10 14:00:00-05:00,0,1,14,4,0,1218,25242,26460
2014-01-10 15:00:00-05:00,0.01,1,15,4,0,1534,23100,24634
2014-01-10 16:00:00-05:00,0,1,16,4,0,1621,18294,19915
2014-01-10 17:00:00-05:00,0.01,1,17,4,0,1796,23495,25291
2014-01-10 18:00:00-05:00,0,1,18,4,0,1911,30513,32424
2014-01-10 19:00:00-05:00,0,1,19,4,0,2054,34070,36124
2014-01-10 20:00:00-05:00,0.01,1,20,4,0,1915,32414,34329
2014-01-10 21:00:00-05:00,0,1,21,4,0,1794,30650,32444
2014-01-10 22:00:00-05:00,0.01,1,22,4,0,1784,31489,33273
2014-01-10 23:00:00-05:00,0,1,23,4,0,1810,32282,34092
2014-01-11 00:00:00-05:00,0.01,1,0,5,0,1641,28766,30407
2014-01-11 01:00:00-05:00,0.01,1,1,5,0,1408,24570,25978
2014-01-11 02:00:00-05:00,0.05,1,2,5,0,1129,20828,21957
2014-01-11 03:00:00-05:00,0,1,3,5,0,915,14668,15583
2014-01-11 04:00:00-05:00,0,1,4,5,0,730,9268,9998
2014-01-11 05:00:00-05:00,0.01,1,5,5,0,323,4475,4798
2014-01-11 06:00:00-05:00,0,1,6,5,0,233,4757,4990
2014-01-11 07:00:00-05:00,0.02,1,7,5,0,356,7191,7547
2014-01-11 08:00:00-05:00,0.01,1,8,5,0,506,10790,11296
2014-01-11 09:00:00-05:00,0.01,1,9,5,0,698,16232,16930
2014-01-11 10:00:00-05:00,0.01,1,10,5,0,793,20110,20903
2014-01-11 11:00:00-05:00,0,1,11,5,0,977,22020,22997
2014-01-11 12:00:00-05:00,0.01,1,12,5,0,1082,25615,26697
2014-01-11 13:00:00-05:00,0.06,1,13,5,0,1189,25521,26710
2014-01-11 14:00:00-05:00,0,1,14,5,0,1286,23612,24898
2014-01-11 15:00:00-05:00,0,1,15,5,0,1416,25155,26571
2014-01-11 16:00:00-05:00,0.05,1,16,5,0,1626,22718,24344
2014-01-11 17:00:00-05:00,0.1,1,17,5,0,1921,27328,29249
2014-01-11 18:00:00-05:00,0.12,1,18,5,0,2125,32681,34806
2014-01-11 19:00:00-05:00,0.03,1,19,5,0,2033,31787,33820
2014-01-11 20:00:00-05:00,0.01,1,20,5,0,1875,26615,28490
2014-01-11 21:00:00-05:00,0,1,21,5,0,1838,25244,27082
2014-01-11 22:00:00-05:00,0,1,22,5,0,1773,28682,30455
2014-01-11 23:00:00-05:00,0,1,23,5,0,1926,32539,34465
2014-01-12 00:00:00-05:00,0.02,1,0,6,0,1836,31971,33807
2014-01-12 01:00:00-05:00,0,1,1,6,0,1613,27394,29007
2014-01-12 02:00:00-05:00,0,1,2,6,0,1452,23358,24810
2014-01-12 03:00:00-05:00,0,1,3,6,0,1198,17957,19155
2014-01-12 04:00:00-05:00,0,1,4,6,0,908,10903,11811
2014-01-12 05:00:00-05:00,0,1,5,6,0,399,4749,5148
2014-01-12 06:00:00-05:00,0,1,6,6,0,270,4477,4747
2014-01-12 07:00:00-05:00,0,1,7,6,0,287,5440,5727
2014-01-12 08:00:00-05:00,0,1,8,6,0,401,8577,8978
2014-01-12 09:00:00-05:00,0,1,9,6,0,530,12843,13373
2014-01-12 10:00:00-05:00,0,1,10,6,0,690,18535,19225
2014-01-12 11:00:00-05:00,0,1,11,6,0,805,22374,23179
2014-01-12 12:00:00-05:00,0,1,12,6,0,924,25372,26296
2014-01-12 13:00:00-05:00,0,1,13,6,0,998,25058,26056
2014-01-12 14:00:00-05:00,0,1,14,6,0,1154,24526,25680
2014-01-12 15:00:00-05:00,0,1,15,6,0,1230,23578,24808
2014-01-12 16:00:00-05:00,0,1,16,6,0,1315,22391,23706
2014-01-12 17:00:00-05:00,0,1,17,6,0,1383,24652,26035
2014-01-12 18:00:00-05:00,0,1,18,6,0,1414,25673,27087
2014-01-12 19:00:00-05:00,0,1,19,6,0,1368,22097,23465
2014-01-12 20:00:00-05:00,0,1,20,6,0,1267,19278,20545
2014-01-12 21:00:00-05:00,0,1,21,6,0,1083,17977,19060
2014-01-12 22:00:00-05:00,0,1,22,6,0,981,16212,17193
2014-01-12 23:00:00-05:00,0,1,23,6,0,880,15095,15975
2014-01-13 00:00:00-05:00,0,1,0,0,0,647,8798,9445
2014-01-13 01:00:00-05:00,0,1,1,0,0,402,5340,5742
2014-01-13 02:00:00-05:00,0,1,2,0,0,263,3627,3890
2014-01-13 03:00:00-05:00,0,1,3,0,0,227,2636,2863
2014-01-13 04:00:00-05:00,0,1,4,0,0,265,2806,3071
2014-01-13 05:00:00-05:00,0,1,5,0,0,167,4556,4723
2014-01-13 06:00:00-05:00,0,1,6,0,0,323,11774,12097
2014-01-13 07:00:00-05:00,0,1,7,0,0,766,21956,22722
2014-01-13 08:00:00-05:00,0,1,8,0,0,1171,25564,26735
2014-01-13 09:00:00-05:00,0,1,9,0,0,1102,23744,24846
2014-01-13 10:00:00-05:00,0,1,10,0,0,1003,20059,21062
2014-01-13 11:00:00-05:00,0,1,11,0,0,977,19506,20483
2014-01-13 12:00:00-05:00,0,1,12,0,0,963,20367,21330
2014-01-13 13:00:00-05:00,0,1,13,0,0,1000,19971,20971
2014-01-13 14:00:00-05:00,0,1,14,0,0,1120,21832,22952
2014-01-13 15:00:00-05:00,0,1,15,0,0,1173,21535,22708
2014-01-13 16:00:00-05:00,0,1,16,0,0,1320,19349,20669
2014-01-13 17:00:00-05:00,0,1,17,0,0,1409,23819,25228
2014-01-13 18:00:00-05:00,0,1,18,0,0,1506,29049,30555
2014-01-13 19:00:00-05:00,0,1,19,0,0,1370,28676,30046
2014-01-13 20:00:00-05:00,0,1,20,0,0,1143,25220,26363
2014-01-13 21:00:00-05:00,0,1,21,0,0,940,23207,24147
2014-01-13 22:00:00-05:00,0,1,22,0,0,826,21068,21894
2014-01-13 23:00:00-05:00,0,1,23,0,0,770,15239,16009
2014-01-14 00:00:00-05:00,0,1,0,1,0,582,10164,10746
2014-01-14 01:00:00-05:00,0,1,1,1,0,418,6100,6518
2014-01-14 02:00:00-05:00,0,1,2,1,0,226,3912,4138
2014-01-14 03:00:00-05:00,0,1,3,1,0,175,2571,2746
2014-01-14 04:00:00-05:00,0.01,1,4,1,0,223,2458,2681
2014-01-14 05:00:00-05:00,0.01,1,5,1,0,173,4055,4228
2014-01-14 06:00:00-05:00,0,1,6,1,0,315,11649,11964
2014-01-14 07:00:00-05:00,0.02,1,7,1,0,877,23317,24194
2014-01-14 08:00:00-05:00,0.02,1,8,1,0,1332,27967,29299
2014-01-14 09:00:00-05:00,0.03,1,9,1,0,1217,26133,27350
2014-01-14 10:00:00-05:00,0.01,1,10,1,0,1114,22502,23616
2014-01-14 11:00:00-05:00,0.02,1,11,1,0,1018,22035,23053
2014-01-14 12:00:00-05:00,0.02,1,12,1,0,1015,22715,23730
2014-01-14 13:00:00-05:00,0.05,1,13,1,0,1037,23497,24534
2014-01-14 14:00:00-05:00,0.08,1,14,1,0,1259,25229,26488
2014-01-14 15:00:00-05:00,0.06,1,15,1,0,1329,22812,24141
2014-01-14 16:00:00-05:00,0.01,1,16,1,0,1423,18072,19495
2014-01-14 17:00:00-05:00,0.04,1,17,1,0,1582,22618,24200
2014-01-14 18:00:00-05:00,0,1,18,1,0,1534,29254,30788
2014-01-14 19:00:00-05:00,0,1,19,1,0,1473,30060,31533
2014-01-14 20:00:00-05:00,0,1,20,1,0,1164,27853,29017
2014-01-14 21:00:00-05:00,0,1,21,1,0,1011,27598,28609
2014-01-14 22:00:00-05:00,0,1,22,1,0,848,24438,25286
2014-01-14 23:00:00-05:00,0,1,23,1,0,707,17099,17806
2014-01-15 00:00:00-05:00,0,1,0,2,0,576,11284,11860
2014-01-15 01:00:00-05:00,0,1,1,2,0,335,6817,7152
2014-01-15 02:00:00-05:00,0,1,2,2,0,209,4625,4834
2014-01-15 03:00:00-05:00,0,1,3,2,0,200,3066,3266
2014-01-15 04:00:00-05:00,0,1,4,2,0,203,3046,3249
2014-01-15 05:00:00-05:00,0,1,5,2,0,173,4487,4660
2014-01-15 06:00:00-05:00,0,1,6,2,0,334,12402,12736
2014-01-15 07:00:00-05:00,0,1,7,2,0,847,23287,24134
2014-01-15 08:00:00-05:00,0,1,8,2,0,1353,27006,28359
2014-01-15 09:00:00-05:00,0,1,9,2,0,1270,26099,27369
2014-01-15 10:00:00-05:00,0,1,10,2,0,1097,23044,24141
2014-01-15 11:00:00-05:00,0,1,11,2,0,1006,22029,23035
2014-01-15 12:00:00-05:00,0,1,12,2,0,1054,22543,23597
2014-01-15 13:00:00-05:00,0,1,13,2,0,1053,21930,22983
2014-01-15 14:00:00-05:00,0,1,14,2,0,1156,23008,24164
2014-01-15 15:00:00-05:00,0,1,15,2,0,1324,22089,23413
2014-01-15 16:00:00-05:00,0,1,16,2,0,1486,17759,19245
2014-01-15 17:00:00-05:00,0,1,17,2,0,1796,23941,25737
2014-01-15 18:00:00-05:00,0,1,18,2,0,1883,29722,31605
2014-01-15 19:00:00-05:00,0,1,19,2,0,1726,30316,32042
2014-01-15 20:00:00-05:00,0,1,20,2,0,1535,30106,31641
2014-01-15 21:00:00-05:00,0,1,21,2,0,1293,29906,31199
2014-01-15 22:00:00-05:00,0,1,22,2,0,1142,26863,28005
2014-01-15 23:00:00-05:00,0,1,23,2,0,942,21068,22010
2014-01-16 00:00:00-05:00,0,1,0,3,0,717,14080,14797
2014-01-16 01:00:00-05:00,0,1,1,3,0,511,7992,8503
2014-01-16 02:00:00-05:00,0,1,2,3,0,294,5076,5370
2014-01-16 03:00:00-05:00,0,1,3,3,0,238,3254,3492
2014-01-16 04:00:00-05:00,0,1,4,3,0,237,3181,3418
2014-01-16 05:00:00-05:00,0,1,5,3,0,186,4529,4715
2014-01-16 06:00:00-05:00,0,1,6,3,0,335,12316,12651
2014-01-16 07:00:00-05:00,0,1,7,3,0,887,22945,23832
2014-01-16 08:00:00-05:00,0,1,8,3,0,1352,26904,28256
2014-01-16 09:00:00-05:00,0,1,9,3,0,1380,25710,27090
2014-01-16 10:00:00-05:00,0,1,10,3,0,1175,22211,23386
2014-01-16 11:00:00-05:00,0,1,11,3,0,1044,21661,22705
2014-01-16 12:00:00-05:00,0,1,12,3,0,1080,22801,23881
2014-01-16 13:00:00-05:00,0,1,13,3,0,1155,22269,23424
2014-01-16 14:00:00-05:00,0,1,14,3,0,1333,24160,25493
2014-01-16 15:00:00-05:00,0,1,15,3,0,1420,22411,23831
2014-01-16 16:00:00-05:00,0,1,16,3,0,1555,18071,19626
2014-01-16 17:00:00-05:00,0,1,17,3,0,1724,23091,24815
2014-01-16 18:00:00-05:00,0,1,18,3,0,1866,30589,32455
2014-01-16 19:00:00-05:00,0,1,19,3,0,1829,31915,33744
2014-01-16 20:00:00-05:00,0,1,20,3,0,1600,30719,32319
2014-01-16 21:00:00-05:00,0,1,21,3,0,1500,30895,32395
2014-01-16 22:00:00-05:00,0,1,22,3,0,1368,29917,31285
2014-01-16 23:00:00-05:00,0,1,23,3,0,1217,25340,26557
2014-01-17 00:00:00-05:00,0,1,0,4,0,935,18503,19438
2014-01-17 01:00:00-05:00,0,1,1,4,0,653,11719,12372
2014-01-17 02:00:00-05:00,0,1,2,4,0,407,7504,7911
2014-01-17 03:00:00-05:00,0,1,3,4,0,340,5149,5489
2014-01-17 04:00:00-05:00,0,1,4,4,0,331,4348,4679
2014-01-17 05:00:00-05:00,0,1,5,4,0,249,4787,5036
2014-01-17 06:00:00-05:00,0,1,6,4,0,379,11870,12249
2014-01-17 07:00:00-05:00,0,1,7,4,0,923,21848,22771
2014-01-17 08:00:00-05:00,0,1,8,4,0,1366,26550,27916
2014-01-17 09:00:00-05:00,0,1,9,4,0,1310,24727,26037
2014-01-17 10:00:00-05:00,0,1,10,4,0,1155,21921,23076
2014-01-17 11:00:00-05:00,0,1,11,4,0,1140,21520,22660
2014-01-17 12:00:00-05:00,0,1,12,4,0,1075,22610,23685
2014-01-17 13:00:00-05:00,0,1,13,4,0,1153,22605,23758
2014-01-17 14:00:00-05:00,0,1,14,4,0,1316,23940,25256
2014-01-17 15:00:00-05:00,0,1,15,4,0,1530,22170,23700
2014-01-17 16:00:00-05:00,0,1,16,4,0,1812,17877,19689
2014-01-17 17:00:00-05:00,0,1,17,4,0,1992,22628,24620
2014-01-17 18:00:00-05:00,0,1,18,4,0,2211,28167,30378
2014-01-17 19:00:00-05:00,0,1,19,4,0,2320,31066,33386
2014-01-17 20:00:00-05:00,0,1,20,4,0,2179,29802,31981
2014-01-17 21:00:00-05:00,0,1,21,4,0,2126,29079,31205
2014-01-17 22:00:00-05:00,0,1,22,4,0,2044,30144,32188
2014-01-17 23:00:00-05:00,0,1,23,4,0,2094,30318,32412
2014-01-18 00:00:00-05:00,0,1,0,5,0,1968,28555,30523
2014-01-18 01:00:00-05:00,0,1,1,5,0,1786,24130,25916
2014-01-18 02:00:00-05:00,0,1,2,5,0,1465,19963,21428
2014-01-18 03:00:00-05:00,0,1,3,5,0,1243,15588,16831
2014-01-18 04:00:00-05:00,0,1,4,5,0,944,10205,11149
2014-01-18 05:00:00-05:00,0,1,5,5,0,456,5159,5615
2014-01-18 06:00:00-05:00,0,1,6,5,0,348,4994,5342
2014-01-18 07:00:00-05:00,0,1,7,5,0,415,6645,7060
2014-01-18 08:00:00-05:00,0.01,1,8,5,0,587,10084,10671
2014-01-18 09:00:00-05:00,0.02,1,9,5,0,836,16709,17545
2014-01-18 10:00:00-05:00,0.1,1,10,5,0,999,20631,21630
2014-01-18 11:00:00-05:00,0.02,1,11,5,0,1012,21680,22692
2014-01-18 12:00:00-05:00,0,1,12,5,0,1113,24160,25273
2014-01-18 13:00:00-05:00,0,1,13,5,0,1244,23785,25029
2014-01-18 14:00:00-05:00,0,1,14,5,0,1286,22672,23958
2014-01-18 15:00:00-05:00,0,1,15,5,0,1541,23716,25257
2014-01-18 16:00:00-05:00,0,1,16,5,0,1797,22622,24419
2014-01-18 17:00:00-05:00,0,1,17,5,0,1948,25619,27567
2014-01-18 18:00:00-05:00,0,1,18,5,0,2236,29772,32008
2014-01-18 19:00:00-05:00,0,1,19,5,0,2393,31505,33898
2014-01-18 20:00:00-05:00,0,1,20,5,0,2361,28297,30658
2014-01-18 21:00:00-05:00,0,1,21,5,0,2337,27330,29667
2014-01-18 22:00:00-05:00,0,1,22,5,0,2357,30507,32864
2014-01-18 23:00:00-05:00,0,1,23,5,0,2315,32705,35020
2014-01-19 00:00:00-05:00,0,1,0,6,0,2278,31615,33893
2014-01-19 01:00:00-05:00,0,1,1,6,0,2095,27871,29966
2014-01-19 02:00:00-05:00,0,1,2,6,0,1787,24145,25932
2014-01-19 03:00:00-05:00,0,1,3,6,0,1490,18796,20286
2014-01-19 04:00:00-05:00,0,1,4,6,0,1180,11499,12679
2014-01-19 05:00:00-05:00,0,1,5,6,0,523,4971,5494
2014-01-19 06:00:00-05:00,0,1,6,6,0,296,4259,4555
2014-01-19 07:00:00-05:00,0,1,7,6,0,346,5233,5579
2014-01-19 08:00:00-05:00,0,1,8,6,0,384,7709,8093
2014-01-19 09:00:00-05:00,0,1,9,6,0,561,12178,12739
2014-01-19 10:00:00-05:00,0,1,10,6,0,693,17541,18234
2014-01-19 11:00:00-05:00,0,1,11,6,0,916,21294,22210
2014-01-19 12:00:00-05:00,0,1,12,6,0,1055,24004,25059
2014-01-19 13:00:00-05:00,0,1,13,6,0,1137,24147,25284
2014-01-19 14:00:00-05:00,0,1,14,6,0,1411,26567,27978
2014-01-19 15:00:00-05:00,0,1,15,6,0,1442,24018,25460
2014-01-19 16:00:00-05:00,0,1,16,6,0,1567,22765,24332
2014-01-19 17:00:00-05:00,0,1,17,6,0,1637,23388,25025
2014-01-19 18:00:00-05:00,0,1,18,6,0,1848,26953,28801
2014-01-19 19:00:00-05:00,0,1,19,6,0,1711,22330,24041
2014-01-19 20:00:00-05:00,0,1,20,6,0,1584,20576,22160
2014-01-19 21:00:00-05:00,0,1,21,6,0,1402,19071,20473
2014-01-19 22:00:00-05:00,0,1,22,6,0,1560,23223,24783
2014-01-19 23:00:00-05:00,0,1,23,6,0,1361,18085,19446
2014-01-20 00:00:00-05:00,0,1,0,0,1,1090,14802,15892
2014-01-20 01:00:00-05:00,0,1,1,0,1,855,9951,10806
2014-01-20 02:00:00-05:00,0,1,2,0,1,618,7168,7786
2014-01-20 03:00:00-05:00,0,1,3,0,1,485,5061,5546
2014-01-20 04:00:00-05:00,0,1,4,0,1,457,4126,4583
2014-01-20 05:00:00-05:00,0,1,5,0,1,302,3284,3586
2014-01-20 06:00:00-05:00,0,1,6,0,1,301,5686,5987
2014-01-20 07:00:00-05:00,0,1,7,0,1,381,8227,8608
2014-01-20 08:00:00-05:00,0,1,8,0,1,555,13489,14044
2014-01-20 09:00:00-05:00,0,1,9,0,1,643,16646,17289
2014-01-20 10:00:00-05:00,0,1,10,0,1,725,17808,18533
2014-01-20 11:00:00-05:00,0,1,11,0,1,780,19322,20102
2014-01-20 12:00:00-05:00,0,1,12,0,1,900,21195,22095
2014-01-20 13:00:00-05:00,0,1,13,0,1,935,22218,23153
2014-01-20 14:00:00-05:00,0,1,14,0,1,1045,22407,23452
2014-01-20 15:00:00-05:00,0,1,15,0,1,1183,22583,23766
2014-01-20 16:00:00-05:00,0,1,16,0,1,1291,21177,22468
2014-01-20 17:00:00-05:00,0,1,17,0,1,1241,23437,24678
2014-01-20 18:00:00-05:00,0,1,18,0,1,1441,26307,27748
2014-01-20 19:00:00-05:00,0,1,19,0,1,1283,23634,24917
2014-01-20 20:00:00-05:00,0,1,20,0,1,1257,20232,21489
2014-01-20 21:00:00-05:00,0,1,21,0,1,1025,19357,20382
2014-01-20 22:00:00-05:00,0,1,22,0,1,962,17471,18433
2014-01-20 23:00:00-05:00,0,1,23,0,1,838,12862,13700
2014-01-21 00:00:00-05:00,0,1,0,1,0,630,8449,9079
2014-01-21 01:00:00-05:00,0,1,1,1,0,378,4853,5231
2014-01-21 02:00:00-05:00,0,1,2,1,0,238,3200,3438
2014-01-21 03:00:00-05:00,0,1,3,1,0,205,2203,2408
2014-01-21 04:00:00-05:00,0,1,4,1,0,225,2376,2601
2014-01-21 05:00:00-05:00,0,1,5,1,0,205,4576,4781
2014-01-21 06:00:00-05:00,0,1,6,1,0,374,12714,13088
2014-01-21 07:00:00-05:00,0,1,7,1,0,977,23747,24724
2014-01-21 08:00:00-05:00,0,1,8,1,0,1533,27423,28956
2014-01-21 09:00:00-05:00,0.01,1,9,1,0,1274,22296,23570
2014-01-21 10:00:00-05:00,0.03,1,10,1,0,1117,18016,19133
2014-01-21 11:00:00-05:00,0.06,1,11,1,0,1000,15335,16335
2014-01-21 12:00:00-05:00,0.02,1,12,1,0,960,14381,15341
2014-01-21 13:00:00-05:00,0.01,1,13,1,0,948,13539,14487
2014-01-21 14:00:00-05:00,0.03,1,14,1,0,838,12361,13199
2014-01-21 15:00:00-05:00,0.02,1,15,1,0,736,9169,9905
2014-01-21 16:00:00-05:00,0.02,1,16,1,0,717,6094,6811
2014-01-21 17:00:00-05:00,0.01,1,17,1,0,605,6219,6824
2014-01-21 18:00:00-05:00,0.02,1,18,1,0,576,7655,8231
2014-01-21 19:00:00-05:00,0.01,1,19,1,0,474,8459,8933
2014-01-21 20:00:00-05:00,0.01,1,20,1,0,447,8386,8833
2014-01-21 21:00:00-05:00,0,1,21,1,0,356,8566,8922
2014-01-21 22:00:00-05:00,0,1,22,1,0,374,8397,8771
2014-01-21 23:00:00-05:00,0,1,23,1,0,303,7104,7407
2014-01-22 00:00:00-05:00,0,1,0,2,0,241,5313,5554
2014-01-22 01:00:00-05:00,0,1,1,2,0,177,3389,3566
2014-01-22 02:00:00-05:00,0,1,2,2,0,108,2158,2266
2014-01-22 03:00:00-05:00,0,1,3,2,0,87,1526,1613
2014-01-22 04:00:00-05:00,0,1,4,2,0,67,1392,1459
2014-01-22 05:00:00-05:00,0,1,5,2,0,117,2348,2465
2014-01-22 06:00:00-05:00,0,1,6,2,0,212,6156,6368
2014-01-22 07:00:00-05:00,0,1,7,2,0,462,11753,12215
2014-01-22 08:00:00-05:00,0,1,8,2,0,782,16143,16925
2014-01-22 09:00:00-05:00,0,1,9,2,0,999,17894,18893
2014-01-22 10:00:00-05:00,0,1,10,2,0,975,17583,18558
2014-01-22 11:00:00-05:00,0,1,11,2,0,882,18090,18972
2014-01-22 12:00:00-05:00,0,1,12,2,0,948,18778,19726
2014-01-22 13:00:00-05:00,0,1,13,2,0,987,18752,19739
2014-01-22 14:00:00-05:00,0,1,14,2,0,1104,19639,20743
2014-01-22 15:00:00-05:00,0,1,15,2,0,1370,19748,21118
2014-01-22 16:00:00-05:00,0,1,16,2,0,1590,17952,19542
2014-01-22 17:00:00-05:00,0,1,17,2,0,1703,22182,23885
2014-01-22 18:00:00-05:00,0,1,18,2,0,1852,28651,30503
2014-01-22 19:00:00-05:00,0,1,19,2,0,1708,29200,30908
2014-01-22 20:00:00-05:00,0,1,20,2,0,1680,27347,29027
2014-01-22 21:00:00-05:00,0,1,21,2,0,1374,27148,28522
2014-01-22 22:00:00-05:00,0,1,22,2,0,1261,25291,26552
2014-01-22 23:00:00-05:00,0,1,23,2,0,1048,19340,20388
2014-01-23 00:00:00-05:00,0,1,0,3,0,760,12529,13289
2014-01-23 01:00:00-05:00,0,1,1,3,0,497,6984,7481
2014-01-23 02:00:00-05:00,0,1,2,3,0,282,4246,4528
2014-01-23 03:00:00-05:00,0,1,3,3,0,241,2906,3147
2014-01-23 04:00:00-05:00,0,1,4,3,0,246,2928,3174
2014-01-23 05:00:00-05:00,0,1,5,3,0,204,4569,4773
2014-01-23 06:00:00-05:00,0,1,6,3,0,364,12190,12554
2014-01-23 07:00:00-05:00,0,1,7,3,0,994,21697,22691
2014-01-23 08:00:00-05:00,0,1,8,3,0,1598,26020,27618
2014-01-23 09:00:00-05:00,0,1,9,3,0,1477,24858,26335
2014-01-23 10:00:00-05:00,0,1,10,3,0,1296,23036,24332
2014-01-23 11:00:00-05:00,0,1,11,3,0,1230,22004,23234
2014-01-23 12:00:00-05:00,0,1,12,3,0,1196,22366,23562
2014-01-23 13:00:00-05:00,0,1,13,3,0,1202,21505,22707
2014-01-23 14:00:00-05:00,0,1,14,3,0,1347,22621,23968
2014-01-23 15:00:00-05:00,0,1,15,3,0,1649,21058,22707
2014-01-23 16:00:00-05:00,0,1,16,3,0,1827,16223,18050
2014-01-23 17:00:00-05:00,0,1,17,3,0,2103,20206,22309
2014-01-23 18:00:00-05:00,0,1,18,3,0,2243,27180,29423
2014-01-23 19:00:00-05:00,0,1,19,3,0,2234,30807,33041
2014-01-23 20:00:00-05:00,0,1,20,3,0,2162,30828,32990
2014-01-23 21:00:00-05:00,0.01,1,21,3,0,1938,30530,32468
2014-01-23 22:00:00-05:00,0,1,22,3,0,1797,29166,30963
2014-01-23 23:00:00-05:00,0,1,23,3,0,1362,26012,27374
2014-01-24 00:00:00-05:00,0,1,0,4,0,1033,17851,18884
2014-01-24 01:00:00-05:00,0,1,1,4,0,675,10888,11563
2014-01-24 02:00:00-05:00,0,1,2,4,0,399,7086,7485
2014-01-24 03:00:00-05:00,0,1,3,4,0,288,4921,5209
2014-01-24 04:00:00-05:00,0,1,4,4,0,264,4022,4286
2014-01-24 05:00:00-05:00,0,1,5,4,0,221,4790,5011
2014-01-24 06:00:00-05:00,0,1,6,4,0,359,12662,13021
2014-01-24 07:00:00-05:00,0,1,7,4,0,967,23394,24361
2014-01-24 08:00:00-05:00,0,1,8,4,0,1540,27788,29328
2014-01-24 09:00:00-05:00,0,1,9,4,0,1446,26068,27514
2014-01-24 10:00:00-05:00,0,1,10,4,0,1295,23767,25062
2014-01-24 11:00:00-05:00,0,1,11,4,0,1283,22892,24175
2014-01-24 12:00:00-05:00,0,1,12,4,0,1183,22894,24077
2014-01-24 13:00:00-05:00,0,1,13,4,0,1184,22481,23665
2014-01-24 14:00:00-05:00,0,1,14,4,0,1373,24185,25558
2014-01-24 15:00:00-05:00,0,1,15,4,0,1746,21655,23401
2014-01-24 16:00:00-05:00,0,1,16,4,0,2019,17576,19595
2014-01-24 17:00:00-05:00,0,1,17,4,0,2239,22319,24558
2014-01-24 18:00:00-05:00,0,1,18,4,0,2648,30023,32671
2014-01-24 19:00:00-05:00,0,1,19,4,0,2850,33649,36499
2014-01-24 20:00:00-05:00,0,1,20,4,0,2719,32886,35605
2014-01-24 21:00:00-05:00,0,1,21,4,0,2606,31742,34348
2014-01-24 22:00:00-05:00,0,1,22,4,0,2538,32225,34763
2014-01-24 23:00:00-05:00,0,1,23,4,0,2328,31745,34073
2014-01-25 00:00:00-05:00,0,1,0,5,0,2249,28853,31102
2014-01-25 01:00:00-05:00,0,1,1,5,0,1876,23903,25779
2014-01-25 02:00:00-05:00,0,1,2,5,0,1564,19654,21218
2014-01-25 03:00:00-05:00,0,1,3,5,0,1225,14589,15814
2014-01-25 04:00:00-05:00,0,1,4,5,0,961,9305,10266
2014-01-25 05:00:00-05:00,0,1,5,5,0,458,4475,4933
2014-01-25 06:00:00-05:00,0,1,6,5,0,318,5144,5462
2014-01-25 07:00:00-05:00,0,1,7,5,0,450,7608,8058
2014-01-25 08:00:00-05:00,0,1,8,5,0,632,12017,12649
2014-01-25 09:00:00-05:00,0,1,9,5,0,839,17000,17839
2014-01-25 10:00:00-05:00,0,1,10,5,0,958,21120,22078
2014-01-25 11:00:00-05:00,0,1,11,5,0,1121,23723,24844
2014-01-25 12:00:00-05:00,0,1,12,5,0,1215,26235,27450
2014-01-25 13:00:00-05:00,0,1,13,5,0,1383,27842,29225
2014-01-25 14:00:00-05:00,0,1,14,5,0,1603,27172,28775
2014-01-25 15:00:00-05:00,0,1,15,5,0,1713,26583,28296
2014-01-25 16:00:00-05:00,0.01,1,16,5,0,1966,23275,25241
2014-01-25 17:00:00-05:00,0.01,1,17,5,0,2004,25383,27387
2014-01-25 18:00:00-05:00,0,1,18,5,0,2251,30910,33161
2014-01-25 19:00:00-05:00,0,1,19,5,0,2389,33458,35847
2014-01-25 20:00:00-05:00,0,1,20,5,0,2363,29136,31499
2014-01-25 21:00:00-05:00,0,1,21,5,0,2232,28164,30396
2014-01-25 22:00:00-05:00,0,1,22,5,0,2260,31435,33695
2014-01-25 23:00:00-05:00,0,1,23,5,0,2235,33567,35802
2014-01-26 00:00:00-05:00,0,1,0,6,0,2248,31714,33962
2014-01-26 01:00:00-05:00,0,1,1,6,0,2001,28219,30220
2014-01-26 02:00:00-05:00,0,1,2,6,0,1746,23607,25353
2014-01-26 03:00:00-05:00,0,1,3,6,0,1500,18284,19784
2014-01-26 04:00:00-05:00,0,1,4,6,0,1174,10939,12113
2014-01-26 05:00:00-05:00,0,1,5,6,0,518,4759,5277
2014-01-26 06:00:00-05:00,0,1,6,6,0,355,4446,4801
2014-01-26 07:00:00-05:00,0,1,7,6,0,330,6291,6621
2014-01-26 08:00:00-05:00,0,1,8,6,0,431,8918,9349
2014-01-26 09:00:00-05:00,0,1,9,6,0,611,13971,14582
2014-01-26 10:00:00-05:00,0,1,10,6,0,813,20004,20817
2014-01-26 11:00:00-05:00,0,1,11,6,0,981,24051,25032
2014-01-26 12:00:00-05:00,0,1,12,6,0,1065,26450,27515
2014-01-26 13:00:00-05:00,0,1,13,6,0,1232,26579,27811
2014-01-26 14:00:00-05:00,0,1,14,6,0,1426,27888,29314
2014-01-26 15:00:00-05:00,0,1,15,6,0,1521,25003,26524
2014-01-26 16:00:00-05:00,0,1,16,6,0,1630,22097,23727
2014-01-26 17:00:00-05:00,0,1,17,6,0,1631,23268,24899
2014-01-26 18:00:00-05:00,0,1,18,6,0,1791,25519,27310
2014-01-26 19:00:00-05:00,0,1,19,6,0,1612,22179,23791
2014-01-26 20:00:00-05:00,0,1,20,6,0,1455,18003,19458
2014-01-26 21:00:00-05:00,0,1,21,6,0,1237,16825,18062
2014-01-26 22:00:00-05:00,0,1,22,6,0,1140,15563,16703
2014-01-26 23:00:00-05:00,0,1,23,6,0,983,12449,13432
2014-01-27 00:00:00-05:00,0,1,0,0,0,694,7738,8432
2014-01-27 01:00:00-05:00,0,1,1,0,0,505,4672,5177
2014-01-27 02:00:00-05:00,0,1,2,0,0,317,3212,3529
2014-01-27 03:00:00-05:00,0,1,3,0,0,247,2242,2489
2014-01-27 04:00:00-05:00,0,1,4,0,0,315,2630,2945
2014-01-27 05:00:00-05:00,0,1,5,0,0,234,4565,4799
2014-01-27 06:00:00-05:00,0,1,6,0,0,339,12037,12376
2014-01-27 07:00:00-05:00,0,1,7,0,0,900,21149,22049
2014-01-27 08:00:00-05:00,0,1,8,0,0,1396,24709,26105
2014-01-27 09:00:00-05:00,0,1,9,0,0,1354,23399,24753
2014-01-27 10:00:00-05:00,0,1,10,0,0,1139,19978,21117
2014-01-27 11:00:00-05:00,0,1,11,0,0,1055,18796,19851
2014-01-27 12:00:00-05:00,0,1,12,0,0,1013,19145,20158
2014-01-27 13:00:00-05:00,0,1,13,0,0,1088,19231,20319
2014-01-27 14:00:00-05:00,0,1,14,0,0,1219,21165,22384
2014-01-27 15:00:00-05:00,0,1,15,0,0,1424,21675,23099
2014-01-27 16:00:00-05:00,0,1,16,0,0,1703,19348,21051
2014-01-27 17:00:00-05:00,0,1,17,0,0,1836,23669,25505
2014-01-27 18:00:00-05:00,0,1,18,0,0,1960,29413,31373
2014-01-27 19:00:00-05:00,0,1,19,0,0,1797,29226,31023
2014-01-27 20:00:00-05:00,0,1,20,0,0,1568,27145,28713
2014-01-27 21:00:00-05:00,0,1,21,0,0,1339,25371,26710
2014-01-27 22:00:00-05:00,0,1,22,0,0,1173,21838,23011
2014-01-27 23:00:00-05:00,0,1,23,0,0,905,16510,17415
2014-01-28 00:00:00-05:00,0,1,0,1,0,706,9850,10556
2014-01-28 01:00:00-05:00,0,1,1,1,0,475,5400,5875
2014-01-28 02:00:00-05:00,0,1,2,1,0,301,3578,3879
2014-01-28 03:00:00-05:00,0,1,3,1,0,233,2373,2606
2014-01-28 04:00:00-05:00,0,1,4,1,0,231,2500,2731
2014-01-28 05:00:00-05:00,0,1,5,1,0,207,4345,4552
2014-01-28 06:00:00-05:00,0,1,6,1,0,352,13089,13441
2014-01-28 07:00:00-05:00,0,1,7,1,0,942,24011,24953
2014-01-28 08:00:00-05:00,0,1,8,1,0,1482,28723,30205
2014-01-28 09:00:00-05:00,0,1,9,1,0,1460,26463,27923
2014-01-28 10:00:00-05:00,0,1,10,1,0,1277,22947,24224
2014-01-28 11:00:00-05:00,0,1,11,1,0,1193,22142,23335
2014-01-28 12:00:00-05:00,0,1,12,1,0,1258,22285,23543
2014-01-28 13:00:00-05:00,0,1,13,1,0,1203,22167,23370
2014-01-28 14:00:00-05:00,0,1,14,1,0,1326,23821,25147
2014-01-28 15:00:00-05:00,0,1,15,1,0,1560,23111,24671
2014-01-28 16:00:00-05:00,0,1,16,1,0,1745,18618,20363
2014-01-28 17:00:00-05:00,0,1,17,1,0,1933,23534,25467
2014-01-28 18:00:00-05:00,0,1,18,1,0,2031,30608,32639
2014-01-28 19:00:00-05:00,0,1,19,1,0,1963,31486,33449
2014-01-28 20:00:00-05:00,0,1,20,1,0,1660,31049,32709
2014-01-28 21:00:00-05:00,0,1,21,1,0,1468,29893,31361
2014-01-28 22:00:00-05:00,0,1,22,1,0,1205,27114,28319
2014-01-28 23:00:00-05:00,0,1,23,1,0,1052,19622,20674
2014-01-29 00:00:00-05:00,0,1,0,2,0,771,11926,12697
2014-01-29 01:00:00-05:00,0.01,1,1,2,0,435,6915,7350
2014-01-29 02:00:00-05:00,0.02,1,2,2,0,282,4227,4509
2014-01-29 03:00:00-05:00,0.01,1,3,2,0,210,2819,3029
2014-01-29 04:00:00-05:00,0.01,1,4,2,0,203,2710,2913
2014-01-29 05:00:00-05:00,0,1,5,2,0,179,4228,4407
2014-01-29 06:00:00-05:00,0,1,6,2,0,361,12555,12916
2014-01-29 07:00:00-05:00,0,1,7,2,0,942,23178,24120
2014-01-29 08:00:00-05:00,0,1,8,2,0,1501,27543,29044
2014-01-29 09:00:00-05:00,0,1,9,2,0,1412,26048,27460
2014-01-29 10:00:00-05:00,0,1,10,2,0,1294,23412,24706
2014-01-29 11:00:00-05:00,0,1,11,2,0,1184,21907,23091
2014-01-29 12:00:00-05:00,0,1,12,2,0,1195,22282,23477
2014-01-29 13:00:00-05:00,0,1,13,2,0,1172,21116,22288
2014-01-29 14:00:00-05:00,0,1,14,2,0,1462,22995,24457
2014-01-29 15:00:00-05:00,0,1,15,2,0,1587,22607,24194
2014-01-29 16:00:00-05:00,0,1,16,2,0,1720,18416,20136
2014-01-29 17:00:00-05:00,0,1,17,2,0,2058,23417,25475
2014-01-29 18:00:00-05:00,0,1,18,2,0,2191,30391,32582
2014-01-29 19:00:00-05:00,0,1,19,2,0,2318,32818,35136
2014-01-29 20:00:00-05:00,0,1,20,2,0,2162,32074,34236
2014-01-29 21:00:00-05:00,0,1,21,2,0,1776,31751,33527
2014-01-29 22:00:00-05:00,0,1,22,2,0,1551,29701,31252
2014-01-29 23:00:00-05:00,0,1,23,2,0,1319,22948,24267
2014-01-30 00:00:00-05:00,0,1,0,3,0,1034,14346,15380
2014-01-30 01:00:00-05:00,0,1,1,3,0,620,8361,8981
2014-01-30 02:00:00-05:00,0,1,2,3,0,421,5329,5750
2014-01-30 03:00:00-05:00,0,1,3,3,0,270,3378,3648
2014-01-30 04:00:00-05:00,0,1,4,3,0,283,3258,3541
2014-01-30 05:00:00-05:00,0,1,5,3,0,210,4565,4775
2014-01-30 06:00:00-05:00,0,1,6,3,0,390,12839,13229
2014-01-30 07:00:00-05:00,0,1,7,3,0,1025,23716,24741
2014-01-30 08:00:00-05:00,0,1,8,3,0,1529,27912,29441
2014-01-30 09:00:00-05:00,0,1,9,3,0,1527,25822,27349
2014-01-30 10:00:00-05:00,0,1,10,3,0,1373,23217,24590
2014-01-30 11:00:00-05:00,0,1,11,3,0,1286,22438,23724
2014-01-30 12:00:00-05:00,0,1,12,3,0,1281,23282,24563
2014-01-30 13:00:00-05:00,0,1,13,3,0,1339,22149,23488
2014-01-30 14:00:00-05:00,0,1,14,3,0,1458,23374,24832
2014-01-30 15:00:00-05:00,0,1,15,3,0,1573,22605,24178
2014-01-30 16:00:00-05:00,0,1,16,3,0,1930,17969,19899
2014-01-30 17:00:00-05:00,0,1,17,3,0,2102,23565,25667
2014-01-30 18:00:00-05:00,0,1,18,3,0,2426,30218,32644
2014-01-30 19:00:00-05:00,0,1,19,3,0,2345,32655,35000
2014-01-30 20:00:00-05:00,0,1,20,3,0,2142,32559,34701
2014-01-30 21:00:00-05:00,0,1,21,3,0,2003,32780,34783
2014-01-30 22:00:00-05:00,0,1,22,3,0,1752,31501,33253
2014-01-30 23:00:00-05:00,0,1,23,3,0,1533,28133,29666
2014-01-31 00:00:00-05:00,0,1,0,4,0,1257,20786,22043
2014-01-31 01:00:00-05:00,0,1,1,4,0,834,13580,14414
2014-01-31 02:00:00-05:00,0,1,2,4,0,595,9064,9659
2014-01-31 03:00:00-05:00,0,1,3,4,0,425,6183,6608
2014-01-31 04:00:00-05:00,0,1,4,4,0,356,4997,5353
2014-01-31 05:00:00-05:00,0,1,5,4,0,274,5153,5427
2014-01-31 06:00:00-05:00,0,1,6,4,0,412,12705,13117
2014-01-31 07:00:00-05:00,0,1,7,4,0,1056,23810,24866
2014-01-31 08:00:00-05:00,0,1,8,4,0,1626,28014,29640
2014-01-31 09:00:00-05:00,0,1,9,4,0,1610,26289,27899
2014-01-31 10:00:00-05:00,0,1,10,4,0,1527,23189,24716
2014-01-31 11:00:00-05:00,0,1,11,4,0,1385,22691,24076
2014-01-31 12:00:00-05:00,0,1,12,4,0,1457,23141,24598
2014-01-31 13:00:00-05:00,0,1,13,4,0,1344,22747,24091
2014-01-31 14:00:00-05:00,0,1,14,4,0,1661,24857,26518
2014-01-31 15:00:00-05:00,0,1,15,4,0,1864,22297,24161
2014-01-31 16:00:00-05:00,0,1,16,4,0,2224,18342,20566
2014-01-31 17:00:00-05:00,0,1,17,4,0,2503,23878,26381
2014-01-31 18:00:00-05:00,0,1,18,4,0,2729,30401,33130
2014-01-31 19:00:00-05:00,0,1,19,4,0,2798,33383,36181
2014-01-31 20:00:00-05:00,0,1,20,4,0,2665,33259,35924
2014-01-31 21:00:00-05:00,0,1,21,4,0,2602,32264,34866
2014-01-31 22:00:00-05:00,0,1,22,4,0,2597,32942,35539
2014-01-31 23:00:00-05:00,0,1,23,4,0,2487,32776,35263
2014-02-01 00:00:00-05:00,0,2,0,5,0,2396,31295,33691
2014-02-01 01:00:00-05:00,0,2,1,5,0,2150,27529,29679
2014-02-01 02:00:00-05:00,0,2,2,5,0,1792,23597,25389
2014-02-01 03:00:00-05:00,0,2,3,5,0,1506,18034,19540
2014-02-01 04:00:00-05:00,0,2,4,5,0,1129,12156,13285
2014-02-01 05:00:00-05:00,0,2,5,5,0,572,5768,6340
2014-02-01 06:00:00-05:00,0,2,6,5,0,349,5420,5769
2014-02-01 07:00:00-05:00,0,2,7,5,0,461,7288,7749
2014-02-01 08:00:00-05:00,0,2,8,5,0,753,11492,12245
2014-02-01 09:00:00-05:00,0,2,9,5,0,929,16268,17197
2014-02-01 10:00:00-05:00,0,2,10,5,0,1066,19776,20842
2014-02-01 11:00:00-05:00,0,2,11,5,0,1241,23088,24329
2014-02-01 12:00:00-05:00,0,2,12,5,0,1372,25274,26646
2014-02-01 13:00:00-05:00,0,2,13,5,0,1436,25504,26940
2014-02-01 14:00:00-05:00,0,2,14,5,0,1640,25077,26717
2014-02-01 15:00:00-05:00,0,2,15,5,0,1817,24944,26761
2014-02-01 16:00:00-05:00,0,2,16,5,0,2081,22204,24285
2014-02-01 17:00:00-05:00,0,2,17,5,0,2308,25095,27403
2014-02-01 18:00:00-05:00,0,2,18,5,0,2579,30460,33039
2014-02-01 19:00:00-05:00,0,2,19,5,0,2747,32221,34968
2014-02-01 20:00:00-05:00,0,2,20,5,0,2719,29071,31790
2014-02-01 21:00:00-05:00,0,2,21,5,0,2584,29370,31954
2014-02-01 22:00:00-05:00,0,2,22,5,0,2625,30369,32994
2014-02-01 23:00:00-05:00,0,2,23,5,0,2690,32483,35173
2014-02-02 00:00:00-05:00,0,2,0,6,0,2598,31190,33788
2014-02-02 01:00:00-05:00,0,2,1,6,0,2393,28871,31264
2014-02-02 02:00:00-05:00,0,2,2,6,0,2061,25149,27210
2014-02-02 03:00:00-05:00,0,2,3,6,0,1732,19973,21705
2014-02-02 04:00:00-05:00,0,2,4,6,0,1335,13290,14625
2014-02-02 05:00:00-05:00,0,2,5,6,0,661,6037,6698
2014-02-02 06:00:00-05:00,0,2,6,6,0,401,4811,5212
2014-02-02 07:00:00-05:00,0,2,7,6,0,384,5712,6096
2014-02-02 08:00:00-05:00,0,2,8,6,0,453,9609,10062
2014-02-02 09:00:00-05:00,0,2,9,6,0,637,13336,13973
2014-02-02 10:00:00-05:00,0,2,10,6,0,859,17768,18627
2014-02-02 11:00:00-05:00,0,2,11,6,0,985,20213,21198
2014-02-02 12:00:00-05:00,0,2,12,6,0,1114,22084,23198
2014-02-02 13:00:00-05:00,0,2,13,6,0,1248,21998,23246
2014-02-02 14:00:00-05:00,0,2,14,6,0,1433,21783,23216
2014-02-02 15:00:00-05:00,0,2,15,6,0,1642,20451,22093
2014-02-02 16:00:00-05:00,0,2,16,6,0,1853,21459,23312
2014-02-02 17:00:00-05:00,0,2,17,6,0,2085,28303,30388
2014-02-02 18:00:00-05:00,0,2,18,6,0,2253,26769,29022
2014-02-02 19:00:00-05:00,0,2,19,6,0,1737,15687,17424
2014-02-02 20:00:00-05:00,0,2,20,6,0,1592,17412,19004
2014-02-02 21:00:00-05:00,0,2,21,6,0,1576,21699,23275
2014-02-02 22:00:00-05:00,0,2,22,6,0,2035,29696,31731
2014-02-02 23:00:00-05:00,0,2,23,6,0,1779,20925,22704
2014-02-03 00:00:00-05:00,0,2,0,0,0,1252,13440,14692
2014-02-03 01:00:00-05:00,0,2,1,0,0,811,8742,9553
2014-02-03 02:00:00-05:00,0.04,2,2,0,0,554,5958,6512
2014-02-03 03:00:00-05:00,0.06,2,3,0,0,374,4436,4810
2014-02-03 04:00:00-05:00,0.05,2,4,0,0,341,4232,4573
2014-02-03 05:00:00-05:00,0.04,2,5,0,0,271,5486,5757
2014-02-03 06:00:00-05:00,0.08,2,6,0,0,414,12003,12417
2014-02-03 07:00:00-05:00,0.11,2,7,0,0,897,19705,20602
2014-02-03 08:00:00-05:00,0.12,2,8,0,0,1321,21405,22726
2014-02-03 09:00:00-05:00,0.1,2,9,0,0,1201,20800,22001
2014-02-03 10:00:00-05:00,0.11,2,10,0,0,1064,18351,19415
2014-02-03 11:00:00-05:00,0.08,2,11,0,0,1008,17875,18883
2014-02-03 12:00:00-05:00,0.08,2,12,0,0,996,17938,18934
2014-02-03 13:00:00-05:00,0.06,2,13,0,0,1002,17311,18313
2014-02-03 14:00:00-05:00,0.04,2,14,0,0,1144,18019,19163
2014-02-03 15:00:00-05:00,0.01,2,15,0,0,1231,18995,20226
2014-02-03 16:00:00-05:00,0.03,2,16,0,0,1341,16157,17498
2014-02-03 17:00:00-05:00,0.07,2,17,0,0,1405,19395,20800
2014-02-03 18:00:00-05:00,0,2,18,0,0,1423,24418,25841
2014-02-03 19:00:00-05:00,0,2,19,0,0,1330,24255,25585
2014-02-03 20:00:00-05:00,0,2,20,0,0,1134,21635,22769
2014-02-03 21:00:00-05:00,0,2,21,0,0,1066,20240,21306
2014-02-03 22:00:00-05:00,0,2,22,0,0,828,17763,18591
2014-02-03 23:00:00-05:00,0,2,23,0,0,723,13958,14681
2014-02-04 00:00:00-05:00,0,2,0,1,0,541,8327,8868
2014-02-04 01:00:00-05:00,0,2,1,1,0,349,5010,5359
2014-02-04 02:00:00-05:00,0,2,2,1,0,230,3156,3386
2014-02-04 03:00:00-05:00,0,2,3,1,0,161,2146,2307
2014-02-04 04:00:00-05:00,0,2,4,1,0,219,2656,2875
2014-02-04 05:00:00-05:00,0,2,5,1,0,210,4629,4839
2014-02-04 06:00:00-05:00,0,2,6,1,0,418,12524,12942
2014-02-04 07:00:00-05:00,0,2,7,1,0,1077,22245,23322
2014-02-04 08:00:00-05:00,0,2,8,1,0,1593,26967,28560
2014-02-04 09:00:00-05:00,0,2,9,1,0,1622,25778,27400
2014-02-04 10:00:00-05:00,0,2,10,1,0,1419,22807,24226
2014-02-04 11:00:00-05:00,0,2,11,1,0,1340,22043,23383
2014-02-04 12:00:00-05:00,0,2,12,1,0,1273,21835,23108
2014-02-04 13:00:00-05:00,0,2,13,1,0,1362,21373,22735
2014-02-04 14:00:00-05:00,0,2,14,1,0,1494,23261,24755
2014-02-04 15:00:00-05:00,0,2,15,1,0,1778,22682,24460
2014-02-04 16:00:00-05:00,0,2,16,1,0,1983,18630,20613
2014-02-04 17:00:00-05:00,0,2,17,1,0,2108,23117,25225
2014-02-04 18:00:00-05:00,0,2,18,1,0,2215,30660,32875
2014-02-04 19:00:00-05:00,0,2,19,1,0,2159,31186,33345
2014-02-04 20:00:00-05:00,0,2,20,1,0,1834,29705,31539
2014-02-04 21:00:00-05:00,0,2,21,1,0,1669,29133,30802
2014-02-04 22:00:00-05:00,0,2,22,1,0,1368,25773,27141
2014-02-04 23:00:00-05:00,0,2,23,1,0,1137,18801,19938
2014-02-05 00:00:00-05:00,0,2,0,2,0,853,11615,12468
2014-02-05 01:00:00-05:00,0.04,2,1,2,0,525,7190,7715
2014-02-05 02:00:00-05:00,0.07,2,2,2,0,308,4350,4658
2014-02-05 03:00:00-05:00,0.11,2,3,2,0,172,2694,2866
2014-02-05 04:00:00-05:00,0.22,2,4,2,0,118,1985,2103
2014-02-05 05:00:00-05:00,0.19,2,5,2,0,115,3219,3334
2014-02-05 06:00:00-05:00,0.11,2,6,2,0,227,9213,9440
2014-02-05 07:00:00-05:00,0.27,2,7,2,0,549,16538,17087
2014-02-05 08:00:00-05:00,0.11,2,8,2,0,1055,20626,21681
2014-02-05 09:00:00-05:00,0.01,2,9,2,0,1359,21467,22826
2014-02-05 10:00:00-05:00,0,2,10,2,0,1284,19732,21016
2014-02-05 11:00:00-05:00,0,2,11,2,0,1209,18599,19808
2014-02-05 12:00:00-05:00,0.03,2,12,2,0,1219,19680,20899
2014-02-05 13:00:00-05:00,0.01,2,13,2,0,1218,18839,20057
2014-02-05 14:00:00-05:00,0.01,2,14,2,0,1389,20070,21459
2014-02-05 15:00:00-05:00,0,2,15,2,0,1540,20057,21597
2014-02-05 16:00:00-05:00,0,2,16,2,0,1701,17801,19502
2014-02-05 17:00:00-05:00,0,2,17,2,0,1869,22303,24172
2014-02-05 18:00:00-05:00,0,2,18,2,0,1931,29159,31090
2014-02-05 19:00:00-05:00,0,2,19,2,0,1894,29999,31893
2014-02-05 20:00:00-05:00,0,2,20,2,0,1542,27058,28600
2014-02-05 21:00:00-05:00,0,2,21,2,0,1379,27246,28625
2014-02-05 22:00:00-05:00,0,2,22,2,0,1295,25130,26425
2014-02-05 23:00:00-05:00,0,2,23,2,0,1097,19283,20380
2014-02-06 00:00:00-05:00,0,2,0,3,0,882,13077,13959
2014-02-06 01:00:00-05:00,0,2,1,3,0,540,7579,8119
2014-02-06 02:00:00-05:00,0,2,2,3,0,347,4715,5062
2014-02-06 03:00:00-05:00,0,2,3,3,0,259,3150,3409
2014-02-06 04:00:00-05:00,0,2,4,3,0,255,3014,3269
2014-02-06 05:00:00-05:00,0,2,5,3,0,266,4742,5008
2014-02-06 06:00:00-05:00,0,2,6,3,0,449,13144,13593
2014-02-06 07:00:00-05:00,0,2,7,3,0,1150,23230,24380
2014-02-06 08:00:00-05:00,0,2,8,3,0,1807,26573,28380
2014-02-06 09:00:00-05:00,0,2,9,3,0,1626,25935,27561
2014-02-06 10:00:00-05:00,0,2,10,3,0,1496,23532,25028
2014-02-06 11:00:00-05:00,0,2,11,3,0,1423,22565,23988
2014-02-06 12:00:00-05:00,0,2,12,3,0,1290,23321,24611
2014-02-06 13:00:00-05:00,0,2,13,3,0,1347,22579,23926
2014-02-06 14:00:00-05:00,0,2,14,3,0,1597,23889,25486
2014-02-06 15:00:00-05:00,0,2,15,3,0,1847,21258,23105
2014-02-06 16:00:00-05:00,0,2,16,3,0,2050,16733,18783
2014-02-06 17:00:00-05:00,0,2,17,3,0,2302,21055,23357
2014-02-06 18:00:00-05:00,0,2,18,3,0,2599,28646,31245
2014-02-06 19:00:00-05:00,0,2,19,3,0,2549,31680,34229
2014-02-06 20:00:00-05:00,0,2,20,3,0,2279,31172,33451
2014-02-06 21:00:00-05:00,0,2,21,3,0,2031,30949,32980
2014-02-06 22:00:00-05:00,0,2,22,3,0,1790,30012,31802
2014-02-06 23:00:00-05:00,0,2,23,3,0,1568,26240,27808
2014-02-07 00:00:00-05:00,0,2,0,4,0,1245,19706,20951
2014-02-07 01:00:00-05:00,0,2,1,4,0,833,12480,13313
2014-02-07 02:00:00-05:00,0,2,2,4,0,512,8125,8637
2014-02-07 03:00:00-05:00,0,2,3,4,0,380,5641,6021
2014-02-07 04:00:00-05:00,0,2,4,4,0,353,4555,4908
2014-02-07 05:00:00-05:00,0,2,5,4,0,254,5204,5458
2014-02-07 06:00:00-05:00,0,2,6,4,0,461,12697,13158
2014-02-07 07:00:00-05:00,0,2,7,4,0,1149,23339,24488
2014-02-07 08:00:00-05:00,0,2,8,4,0,1684,26908,28592
2014-02-07 09:00:00-05:00,0,2,9,4,0,1581,26085,27666
2014-02-07 10:00:00-05:00,0,2,10,4,0,1426,23200,24626
2014-02-07 11:00:00-05:00,0,2,11,4,0,1323,22829,24152
2014-02-07 12:00:00-05:00,0,2,12,4,0,1369,22425,23794
2014-02-07 13:00:00-05:00,0,2,13,4,0,1353,22180,23533
2014-02-07 14:00:00-05:00,0,2,14,4,0,1660,23388,25048
2014-02-07 15:00:00-05:00,0,2,15,4,0,1957,21283,23240
2014-02-07 16:00:00-05:00,0,2,16,4,0,2251,17333,19584
2014-02-07 17:00:00-05:00,0,2,17,4,0,2621,21904,24525
2014-02-07 18:00:00-05:00,0,2,18,4,0,3027,29330,32357
2014-02-07 19:00:00-05:00,0,2,19,4,0,3214,33528,36742
2014-02-07 20:00:00-05:00,0,2,20,4,0,3076,32671,35747
2014-02-07 21:00:00-05:00,0,2,21,4,0,2829,31766,34595
2014-02-07 22:00:00-05:00,0,2,22,4,0,2772,32964,35736
2014-02-07 23:00:00-05:00,0,2,23,4,0,2698,32677,35375
2014-02-08 00:00:00-05:00,0,2,0,5,0,2587,30316,32903
2014-02-08 01:00:00-05:00,0,2,1,5,0,2230,25701,27931
2014-02-08 02:00:00-05:00,0,2,2,5,0,1801,20903,22704
2014-02-08 03:00:00-05:00,0,2,3,5,0,1462,15735,17197
2014-02-08 04:00:00-05:00,0,2,4,5,0,1149,10413,11562
2014-02-08 05:00:00-05:00,0,2,5,5,0,578,4965,5543
2014-02-08 06:00:00-05:00,0,2,6,5,0,411,5334,5745
2014-02-08 07:00:00-05:00,0,2,7,5,0,534,7609,8143
2014-02-08 08:00:00-05:00,0,2,8,5,0,772,12552,13324
2014-02-08 09:00:00-05:00,0,2,9,5,0,1092,18338,19430
2014-02-08 10:00:00-05:00,0,2,10,5,0,1132,21524,22656
2014-02-08 11:00:00-05:00,0,2,11,5,0,1295,24594,25889
2014-02-08 12:00:00-05:00,0,2,12,5,0,1515,27307,28822
2014-02-08 13:00:00-05:00,0,2,13,5,0,1604,28028,29632
2014-02-08 14:00:00-05:00,0,2,14,5,0,1865,26939,28804
2014-02-08 15:00:00-05:00,0,2,15,5,0,2145,26575,28720
2014-02-08 16:00:00-05:00,0,2,16,5,0,2415,23058,25473
2014-02-08 17:00:00-05:00,0,2,17,5,0,2527,26157,28684
2014-02-08 18:00:00-05:00,0,2,18,5,0,2973,32833,35806
2014-02-08 19:00:00-05:00,0,2,19,5,0,3090,33796,36886
2014-02-08 20:00:00-05:00,0,2,20,5,0,3081,31269,34350
2014-02-08 21:00:00-05:00,0,2,21,5,0,2964,30172,33136
2014-02-08 22:00:00-05:00,0,2,22,5,0,3040,32093,35133
2014-02-08 23:00:00-05:00,0,2,23,5,0,3040,33756,36796
2014-02-09 00:00:00-05:00,0,2,0,6,0,2795,32117,34912
2014-02-09 01:00:00-05:00,0,2,1,6,0,2527,29237,31764
2014-02-09 02:00:00-05:00,0,2,2,6,0,2160,24595,26755
2014-02-09 03:00:00-05:00,0,2,3,6,0,1818,19091,20909
2014-02-09 04:00:00-05:00,0,2,4,6,0,1427,12320,13747
2014-02-09 05:00:00-05:00,0,2,5,6,0,692,5325,6017
2014-02-09 06:00:00-05:00,0,2,6,6,0,419,4784,5203
2014-02-09 07:00:00-05:00,0,2,7,6,0,393,5607,6000
2014-02-09 08:00:00-05:00,0,2,8,6,0,522,8977,9499
2014-02-09 09:00:00-05:00,0,2,9,6,0,764,13743,14507
2014-02-09 10:00:00-05:00,0,2,10,6,0,957,19726,20683
2014-02-09 11:00:00-05:00,0,2,11,6,0,1155,23273,24428
2014-02-09 12:00:00-05:00,0,2,12,6,0,1252,25744,26996
2014-02-09 13:00:00-05:00,0,2,13,6,0,1470,26316,27786
2014-02-09 14:00:00-05:00,0,2,14,6,0,1604,25218,26822
2014-02-09 15:00:00-05:00,0,2,15,6,0,1728,24915,26643
2014-02-09 16:00:00-05:00,0,2,16,6,0,1933,23256,25189
2014-02-09 17:00:00-05:00,0,2,17,6,0,2005,24553,26558
2014-02-09 18:00:00-05:00,0.01,2,18,6,0,2182,27636,29818
2014-02-09 19:00:00-05:00,0.07,2,19,6,0,1821,23554,25375
2014-02-09 20:00:00-05:00,0.01,2,20,6,0,1633,19639,21272
2014-02-09 21:00:00-05:00,0.01,2,21,6,0,1375,18288,19663
2014-02-09 22:00:00-05:00,0,2,22,6,0,1212,15964,17176
2014-02-09 23:00:00-05:00,0,2,23,6,0,1031,12614,13645
2014-02-10 00:00:00-05:00,0,2,0,0,0,771,8899,9670
2014-02-10 01:00:00-05:00,0,2,1,0,0,460,5026,5486
2014-02-10 02:00:00-05:00,0,2,2,0,0,308,3320,3628
2014-02-10 03:00:00-05:00,0,2,3,0,0,265,2330,2595
2014-02-10 04:00:00-05:00,0,2,4,0,0,341,2636,2977
2014-02-10 05:00:00-05:00,0,2,5,0,0,242,4599,4841
2014-02-10 06:00:00-05:00,0,2,6,0,0,433,12264,12697
2014-02-10 07:00:00-05:00,0,2,7,0,0,1100,21115,22215
2014-02-10 08:00:00-05:00,0,2,8,0,0,1785,24652,26437
2014-02-10 09:00:00-05:00,0,2,9,0,0,1701,24409,26110
2014-02-10 10:00:00-05:00,0,2,10,0,0,1414,20991,22405
2014-02-10 11:00:00-05:00,0,2,11,0,0,1311,20285,21596
2014-02-10 12:00:00-05:00,0,2,12,0,0,1296,21050,22346
2014-02-10 13:00:00-05:00,0,2,13,0,0,1326,20767,22093
2014-02-10 14:00:00-05:00,0,2,14,0,0,1469,22308,23777
2014-02-10 15:00:00-05:00,0,2,15,0,0,1675,22641,24316
2014-02-10 16:00:00-05:00,0,2,16,0,0,1866,19902,21768
2014-02-10 17:00:00-05:00,0,2,17,0,0,2097,24445,26542
2014-02-10 18:00:00-05:00,0,2,18,0,0,2269,30164,32433
2014-02-10 19:00:00-05:00,0,2,19,0,0,2112,30407,32519
2014-02-10 20:00:00-05:00,0,2,20,0,0,1896,28032,29928
2014-02-10 21:00:00-05:00,0,2,21,0,0,1536,26594,28130
2014-02-10 22:00:00-05:00,0,2,22,0,0,1257,22742,23999
2014-02-10 23:00:00-05:00,0,2,23,0,0,1054,16333,17387
2014-02-11 00:00:00-05:00,0,2,0,1,0,820,10250,11070
2014-02-11 01:00:00-05:00,0,2,1,1,0,470,6026,6496
2014-02-11 02:00:00-05:00,0,2,2,1,0,325,3842,4167
2014-02-11 03:00:00-05:00,0,2,3,1,0,251,2516,2767
2014-02-11 04:00:00-05:00,0,2,4,1,0,268,2451,2719
2014-02-11 05:00:00-05:00,0,2,5,1,0,234,4416,4650
2014-02-11 06:00:00-05:00,0,2,6,1,0,442,12791,13233
2014-02-11 07:00:00-05:00,0,2,7,1,0,1154,24011,25165
2014-02-11 08:00:00-05:00,0,2,8,1,0,1776,27584,29360
2014-02-11 09:00:00-05:00,0,2,9,1,0,1656,27372,29028
2014-02-11 10:00:00-05:00,0,2,10,1,0,1754,25878,27632
2014-02-11 11:00:00-05:00,0,2,11,1,0,1608,24819,26427
2014-02-11 12:00:00-05:00,0,2,12,1,0,1579,24617,26196
2014-02-11 13:00:00-05:00,0,2,13,1,0,1527,23948,25475
2014-02-11 14:00:00-05:00,0,2,14,1,0,1695,25471,27166
2014-02-11 15:00:00-05:00,0,2,15,1,0,1901,23933,25834
2014-02-11 16:00:00-05:00,0,2,16,1,0,2156,18865,21021
2014-02-11 17:00:00-05:00,0,2,17,1,0,2470,23952,26422
2014-02-11 18:00:00-05:00,0,2,18,1,0,2574,30739,33313
2014-02-11 19:00:00-05:00,0,2,19,1,0,2449,32295,34744
2014-02-11 20:00:00-05:00,0,2,20,1,0,2260,32205,34465
2014-02-11 21:00:00-05:00,0,2,21,1,0,2023,31203,33226
2014-02-11 22:00:00-05:00,0,2,22,1,0,1661,27976,29637
2014-02-11 23:00:00-05:00,0,2,23,1,0,1378,22213,23591
2014-02-12 00:00:00-05:00,0,2,0,2,0,975,13461,14436
2014-02-12 01:00:00-05:00,0,2,1,2,0,617,7590,8207
2014-02-12 02:00:00-05:00,0,2,2,2,0,365,4763,5128
2014-02-12 03:00:00-05:00,0,2,3,2,0,267,3081,3348
2014-02-12 04:00:00-05:00,0,2,4,2,0,250,3089,3339
2014-02-12 05:00:00-05:00,0,2,5,2,0,194,4622,4816
2014-02-12 06:00:00-05:00,0,2,6,2,0,405,13251,13656
2014-02-12 07:00:00-05:00,0,2,7,2,0,1172,24111,25283
2014-02-12 08:00:00-05:00,0,2,8,2,0,1842,27217,29059
2014-02-12 09:00:00-05:00,0,2,9,2,0,1766,25936,27702
2014-02-12 10:00:00-05:00,0,2,10,2,0,1567,23543,25110
2014-02-12 11:00:00-05:00,0,2,11,2,0,1526,23409,24935
2014-02-12 12:00:00-05:00,0,2,12,2,0,1570,24146,25716
2014-02-12 13:00:00-05:00,0,2,13,2,0,1642,22976,24618
2014-02-12 14:00:00-05:00,0,2,14,2,0,1893,23767,25660
2014-02-12 15:00:00-05:00,0,2,15,2,0,2164,21226,23390
2014-02-12 16:00:00-05:00,0,2,16,2,0,2437,17132,19569
2014-02-12 17:00:00-05:00,0,2,17,2,0,2744,22846,25590
2014-02-12 18:00:00-05:00,0,2,18,2,0,2956,29950,32906
2014-02-12 19:00:00-05:00,0,2,19,2,0,3005,32395,35400
2014-02-12 20:00:00-05:00,0,2,20,2,0,2615,31110,33725
2014-02-12 21:00:00-05:00,0,2,21,2,0,2226,30279,32505
2014-02-12 22:00:00-05:00,0,2,22,2,0,1888,29020,30908
2014-02-12 23:00:00-05:00,0,2,23,2,0,1552,23048,24600
2014-02-13 00:00:00-05:00,0.01,2,0,3,0,1132,15225,16357
2014-02-13 01:00:00-05:00,0.03,2,1,3,0,648,9355,10003
2014-02-13 02:00:00-05:00,0.02,2,2,3,0,389,5861,6250
2014-02-13 03:00:00-05:00,0.03,2,3,3,0,286,3865,4151
2014-02-13 04:00:00-05:00,0.03,2,4,3,0,230,2954,3184
2014-02-13 05:00:00-05:00,0.03,2,5,3,0,187,3453,3640
2014-02-13 06:00:00-05:00,0.03,2,6,3,0,244,8209,8453
2014-02-13 07:00:00-05:00,0.05,2,7,3,0,527,12938,13465
2014-02-13 08:00:00-05:00,0.06,2,8,3,0,626,12998,13624
2014-02-13 09:00:00-05:00,0.04,2,9,3,0,608,11747,12355
2014-02-13 10:00:00-05:00,0.06,2,10,3,0,567,10252,10819
2014-02-13 11:00:00-05:00,0.07,2,11,3,0,532,10279,10811
2014-02-13 12:00:00-05:00,0.06,2,12,3,0,696,12445,13141
2014-02-13 13:00:00-05:00,0.03,2,13,3,0,766,12824,13590
2014-02-13 14:00:00-05:00,0.01,2,14,3,0,1042,14442,15484
2014-02-13 15:00:00-05:00,0.01,2,15,3,0,1241,14498,15739
2014-02-13 16:00:00-05:00,0.01,2,16,3,0,1436,13907,15343
2014-02-13 17:00:00-05:00,0.01,2,17,3,0,1493,17799,19292
2014-02-13 18:00:00-05:00,0,2,18,3,0,1683,23350,25033
2014-02-13 19:00:00-05:00,0,2,19,3,0,1657,23501,25158
2014-02-13 20:00:00-05:00,0.09,2,20,3,0,1726,24244,25970
2014-02-13 21:00:00-05:00,0.95,2,21,3,0,1714,24966,26680
2014-02-13 22:00:00-05:00,0.06,2,22,3,0,1282,20188,21470
2014-02-13 23:00:00-05:00,0,2,23,3,0,1065,16887,17952
2014-02-14 00:00:00-05:00,0.05,2,0,4,0,844,12931,13775
2014-02-14 01:00:00-05:00,0.07,2,1,4,0,529,7782,8311
2014-02-14 02:00:00-05:00,0.07,2,2,4,0,310,5005,5315
2014-02-14 03:00:00-05:00,0.05,2,3,4,0,224,3570,3794
2014-02-14 04:00:00-05:00,0,2,4,4,0,235,2972,3207
2014-02-14 05:00:00-05:00,0.01,2,5,4,0,188,3956,4144
2014-02-14 06:00:00-05:00,0,2,6,4,0,358,9991,10349
2014-02-14 07:00:00-05:00,0,2,7,4,0,979,17672,18651
2014-02-14 08:00:00-05:00,0,2,8,4,0,1674,22101,23775
2014-02-14 09:00:00-05:00,0,2,9,4,0,1845,22942,24787
2014-02-14 10:00:00-05:00,0,2,10,4,0,1683,20800,22483
2014-02-14 11:00:00-05:00,0,2,11,4,0,1605,20948,22553
2014-02-14 12:00:00-05:00,0,2,12,4,0,1622,21222,22844
2014-02-14 13:00:00-05:00,0,2,13,4,0,1679,21632,23311
2014-02-14 14:00:00-05:00,0,2,14,4,0,2025,22752,24777
2014-02-14 15:00:00-05:00,0,2,15,4,0,2403,21456,23859
2014-02-14 16:00:00-05:00,0,2,16,4,0,2794,17982,20776
2014-02-14 17:00:00-05:00,0,2,17,4,0,3233,23755,26988
2014-02-14 18:00:00-05:00,0,2,18,4,0,3547,30942,34489
2014-02-14 19:00:00-05:00,0,2,19,4,0,3829,34290,38119
2014-02-14 20:00:00-05:00,0,2,20,4,0,3723,33848,37571
2014-02-14 21:00:00-05:00,0,2,21,4,0,3490,31503,34993
2014-02-14 22:00:00-05:00,0,2,22,4,0,3184,30969,34153
2014-02-14 23:00:00-05:00,0,2,23,4,0,3174,31208,34382
2014-02-15 00:00:00-05:00,0,2,0,5,0,2897,28561,31458
2014-02-15 01:00:00-05:00,0,2,1,5,0,2500,23802,26302
2014-02-15 02:00:00-05:00,0,2,2,5,0,2005,19296,21301
2014-02-15 03:00:00-05:00,0,2,3,5,0,1721,15080,16801
2014-02-15 04:00:00-05:00,0,2,4,5,0,1416,10413,11829
2014-02-15 05:00:00-05:00,0,2,5,5,0,714,5303,6017
2014-02-15 06:00:00-05:00,0,2,6,5,0,432,5471,5903
2014-02-15 07:00:00-05:00,0,2,7,5,0,472,7167,7639
2014-02-15 08:00:00-05:00,0,2,8,5,0,748,10135,10883
2014-02-15 09:00:00-05:00,0,2,9,5,0,1002,14581,15583
2014-02-15 10:00:00-05:00,0,2,10,5,0,1214,18476,19690
2014-02-15 11:00:00-05:00,0,2,11,5,0,1386,22842,24228
2014-02-15 12:00:00-05:00,0,2,12,5,0,1393,23207,24600
2014-02-15 13:00:00-05:00,0,2,13,5,0,1705,23623,25328
2014-02-15 14:00:00-05:00,0,2,14,5,0,1781,22447,24228
2014-02-15 15:00:00-05:00,0,2,15,5,0,2065,22899,24964
2014-02-15 16:00:00-05:00,0.02,2,16,5,0,2397,22194,24591
2014-02-15 17:00:00-05:00,0.01,2,17,5,0,2441,23980,26421
2014-02-15 18:00:00-05:00,0.01,2,18,5,0,2609,28775,31384
2014-02-15 19:00:00-05:00,0.01,2,19,5,0,2682,31307,33989
2014-02-15 20:00:00-05:00,0,2,20,5,0,2725,26103,28828
2014-02-15 21:00:00-05:00,0,2,21,5,0,2626,25902,28528
2014-02-15 22:00:00-05:00,0,2,22,5,0,2647,28847,31494
2014-02-15 23:00:00-05:00,0,2,23,5,0,2613,30964,33577
2014-02-16 00:00:00-05:00,0,2,0,6,0,2448,29107,31555
2014-02-16 01:00:00-05:00,0,2,1,6,0,2183,25564,27747
2014-02-16 02:00:00-05:00,0,2,2,6,0,1885,21809,23694
2014-02-16 03:00:00-05:00,0,2,3,6,0,1562,16787,18349
2014-02-16 04:00:00-05:00,0,2,4,6,0,1281,10855,12136
2014-02-16 05:00:00-05:00,0,2,5,6,0,594,4712,5306
2014-02-16 06:00:00-05:00,0,2,6,6,0,402,4355,4757
2014-02-16 07:00:00-05:00,0,2,7,6,0,438,5638,6076
2014-02-16 08:00:00-05:00,0,2,8,6,0,515,8405,8920
2014-02-16 09:00:00-05:00,0,2,9,6,0,763,12936,13699
2014-02-16 10:00:00-05:00,0,2,10,6,0,1069,17254,18323
2014-02-16 11:00:00-05:00,0,2,11,6,0,1295,21025,22320
2014-02-16 12:00:00-05:00,0,2,12,6,0,1296,22988,24284
2014-02-16 13:00:00-05:00,0,2,13,6,0,1543,23857,25400
2014-02-16 14:00:00-05:00,0,2,14,6,0,1729,23206,24935
2014-02-16 15:00:00-05:00,0,2,15,6,0,1914,22598,24512
2014-02-16 16:00:00-05:00,0,2,16,6,0,2107,21721,23828
2014-02-16 17:00:00-05:00,0,2,17,6,0,2188,23885,26073
2014-02-16 18:00:00-05:00,0,2,18,6,0,2450,26663,29113
2014-02-16 19:00:00-05:00,0,2,19,6,0,2495,25462,27957
2014-02-16 20:00:00-05:00,0,2,20,6,0,2249,22990,25239
2014-02-16 21:00:00-05:00,0,2,21,6,0,2092,22509,24601
2014-02-16 22:00:00-05:00,0,2,22,6,0,2043,22529,24572
2014-02-16 23:00:00-05:00,0,2,23,6,0,1849,20477,22326
2014-02-17 00:00:00-05:00,0,2,0,0,1,1604,15682,17286
2014-02-17 01:00:00-05:00,0,2,1,0,1,1208,11255,12463
2014-02-17 02:00:00-05:00,0,2,2,0,1,792,8150,8942
2014-02-17 03:00:00-05:00,0,2,3,0,1,592,5794,6386
2014-02-17 04:00:00-05:00,0,2,4,0,1,493,4738,5231
2014-02-17 05:00:00-05:00,0,2,5,0,1,354,3640,3994
2014-02-17 06:00:00-05:00,0,2,6,0,1,376,5970,6346
2014-02-17 07:00:00-05:00,0,2,7,0,1,575,8655,9230
2014-02-17 08:00:00-05:00,0,2,8,0,1,842,14095,14937
2014-02-17 09:00:00-05:00,0,2,9,0,1,987,16715,17702
2014-02-17 10:00:00-05:00,0,2,10,0,1,1024,18123,19147
2014-02-17 11:00:00-05:00,0,2,11,0,1,1131,20001,21132
2014-02-17 12:00:00-05:00,0,2,12,0,1,1189,21432,22621
2014-02-17 13:00:00-05:00,0,2,13,0,1,1373,21869,23242
2014-02-17 14:00:00-05:00,0,2,14,0,1,1449,21988,23437
2014-02-17 15:00:00-05:00,0,2,15,0,1,1611,21939,23550
2014-02-17 16:00:00-05:00,0,2,16,0,1,1952,20384,22336
2014-02-17 17:00:00-05:00,0,2,17,0,1,1964,22771,24735
2014-02-17 18:00:00-05:00,0,2,18,0,1,2109,26832,28941
2014-02-17 19:00:00-05:00,0,2,19,0,1,2095,25332,27427
2014-02-17 20:00:00-05:00,0,2,20,0,1,1874,21812,23686
2014-02-17 21:00:00-05:00,0,2,21,0,1,1569,20223,21792
2014-02-17 22:00:00-05:00,0,2,22,0,1,1403,19177,20580
2014-02-17 23:00:00-05:00,0,2,23,0,1,1090,15146,16236
2014-02-18 00:00:00-05:00,0,2,0,1,0,834,9388,10222
2014-02-18 01:00:00-05:00,0,2,1,1,0,506,5678,6184
2014-02-18 02:00:00-05:00,0,2,2,1,0,318,3296,3614
2014-02-18 03:00:00-05:00,0,2,3,1,0,244,2117,2361
2014-02-18 04:00:00-05:00,0,2,4,1,0,274,2507,2781
2014-02-18 05:00:00-05:00,0.01,2,5,1,0,228,4618,4846
2014-02-18 06:00:00-05:00,0.04,2,6,1,0,339,11829,12168
2014-02-18 07:00:00-05:00,0.05,2,7,1,0,757,18960,19717
2014-02-18 08:00:00-05:00,0.03,2,8,1,0,1258,23340,24598
2014-02-18 09:00:00-05:00,0.02,2,9,1,0,1396,23053,24449
2014-02-18 10:00:00-05:00,0,2,10,1,0,1293,20759,22052
2014-02-18 11:00:00-05:00,0,2,11,1,0,1151,19696,20847
2014-02-18 12:00:00-05:00,0,2,12,1,0,1229,20129,21358
2014-02-18 13:00:00-05:00,0,2,13,1,0,1316,20013,21329
2014-02-18 14:00:00-05:00,0,2,14,1,0,1412,20278,21690
2014-02-18 15:00:00-05:00,0,2,15,1,0,1521,20489,22010
2014-02-18 16:00:00-05:00,0,2,16,1,0,1879,18004,19883
2014-02-18 17:00:00-05:00,0,2,17,1,0,2065,22539,24604
2014-02-18 18:00:00-05:00,0,2,18,1,0,2169,28685,30854
2014-02-18 19:00:00-05:00,0,2,19,1,0,2195,29149,31344
2014-02-18 20:00:00-05:00,0,2,20,1,0,1876,27485,29361
2014-02-18 21:00:00-05:00,0,2,21,1,0,1615,26834,28449
2014-02-18 22:00:00-05:00,0,2,22,1,0,1407,23191,24598
2014-02-18 23:00:00-05:00,0,2,23,1,0,1181,17618,18799
2014-02-19 00:00:00-05:00,0,2,0,2,0,899,11886,12785
2014-02-19 01:00:00-05:00,0,2,1,2,0,560,6736,7296
2014-02-19 02:00:00-05:00,0,2,2,2,0,385,4175,4560
2014-02-19 03:00:00-05:00,0,2,3,2,0,283,2961,3244
2014-02-19 04:00:00-05:00,0,2,4,2,0,303,2812,3115
2014-02-19 05:00:00-05:00,0,2,5,2,0,232,4406,4638
2014-02-19 06:00:00-05:00,0,2,6,2,0,383,11715,12098
2014-02-19 07:00:00-05:00,0,2,7,2,0,813,21274,22087
2014-02-19 08:00:00-05:00,0,2,8,2,0,1447,24871,26318
2014-02-19 09:00:00-05:00,0,2,9,2,0,1600,24462,26062
2014-02-19 10:00:00-05:00,0,2,10,2,0,1383,21499,22882
2014-02-19 11:00:00-05:00,0.06,2,11,2,0,1687,24071,25758
2014-02-19 12:00:00-05:00,0.14,2,12,2,0,1713,23139,24852
2014-02-19 13:00:00-05:00,0.04,2,13,2,0,1516,20443,21959
2014-02-19 14:00:00-05:00,0,2,14,2,0,1551,19892,21443
2014-02-19 15:00:00-05:00,0,2,15,2,0,1682,18899,20581
2014-02-19 16:00:00-05:00,0,2,16,2,0,1855,16221,18076
2014-02-19 17:00:00-05:00,0,2,17,2,0,2190,22173,24363
2014-02-19 18:00:00-05:00,0.01,2,18,2,0,2380,28340,30720
2014-02-19 19:00:00-05:00,0,2,19,2,0,2167,30454,32621
2014-02-19 20:00:00-05:00,0,2,20,2,0,2025,29241,31266
2014-02-19 21:00:00-05:00,0,2,21,2,0,1832,28895,30727
2014-02-19 22:00:00-05:00,0,2,22,2,0,1589,26758,28347
2014-02-19 23:00:00-05:00,0,2,23,2,0,1329,20803,22132
2014-02-20 00:00:00-05:00,0,2,0,3,0,1031,13588,14619
2014-02-20 01:00:00-05:00,0,2,1,3,0,672,8196,8868
2014-02-20 02:00:00-05:00,0,2,2,3,0,478,5292,5770
2014-02-20 03:00:00-05:00,0,2,3,3,0,341,3280,3621
2014-02-20 04:00:00-05:00,0,2,4,3,0,311,3185,3496
2014-02-20 05:00:00-05:00,0,2,5,3,0,241,4579,4820
2014-02-20 06:00:00-05:00,0,2,6,3,0,410,12089,12499
2014-02-20 07:00:00-05:00,0,2,7,3,0,999,21460,22459
2014-02-20 08:00:00-05:00,0,2,8,3,0,1443,25052,26495
2014-02-20 09:00:00-05:00,0,2,9,3,0,1600,24729,26329
2014-02-20 10:00:00-05:00,0,2,10,3,0,1485,22071,23556
2014-02-20 11:00:00-05:00,0,2,11,3,0,1423,21405,22828
2014-02-20 12:00:00-05:00,0,2,12,3,0,1469,22051,23520
2014-02-20 13:00:00-05:00,0,2,13,3,0,1541,21484,23025
2014-02-20 14:00:00-05:00,0,2,14,3,0,1698,22859,24557
2014-02-20 15:00:00-05:00,0,2,15,3,0,1877,21702,23579
2014-02-20 16:00:00-05:00,0,2,16,3,0,2236,16758,18994
2014-02-20 17:00:00-05:00,0,2,17,3,0,2445,21094,23539
2014-02-20 18:00:00-05:00,0,2,18,3,0,2606,28068,30674
2014-02-20 19:00:00-05:00,0,2,19,3,0,2485,30311,32796
2014-02-20 20:00:00-05:00,0,2,20,3,0,2499,30425,32924
2014-02-20 21:00:00-05:00,0.01,2,21,3,0,2543,30603,33146
2014-02-20 22:00:00-05:00,0.01,2,22,3,0,1960,29046,31006
2014-02-20 23:00:00-05:00,0,2,23,3,0,1706,26693,28399
2014-02-21 00:00:00-05:00,0,2,0,4,0,1384,20178,21562
2014-02-21 01:00:00-05:00,0,2,1,4,0,900,12490,13390
2014-02-21 02:00:00-05:00,0,2,2,4,0,620,8381,9001
2014-02-21 03:00:00-05:00,0,2,3,4,0,449,5739,6188
2014-02-21 04:00:00-05:00,0,2,4,4,0,411,4570,4981
2014-02-21 05:00:00-05:00,0,2,5,4,0,243,4951,5194
2014-02-21 06:00:00-05:00,0,2,6,4,0,425,11957,12382
2014-02-21 07:00:00-05:00,0,2,7,4,0,959,21935,22894
2014-02-21 08:00:00-05:00,0,2,8,4,0,1484,26406,27890
2014-02-21 09:00:00-05:00,0,2,9,4,0,1599,25568,27167
2014-02-21 10:00:00-05:00,0,2,10,4,0,1502,22436,23938
2014-02-21 11:00:00-05:00,0,2,11,4,0,1474,22176,23650
2014-02-21 12:00:00-05:00,0,2,12,4,0,1439,22788,24227
2014-02-21 13:00:00-05:00,0,2,13,4,0,1495,22172,23667
2014-02-21 14:00:00-05:00,0,2,14,4,0,1691,23244,24935
2014-02-21 15:00:00-05:00,0.09,2,15,4,0,2345,22886,25231
2014-02-21 16:00:00-05:00,0.02,2,16,4,0,2350,17219,19569
2014-02-21 17:00:00-05:00,0,2,17,4,0,2629,22775,25404
2014-02-21 18:00:00-05:00,0,2,18,4,0,2988,29965,32953
2014-02-21 19:00:00-05:00,0,2,19,4,0,2866,33078,35944
2014-02-21 20:00:00-05:00,0,2,20,4,0,2810,31152,33962
2014-02-21 21:00:00-05:00,0,2,21,4,0,2762,29847,32609
2014-02-21 22:00:00-05:00,0,2,22,4,0,2671,30461,33132
2014-02-21 23:00:00-05:00,0,2,23,4,0,2711,31141,33852
2014-02-22 00:00:00-05:00,0,2,0,5,0,2690,29209,31899
2014-02-22 01:00:00-05:00,0,2,1,5,0,2447,25438,27885
2014-02-22 02:00:00-05:00,0,2,2,5,0,1947,21168,23115
2014-02-22 03:00:00-05:00,0,2,3,5,0,1645,16048,17693
2014-02-22 04:00:00-05:00,0,2,4,5,0,1297,10747,12044
2014-02-22 05:00:00-05:00,0,2,5,5,0,659,5302,5961
2014-02-22 06:00:00-05:00,0,2,6,5,0,478,5534,6012
2014-02-22 07:00:00-05:00,0,2,7,5,0,570,7480,8050
2014-02-22 08:00:00-05:00,0,2,8,5,0,829,11795,12624
2014-02-22 09:00:00-05:00,0,2,9,5,0,1121,16725,17846
2014-02-22 10:00:00-05:00,0,2,10,5,0,1283,20209,21492
2014-02-22 11:00:00-05:00,0,2,11,5,0,1364,22298,23662
2014-02-22 12:00:00-05:00,0,2,12,5,0,1524,24343,25867
2014-02-22 13:00:00-05:00,0,2,13,5,0,1728,24912,26640
2014-02-22 14:00:00-05:00,0,2,14,5,0,1913,24009,25922
2014-02-22 15:00:00-05:00,0,2,15,5,0,2186,24301,26487
2014-02-22 16:00:00-05:00,0,2,16,5,0,2410,21189,23599
2014-02-22 17:00:00-05:00,0,2,17,5,0,2718,24131,26849
2014-02-22 18:00:00-05:00,0,2,18,5,0,3074,30918,33992
2014-02-22 19:00:00-05:00,0,2,19,5,0,3190,33210,36400
2014-02-22 20:00:00-05:00,0,2,20,5,0,3341,29718,33059
2014-02-22 21:00:00-05:00,0,2,21,5,0,3409,29054,32463
2014-02-22 22:00:00-05:00,0,2,22,5,0,3370,31498,34868
2014-02-22 23:00:00-05:00,0,2,23,5,0,3326,32844,36170
2014-02-23 00:00:00-05:00,0,2,0,6,0,3255,31761,35016
2014-02-23 01:00:00-05:00,0,2,1,6,0,3017,28513,31530
2014-02-23 02:00:00-05:00,0,2,2,6,0,2561,25032,27593
2014-02-23 03:00:00-05:00,0,2,3,6,0,2181,19739,21920
2014-02-23 04:00:00-05:00,0,2,4,6,0,1766,12555,14321
2014-02-23 05:00:00-05:00,0,2,5,6,0,813,5667,6480
2014-02-23 06:00:00-05:00,0,2,6,6,0,521,5247,5768
2014-02-23 07:00:00-05:00,0,2,7,6,0,434,6337,6771
2014-02-23 08:00:00-05:00,0,2,8,6,0,567,10387,10954
2014-02-23 09:00:00-05:00,0,2,9,6,0,732,13731,14463
2014-02-23 10:00:00-05:00,0,2,10,6,0,969,18032,19001
2014-02-23 11:00:00-05:00,0,2,11,6,0,1158,21094,22252
2014-02-23 12:00:00-05:00,0,2,12,6,0,1278,23096,24374
2014-02-23 13:00:00-05:00,0,2,13,6,0,1439,23137,24576
2014-02-23 14:00:00-05:00,0,2,14,6,0,1691,22643,24334
2014-02-23 15:00:00-05:00,0,2,15,6,0,1692,21359,23051
2014-02-23 16:00:00-05:00,0,2,16,6,0,1848,19914,21762
2014-02-23 17:00:00-05:00,0,2,17,6,0,2092,21580,23672
2014-02-23 18:00:00-05:00,0,2,18,6,0,2286,24053,26339
2014-02-23 19:00:00-05:00,0,2,19,6,0,2321,22386,24707
2014-02-23 20:00:00-05:00,0,2,20,6,0,2230,19553,21783
2014-02-23 21:00:00-05:00,0,2,21,6,0,1823,17659,19482
2014-02-23 22:00:00-05:00,0,2,22,6,0,1667,15950,17617
2014-02-23 23:00:00-05:00,0,2,23,6,0,1457,13033,14490
2014-02-24 00:00:00-05:00,0,2,0,0,0,1051,8450,9501
2014-02-24 01:00:00-05:00,0,2,1,0,0,670,5037,5707
2014-02-24 02:00:00-05:00,0,2,2,0,0,411,3418,3829
2014-02-24 03:00:00-05:00,0,2,3,0,0,329,2395,2724
2014-02-24 04:00:00-05:00,0,2,4,0,0,377,2769,3146
2014-02-24 05:00:00-05:00,0,2,5,0,0,288,4677,4965
2014-02-24 06:00:00-05:00,0,2,6,0,0,486,12497,12983
2014-02-24 07:00:00-05:00,0,2,7,0,0,1222,21742,22964
2014-02-24 08:00:00-05:00,0,2,8,0,0,1778,25502,27280
2014-02-24 09:00:00-05:00,0,2,9,0,0,1647,23951,25598
2014-02-24 10:00:00-05:00,0,2,10,0,0,1403,20591,21994
2014-02-24 11:00:00-05:00,0,2,11,0,0,1347,20098,21445
2014-02-24 12:00:00-05:00,0,2,12,0,0,1352,20284,21636
2014-02-24 13:00:00-05:00,0,2,13,0,0,1419,20940,22359
2014-02-24 14:00:00-05:00,0,2,14,0,0,1596,22609,24205
2014-02-24 15:00:00-05:00,0,2,15,0,0,2006,22870,24876
2014-02-24 16:00:00-05:00,0,2,16,0,0,2070,20225,22295
2014-02-24 17:00:00-05:00,0,2,17,0,0,2342,24658,27000
2014-02-24 18:00:00-05:00,0,2,18,0,0,2431,30846,33277
2014-02-24 19:00:00-05:00,0,2,19,0,0,2368,30256,32624
2014-02-24 20:00:00-05:00,0,2,20,0,0,2061,28205,30266
2014-02-24 21:00:00-05:00,0,2,21,0,0,1688,26661,28349
2014-02-24 22:00:00-05:00,0,2,22,0,0,1483,24163,25646
2014-02-24 23:00:00-05:00,0,2,23,0,0,1132,16636,17768
2014-02-25 00:00:00-05:00,0,2,0,1,0,867,10115,10982
2014-02-25 01:00:00-05:00,0,2,1,1,0,489,5690,6179
2014-02-25 02:00:00-05:00,0,2,2,1,0,335,3532,3867
2014-02-25 03:00:00-05:00,0,2,3,1,0,257,2350,2607
2014-02-25 04:00:00-05:00,0,2,4,1,0,299,2495,2794
2014-02-25 05:00:00-05:00,0,2,5,1,0,231,4343,4574
2014-02-25 06:00:00-05:00,0,2,6,1,0,429,12553,12982
2014-02-25 07:00:00-05:00,0,2,7,1,0,1193,23534,24727
2014-02-25 08:00:00-05:00,0,2,8,1,0,1849,27936,29785
2014-02-25 09:00:00-05:00,0,2,9,1,0,1726,25867,27593
2014-02-25 10:00:00-05:00,0,2,10,1,0,1469,23046,24515
2014-02-25 11:00:00-05:00,0,2,11,1,0,1433,22038,23471
2014-02-25 12:00:00-05:00,0,2,12,1,0,1435,22922,24357
2014-02-25 13:00:00-05:00,0,2,13,1,0,1449,22508,23957
2014-02-25 14:00:00-05:00,0,2,14,1,0,1630,24081,25711
2014-02-25 15:00:00-05:00,0,2,15,1,0,1856,23523,25379
2014-02-25 16:00:00-05:00,0,2,16,1,0,2107,19228,21335
2014-02-25 17:00:00-05:00,0,2,17,1,0,2377,24505,26882
2014-02-25 18:00:00-05:00,0,2,18,1,0,2663,30704,33367
2014-02-25 19:00:00-05:00,0,2,19,1,0,2525,31928,34453
2014-02-25 20:00:00-05:00,0,2,20,1,0,2302,30771,33073
2014-02-25 21:00:00-05:00,0,2,21,1,0,1930,30983,32913
2014-02-25 22:00:00-05:00,0,2,22,1,0,1617,27672,29289
2014-02-25 23:00:00-05:00,0,2,23,1,0,1359,20059,21418
2014-02-26 00:00:00-05:00,0,2,0,2,0,998,12270,13268
2014-02-26 01:00:00-05:00,0,2,1,2,0,586,7148,7734
2014-02-26 02:00:00-05:00,0,2,2,2,0,379,4438,4817
2014-02-26 03:00:00-05:00,0,2,3,2,0,261,2971,3232
2014-02-26 04:00:00-05:00,0,2,4,2,0,284,3071,3355
2014-02-26 05:00:00-05:00,0,2,5,2,0,240,4562,4802
2014-02-26 06:00:00-05:00,0,2,6,2,0,457,12536,12993
2014-02-26 07:00:00-05:00,0,2,7,2,0,1177,24075,25252
2014-02-26 08:00:00-05:00,0,2,8,2,0,1887,28208,30095
2014-02-26 09:00:00-05:00,0,2,9,2,0,1759,26691,28450
2014-02-26 10:00:00-05:00,0.01,2,10,2,0,1614,23680,25294
2014-02-26 11:00:00-05:00,0,2,11,2,0,1470,21700,23170
2014-02-26 12:00:00-05:00,0,2,12,2,0,1489,22982,24471
2014-02-26 13:00:00-05:00,0,2,13,2,0,1520,22069,23589
2014-02-26 14:00:00-05:00,0,2,14,2,0,1691,23421,25112
2014-02-26 15:00:00-05:00,0,2,15,2,0,1946,23288,25234
2014-02-26 16:00:00-05:00,0,2,16,2,0,2228,19261,21489
2014-02-26 17:00:00-05:00,0,2,17,2,0,2511,25041,27552
2014-02-26 18:00:00-05:00,0,2,18,2,0,2756,32498,35254
2014-02-26 19:00:00-05:00,0,2,19,2,0,2688,34298,36986
2014-02-26 20:00:00-05:00,0,2,20,2,0,2428,33397,35825
2014-02-26 21:00:00-05:00,0,2,21,2,0,2127,32662,34789
2014-02-26 22:00:00-05:00,0,2,22,2,0,1804,29807,31611
2014-02-26 23:00:00-05:00,0,2,23,2,0,1449,22908,24357
2014-02-27 00:00:00-05:00,0,2,0,3,0,1176,14398,15574
2014-02-27 01:00:00-05:00,0,2,1,3,0,721,8350,9071
2014-02-27 02:00:00-05:00,0,2,2,3,0,466,5100,5566
2014-02-27 03:00:00-05:00,0,2,3,3,0,334,3402,3736
2014-02-27 04:00:00-05:00,0,2,4,3,0,351,3154,3505
2014-02-27 05:00:00-05:00,0,2,5,3,0,263,4465,4728
2014-02-27 06:00:00-05:00,0,2,6,3,0,464,13385,13849
2014-02-27 07:00:00-05:00,0,2,7,3,0,1218,24052,25270
2014-02-27 08:00:00-05:00,0,2,8,3,0,1820,27955,29775
2014-02-27 09:00:00-05:00,0,2,9,3,0,1668,26341,28009
2014-02-27 10:00:00-05:00,0,2,10,3,0,1588,23653,25241
2014-02-27 11:00:00-05:00,0,2,11,3,0,1539,23056,24595
2014-02-27 12:00:00-05:00,0,2,12,3,0,1477,23890,25367
2014-02-27 13:00:00-05:00,0,2,13,3,0,1601,23431,25032
2014-02-27 14:00:00-05:00,0,2,14,3,0,1910,25166,27076
2014-02-27 15:00:00-05:00,0,2,15,3,0,2181,23548,25729
2014-02-27 16:00:00-05:00,0,2,16,3,0,2449,18819,21268
2014-02-27 17:00:00-05:00,0,2,17,3,0,2807,24746,27553
2014-02-27 18:00:00-05:00,0,2,18,3,0,3049,32237,35286
2014-02-27 19:00:00-05:00,0,2,19,3,0,3151,34565,37716
2014-02-27 20:00:00-05:00,0,2,20,3,0,2978,34288,37266
2014-02-27 21:00:00-05:00,0,2,21,3,0,2834,33572,36406
2014-02-27 22:00:00-05:00,0,2,22,3,0,2321,32287,34608
2014-02-27 23:00:00-05:00,0,2,23,3,0,2101,28482,30583
2014-02-28 00:00:00-05:00,0,2,0,4,0,1580,20476,22056
2014-02-28 01:00:00-05:00,0,2,1,4,0,966,12890,13856
2014-02-28 02:00:00-05:00,0,2,2,4,0,602,8287,8889
2014-02-28 03:00:00-05:00,0,2,3,4,0,469,5310,5779
2014-02-28 04:00:00-05:00,0,2,4,4,0,457,4334,4791
2014-02-28 05:00:00-05:00,0,2,5,4,0,354,5309,5663
2014-02-28 06:00:00-05:00,0,2,6,4,0,524,13793,14317
2014-02-28 07:00:00-05:00,0,2,7,4,0,1351,24407,25758
2014-02-28 08:00:00-05:00,0,2,8,4,0,2104,28723,30827
2014-02-28 09:00:00-05:00,0,2,9,4,0,1941,27087,29028
2014-02-28 10:00:00-05:00,0,2,10,4,0,1823,24938,26761
2014-02-28 11:00:00-05:00,0,2,11,4,0,1665,24876,26541
2014-02-28 12:00:00-05:00,0,2,12,4,0,1740,24774,26514
2014-02-28 13:00:00-05:00,0,2,13,4,0,1726,24777,26503
2014-02-28 14:00:00-05:00,0,2,14,4,0,2073,26269,28342
2014-02-28 15:00:00-05:00,0,2,15,4,0,2394,23768,26162
2014-02-28 16:00:00-05:00,0,2,16,4,0,2818,19173,21991
2014-02-28 17:00:00-05:00,0,2,17,4,0,3190,24993,28183
2014-02-28 18:00:00-05:00,0,2,18,4,0,3473,32009,35482
2014-02-28 19:00:00-05:00,0,2,19,4,0,3686,35779,39465
2014-02-28 20:00:00-05:00,0,2,20,4,0,3692,34345,38037
2014-02-28 21:00:00-05:00,0,2,21,4,0,3270,33204,36474
2014-02-28 22:00:00-05:00,0,2,22,4,0,3290,32617,35907
2014-02-28 23:00:00-05:00,0,2,23,4,0,3240,32225,35465
2014-03-01 00:00:00-05:00,0,3,0,5,0,2793,30487,33280
2014-03-01 01:00:00-05:00,0,3,1,5,0,2456,26237,28693
2014-03-01 02:00:00-05:00,0,3,2,5,0,1931,21751,23682
2014-03-01 03:00:00-05:00,0,3,3,5,0,1578,16295,17873
2014-03-01 04:00:00-05:00,0,3,4,5,0,1229,10702,11931
2014-03-01 05:00:00-05:00,0,3,5,5,0,641,5170,5811
2014-03-01 06:00:00-05:00,0,3,6,5,0,453,5871,6324
2014-03-01 07:00:00-05:00,0,3,7,5,0,551,7947,8498
2014-03-01 08:00:00-05:00,0,3,8,5,0,933,12897,13830
2014-03-01 09:00:00-05:00,0,3,9,5,0,1169,19126,20295
2014-03-01 10:00:00-05:00,0,3,10,5,0,1291,22456,23747
2014-03-01 11:00:00-05:00,0,3,11,5,0,1425,25466,26891
2014-03-01 12:00:00-05:00,0,3,12,5,0,1604,26922,28526
2014-03-01 13:00:00-05:00,0,3,13,5,0,1774,27987,29761
2014-03-01 14:00:00-05:00,0,3,14,5,0,2029,26351,28380
2014-03-01 15:00:00-05:00,0,3,15,5,0,2409,26833,29242
2014-03-01 16:00:00-05:00,0,3,16,5,0,2627,22973,25600
2014-03-01 17:00:00-05:00,0,3,17,5,0,2906,26694,29600
2014-03-01 18:00:00-05:00,0,3,18,5,0,3154,32332,35486
2014-03-01 19:00:00-05:00,0,3,19,5,0,3338,33984,37322
2014-03-01 20:00:00-05:00,0,3,20,5,0,3482,30599,34081
2014-03-01 21:00:00-05:00,0,3,21,5,0,3345,30250,33595
2014-03-01 22:00:00-05:00,0,3,22,5,0,3239,32344,35583
2014-03-01 23:00:00-05:00,0,3,23,5,0,3215,33232,36447
2014-03-02 00:00:00-05:00,0,3,0,6,0,3162,31563,34725
2014-03-02 01:00:00-05:00,0,3,1,6,0,2931,27997,30928
2014-03-02 02:00:00-05:00,0,3,2,6,0,2428,24795,27223
2014-03-02 03:00:00-05:00,0,3,3,6,0,1982,18781,20763
2014-03-02 04:00:00-05:00,0,3,4,6,0,1566,12102,13668
2014-03-02 05:00:00-05:00,0,3,5,6,0,745,5418,6163
2014-03-02 06:00:00-05:00,0,3,6,6,0,465,5295,5760
2014-03-02 07:00:00-05:00,0,3,7,6,0,460,6576,7036
2014-03-02 08:00:00-05:00,0,3,8,6,0,570,9881,10451
2014-03-02 09:00:00-05:00,0,3,9,6,0,828,14817,15645
2014-03-02 10:00:00-05:00,0,3,10,6,0,1070,20091,21161
2014-03-02 11:00:00-05:00,0,3,11,6,0,1236,23289,24525
2014-03-02 12:00:00-05:00,0,3,12,6,0,1422,25738,27160
2014-03-02 13:00:00-05:00,0,3,13,6,0,1696,26168,27864
2014-03-02 14:00:00-05:00,0,3,14,6,0,1749,25667,27416
2014-03-02 15:00:00-05:00,0,3,15,6,0,1928,23392,25320
2014-03-02 16:00:00-05:00,0,3,16,6,0,2109,22318,24427
2014-03-02 17:00:00-05:00,0,3,17,6,0,2218,24462,26680
2014-03-02 18:00:00-05:00,0,3,18,6,0,2331,26708,29039
2014-03-02 19:00:00-05:00,0,3,19,6,0,2239,24050,26289
2014-03-02 20:00:00-05:00,0,3,20,6,0,1923,17482,19405
2014-03-02 21:00:00-05:00,0,3,21,6,0,1595,16420,18015
2014-03-02 22:00:00-05:00,0,3,22,6,0,1522,16393,17915
2014-03-02 23:00:00-05:00,0,3,23,6,0,1273,12662,13935
2014-03-03 00:00:00-05:00,0,3,0,0,0,1269,16400,17669
2014-03-03 01:00:00-05:00,0,3,1,0,0,733,5821,6554
2014-03-03 02:00:00-05:00,0,3,2,0,0,447,3502,3949
2014-03-03 03:00:00-05:00,0.01,3,3,0,0,295,2358,2653
2014-03-03 04:00:00-05:00,0,3,4,0,0,311,2372,2683
2014-03-03 05:00:00-05:00,0,3,5,0,0,230,3793,4023
2014-03-03 06:00:00-05:00,0,3,6,0,0,435,11896,12331
2014-03-03 07:00:00-05:00,0,3,7,0,0,1237,21581,22818
2014-03-03 08:00:00-05:00,0,3,8,0,0,1884,26714,28598
2014-03-03 09:00:00-05:00,0,3,9,0,0,1846,25981,27827
2014-03-03 10:00:00-05:00,0,3,10,0,0,1745,24517,26262
2014-03-03 11:00:00-05:00,0,3,11,0,0,1576,21738,23314
2014-03-03 12:00:00-05:00,0,3,12,0,0,1600,21554,23154
2014-03-03 13:00:00-05:00,0,3,13,0,0,1585,21350,22935
2014-03-03 14:00:00-05:00,0,3,14,0,0,1733,23319,25052
2014-03-03 15:00:00-05:00,0,3,15,0,0,1993,23938,25931
2014-03-03 16:00:00-05:00,0,3,16,0,0,2206,21357,23563
2014-03-03 17:00:00-05:00,0,3,17,0,0,2456,26136,28592
2014-03-03 18:00:00-05:00,0,3,18,0,0,2529,32278,34807
2014-03-03 19:00:00-05:00,0,3,19,0,0,2503,31227,33730
2014-03-03 20:00:00-05:00,0,3,20,0,0,2143,28410,30553
2014-03-03 21:00:00-05:00,0,3,21,0,0,1789,26498,28287
2014-03-03 22:00:00-05:00,0,3,22,0,0,1477,23998,25475
2014-03-03 23:00:00-05:00,0,3,23,0,0,1213,17244,18457
2014-03-04 00:00:00-05:00,0,3,0,1,0,896,10415,11311
2014-03-04 01:00:00-05:00,0,3,1,1,0,513,6144,6657
2014-03-04 02:00:00-05:00,0,3,2,1,0,356,3584,3940
2014-03-04 03:00:00-05:00,0,3,3,1,0,239,2381,2620
2014-03-04 04:00:00-05:00,0,3,4,1,0,293,2678,2971
2014-03-04 05:00:00-05:00,0,3,5,1,0,224,4633,4857
2014-03-04 06:00:00-05:00,0,3,6,1,0,467,13532,13999
2014-03-04 07:00:00-05:00,0,3,7,1,0,1281,24722,26003
2014-03-04 08:00:00-05:00,0,3,8,1,0,1949,29640,31589
2014-03-04 09:00:00-05:00,0,3,9,1,0,1760,28054,29814
2014-03-04 10:00:00-05:00,0,3,10,1,0,1644,24354,25998
2014-03-04 11:00:00-05:00,0,3,11,1,0,1532,23160,24692
2014-03-04 12:00:00-05:00,0,3,12,1,0,1472,23947,25419
2014-03-04 13:00:00-05:00,0,3,13,1,0,1427,23481,24908
2014-03-04 14:00:00-05:00,0,3,14,1,0,1758,25397,27155
2014-03-04 15:00:00-05:00,0,3,15,1,0,2002,25023,27025
2014-03-04 16:00:00-05:00,0,3,16,1,0,2205,20904,23109
2014-03-04 17:00:00-05:00,0,3,17,1,0,2515,26628,29143
2014-03-04 18:00:00-05:00,0,3,18,1,0,2663,32703,35366
2014-03-04 19:00:00-05:00,0,3,19,1,0,2494,33755,36249
2014-03-04 20:00:00-05:00,0,3,20,1,0,2243,31918,34161
2014-03-04 21:00:00-05:00,0,3,21,1,0,1907,31178,33085
2014-03-04 22:00:00-05:00,0,3,22,1,0,1607,28363,29970
2014-03-04 23:00:00-05:00,0,3,23,1,0,1404,22755,24159
2014-03-05 00:00:00-05:00,0,3,0,2,0,996,13712,14708
2014-03-05 01:00:00-05:00,0,3,1,2,0,611,7904,8515
2014-03-05 02:00:00-05:00,0,3,2,2,0,380,4816,5196
2014-03-05 03:00:00-05:00,0,3,3,2,0,265,3182,3447
2014-03-05 04:00:00-05:00,0,3,4,2,0,272,3103,3375
2014-03-05 05:00:00-05:00,0,3,5,2,0,211,4662,4873
2014-03-05 06:00:00-05:00,0,3,6,2,0,456,12916,13372
2014-03-05 07:00:00-05:00,0,3,7,2,0,1277,24571,25848
2014-03-05 08:00:00-05:00,0,3,8,2,0,1992,28534,30526
2014-03-05 09:00:00-05:00,0,3,9,2,0,1765,26914,28679
2014-03-05 10:00:00-05:00,0,3,10,2,0,1569,23626,25195
2014-03-05 11:00:00-05:00,0,3,11,2,0,1508,23247,24755
2014-03-05 12:00:00-05:00,0,3,12,2,0,1536,23822,25358
2014-03-05 13:00:00-05:00,0,3,13,2,0,1598,23604,25202
2014-03-05 14:00:00-05:00,0,3,14,2,0,1922,25224,27146
2014-03-05 15:00:00-05:00,0,3,15,2,0,2126,24559,26685
2014-03-05 16:00:00-05:00,0,3,16,2,0,2268,19668,21936
2014-03-05 17:00:00-05:00,0,3,17,2,0,2595,25965,28560
2014-03-05 18:00:00-05:00,0,3,18,2,0,2757,32795,35552
2014-03-05 19:00:00-05:00,0,3,19,2,0,2667,34670,37337
2014-03-05 20:00:00-05:00,0,3,20,2,0,2485,33477,35962
2014-03-05 21:00:00-05:00,0,3,21,2,0,2263,32531,34794
2014-03-05 22:00:00-05:00,0,3,22,2,0,2018,30529,32547
2014-03-05 23:00:00-05:00,0,3,23,2,0,1660,24350,26010
2014-03-06 00:00:00-05:00,0,3,0,3,0,1247,15449,16696
2014-03-06 01:00:00-05:00,0,3,1,3,0,787,8800,9587
2014-03-06 02:00:00-05:00,0,3,2,3,0,498,5655,6153
2014-03-06 03:00:00-05:00,0,3,3,3,0,345,3521,3866
2014-03-06 04:00:00-05:00,0,3,4,3,0,352,3410,3762
2014-03-06 05:00:00-05:00,0,3,5,3,0,274,4952,5226
2014-03-06 06:00:00-05:00,0,3,6,3,0,523,13938,14461
2014-03-06 07:00:00-05:00,0,3,7,3,0,1296,25581,26877
2014-03-06 08:00:00-05:00,0,3,8,3,0,2012,29613,31625
2014-03-06 09:00:00-05:00,0,3,9,3,0,1920,27987,29907
2014-03-06 10:00:00-05:00,0,3,10,3,0,1603,25590,27193
2014-03-06 11:00:00-05:00,0,3,11,3,0,1600,25117,26717
2014-03-06 12:00:00-05:00,0,3,12,3,0,1629,25456,27085
2014-03-06 13:00:00-05:00,0,3,13,3,0,1670,24743,26413
2014-03-06 14:00:00-05:00,0,3,14,3,0,1919,26349,28268
2014-03-06 15:00:00-05:00,0,3,15,3,0,2105,24946,27051
2014-03-06 16:00:00-05:00,0,3,16,3,0,2346,19606,21952
2014-03-06 17:00:00-05:00,0,3,17,3,0,2766,25899,28665
2014-03-06 18:00:00-05:00,0,3,18,3,0,3019,32382,35401
2014-03-06 19:00:00-05:00,0,3,19,3,0,3000,34787,37787
2014-03-06 20:00:00-05:00,0,3,20,3,0,2803,33461,36264
2014-03-06 21:00:00-05:00,0,3,21,3,0,2535,33248,35783
2014-03-06 22:00:00-05:00,0,3,22,3,0,2300,31916,34216
2014-03-06 23:00:00-05:00,0,3,23,3,0,1961,28731,30692
2014-03-07 00:00:00-05:00,0,3,0,4,0,1545,20618,22163
2014-03-07 01:00:00-05:00,0,3,1,4,0,1097,13163,14260
2014-03-07 02:00:00-05:00,0,3,2,4,0,700,8512,9212
2014-03-07 03:00:00-05:00,0,3,3,4,0,487,5847,6334
2014-03-07 04:00:00-05:00,0,3,4,4,0,405,4557,4962
2014-03-07 05:00:00-05:00,0,3,5,4,0,288,5338,5626
2014-03-07 06:00:00-05:00,0,3,6,4,0,528,13569,14097
2014-03-07 07:00:00-05:00,0,3,7,4,0,1308,24561,25869
2014-03-07 08:00:00-05:00,0,3,8,4,0,2029,28832,30861
2014-03-07 09:00:00-05:00,0,3,9,4,0,1901,27177,29078
2014-03-07 10:00:00-05:00,0,3,10,4,0,1767,24764,26531
2014-03-07 11:00:00-05:00,0,3,11,4,0,1663,24751,26414
2014-03-07 12:00:00-05:00,0,3,12,4,0,1655,24761,26416
2014-03-07 13:00:00-05:00,0,3,13,4,0,1688,25085,26773
2014-03-07 14:00:00-05:00,0,3,14,4,0,2033,26791,28824
2014-03-07 15:00:00-05:00,0,3,15,4,0,2315,24047,26362
2014-03-07 16:00:00-05:00,0,3,16,4,0,2664,18980,21644
2014-03-07 17:00:00-05:00,0,3,17,4,0,3167,25080,28247
2014-03-07 18:00:00-05:00,0,3,18,4,0,3453,31915,35368
2014-03-07 19:00:00-05:00,0,3,19,4,0,3525,35481,39006
2014-03-07 20:00:00-05:00,0,3,20,4,0,3423,34109,37532
2014-03-07 21:00:00-05:00,0,3,21,4,0,3275,32797,36072
2014-03-07 22:00:00-05:00,0,3,22,4,0,3213,33230,36443
2014-03-07 23:00:00-05:00,0,3,23,4,0,3241,33212,36453
2014-03-08 00:00:00-05:00,0,3,0,5,0,2911,30167,33078
2014-03-08 01:00:00-05:00,0,3,1,5,0,2616,25866,28482
2014-03-08 02:00:00-05:00,0,3,2,5,0,2155,21035,23190
2014-03-08 03:00:00-05:00,0,3,3,5,0,1758,15667,17425
2014-03-08 04:00:00-05:00,0,3,4,5,0,1331,10322,11653
2014-03-08 05:00:00-05:00,0,3,5,5,0,626,5284,5910
2014-03-08 06:00:00-05:00,0,3,6,5,0,551,5938,6489
2014-03-08 07:00:00-05:00,0,3,7,5,0,599,8726,9325
2014-03-08 08:00:00-05:00,0,3,8,5,0,966,13965,14931
2014-03-08 09:00:00-05:00,0,3,9,5,0,1245,19712,20957
2014-03-08 10:00:00-05:00,0,3,10,5,0,1371,22275,23646
2014-03-08 11:00:00-05:00,0,3,11,5,0,1589,24627,26216
2014-03-08 12:00:00-05:00,0,3,12,5,0,1693,26199,27892
2014-03-08 13:00:00-05:00,0,3,13,5,0,1830,27107,28937
2014-03-08 14:00:00-05:00,0,3,14,5,0,1996,26309,28305
2014-03-08 15:00:00-05:00,0,3,15,5,0,2233,25905,28138
2014-03-08 16:00:00-05:00,0,3,16,5,0,2670,22107,24777
2014-03-08 17:00:00-05:00,0,3,17,5,0,2888,25642,28530
2014-03-08 18:00:00-05:00,0,3,18,5,0,3129,32061,35190
2014-03-08 19:00:00-05:00,0,3,19,5,0,3442,33981,37423
2014-03-08 20:00:00-05:00,0,3,20,5,0,3554,31134,34688
2014-03-08 21:00:00-05:00,0,3,21,5,0,3416,30395,33811
2014-03-08 22:00:00-05:00,0,3,22,5,0,3528,33071,36599
2014-03-08 23:00:00-05:00,0,3,23,5,0,3571,34079,37650
2014-03-09 00:00:00-05:00,0,3,0,6,0,3344,31953,35297
2014-03-09 01:00:00-05:00,0,3,1,6,0,3165,29220,32385
2014-03-09 03:00:00-04:00,0,3,3,6,0,27,0,27
2014-03-09 04:00:00-04:00,0,3,4,6,0,2821,25767,28588
2014-03-09 05:00:00-04:00,0,3,5,6,0,2406,18236,20642
2014-03-09 06:00:00-04:00,0,3,6,6,0,1359,9189,10548
2014-03-09 07:00:00-04:00,0,3,7,6,0,713,6064,6777
2014-03-09 08:00:00-04:00,0,3,8,6,0,581,6682,7263
2014-03-09 09:00:00-04:00,0,3,9,6,0,556,9888,10444
2014-03-09 10:00:00-04:00,0,3,10,6,0,815,14641,15456
2014-03-09 11:00:00-04:00,0,3,11,6,0,1052,20766,21818
2014-03-09 12:00:00-04:00,0,3,12,6,0,1206,24740,25946
2014-03-09 13:00:00-04:00,0,3,13,6,0,1310,27090,28400
2014-03-09 14:00:00-04:00,0,3,14,6,0,1511,26566,28077
2014-03-09 15:00:00-04:00,0,3,15,6,0,1731,26079,27810
2014-03-09 16:00:00-04:00,0,3,16,6,0,1811,24709,26520
2014-03-09 17:00:00-04:00,0,3,17,6,0,1978,21707,23685
2014-03-09 18:00:00-04:00,0,3,18,6,0,2110,23280,25390
2014-03-09 19:00:00-04:00,0,3,19,6,0,2304,25682,27986
2014-03-09 20:00:00-04:00,0,3,20,6,0,2353,25259,27612
2014-03-09 21:00:00-04:00,0,3,21,6,0,2248,22590,24838
2014-03-09 22:00:00-04:00,0,3,22,6,0,2051,20499,22550
2014-03-09 23:00:00-04:00,0,3,23,6,0,1920,18559,20479
2014-03-10 00:00:00-04:00,0,3,0,0,0,1625,14285,15910
2014-03-10 01:00:00-04:00,0,3,1,0,0,1241,9712,10953
2014-03-10 02:00:00-04:00,0,3,2,0,0,745,6001,6746
2014-03-10 03:00:00-04:00,0,3,3,0,0,500,3651,4151
2014-03-10 04:00:00-04:00,0,3,4,0,0,388,2518,2906
2014-03-10 05:00:00-04:00,0,3,5,0,0,410,2880,3290
2014-03-10 06:00:00-04:00,0,3,6,0,0,292,4728,5020
2014-03-10 07:00:00-04:00,0,3,7,0,0,484,11917,12401
2014-03-10 08:00:00-04:00,0,3,8,0,0,1189,22003,23192
2014-03-10 09:00:00-04:00,0,3,9,0,0,1986,26646,28632
2014-03-10 10:00:00-04:00,0,3,10,0,0,1832,25838,27670
2014-03-10 11:00:00-04:00,0,3,11,0,0,1549,22189,23738
2014-03-10 12:00:00-04:00,0,3,12,0,0,1430,21231,22661
2014-03-10 13:00:00-04:00,0,3,13,0,0,1369,21864,23233
2014-03-10 14:00:00-04:00,0,3,14,0,0,1405,20970,22375
2014-03-10 15:00:00-04:00,0,3,15,0,0,1534,22523,24057
2014-03-10 16:00:00-04:00,0,3,16,0,0,1747,22570,24317
2014-03-10 17:00:00-04:00,0,3,17,0,0,1936,19708,21644
2014-03-10 18:00:00-04:00,0,3,18,0,0,2074,23682,25756
2014-03-10 19:00:00-04:00,0,3,19,0,0,2218,29100,31318
2014-03-10 20:00:00-04:00,0,3,20,0,0,2220,29270,31490
2014-03-10 21:00:00-04:00,0,3,21,0,0,1942,27813,29755
2014-03-10 22:00:00-04:00,0,3,22,0,0,1749,25672,27421
2014-03-10 23:00:00-04:00,0,3,23,0,0,1360,22902,24262
2014-03-11 00:00:00-04:00,0,3,0,1,0,1157,16812,17969
2014-03-11 01:00:00-04:00,0,3,1,1,0,921,11051,11972
2014-03-11 02:00:00-04:00,0,3,2,1,0,659,6427,7086
2014-03-11 03:00:00-04:00,0,3,3,1,0,386,3999,4385
2014-03-11 04:00:00-04:00,0,3,4,1,0,293,2652,2945
2014-03-11 05:00:00-04:00,0,3,5,1,0,299,2677,2976
2014-03-11 06:00:00-04:00,0,3,6,1,0,296,4421,4717
2014-03-11 07:00:00-04:00,0,3,7,1,0,414,11876,12290
2014-03-11 08:00:00-04:00,0,3,8,1,0,1114,23143,24257
2014-03-11 09:00:00-04:00,0,3,9,1,0,1834,27919,29753
2014-03-11 10:00:00-04:00,0,3,10,1,0,1711,25700,27411
2014-03-11 11:00:00-04:00,0,3,11,1,0,1581,22564,24145
2014-03-11 12:00:00-04:00,0,3,12,1,0,1394,21987,23381
2014-03-11 13:00:00-04:00,0,3,13,1,0,1395,22775,24170
2014-03-11 14:00:00-04:00,0,3,14,1,0,1460,21932,23392
2014-03-11 15:00:00-04:00,0,3,15,1,0,1567,23087,24654
2014-03-11 16:00:00-04:00,0,3,16,1,0,1848,22447,24295
2014-03-11 17:00:00-04:00,0,3,17,1,0,2063,17163,19226
2014-03-11 18:00:00-04:00,0,3,18,1,0,2252,22768,25020
2014-03-11 19:00:00-04:00,0,3,19,1,0,2334,27855,30189
2014-03-11 20:00:00-04:00,0,3,20,1,0,2412,29845,32257
2014-03-11 21:00:00-04:00,0,3,21,1,0,2186,28698,30884
2014-03-11 22:00:00-04:00,0,3,22,1,0,1915,28730,30645
2014-03-11 23:00:00-04:00,0,3,23,1,0,1628,26824,28452
2014-03-12 00:00:00-04:00,0,3,0,2,0,1414,20443,21857
2014-03-12 01:00:00-04:00,0,3,1,2,0,1119,14014,15133
2014-03-12 02:00:00-04:00,0,3,2,2,0,785,8325,9110
2014-03-12 03:00:00-04:00,0,3,3,2,0,507,5165,5672
2014-03-12 04:00:00-04:00,0,3,4,2,0,359,3407,3766
2014-03-12 05:00:00-04:00,0,3,5,2,0,365,3258,3623
2014-03-12 06:00:00-04:00,0,3,6,2,0,287,4558,4845
2014-03-12 07:00:00-04:00,0,3,7,2,0,488,12170,12658
2014-03-12 08:00:00-04:00,0,3,8,2,0,1191,23625,24816
2014-03-12 09:00:00-04:00,0,3,9,2,0,1979,28367,30346
2014-03-12 10:00:00-04:00,0,3,10,2,0,1925,26322,28247
2014-03-12 11:00:00-04:00,0,3,11,2,0,1633,22575,24208
2014-03-12 12:00:00-04:00,0,3,12,2,0,1498,22206,23704
2014-03-12 13:00:00-04:00,0,3,13,2,0,1489,20146,21635
2014-03-12 14:00:00-04:00,0,3,14,2,0,1532,23304,24836
2014-03-12 15:00:00-04:00,0,3,15,2,0,1742,23749,25491
2014-03-12 16:00:00-04:00,0,3,16,2,0,2003,22679,24682
2014-03-12 17:00:00-04:00,0.07,3,17,2,0,2290,18838,21128
2014-03-12 18:00:00-04:00,0.09,3,18,2,0,2966,24901,27867
2014-03-12 19:00:00-04:00,0,3,19,2,0,3110,29913,33023
2014-03-12 20:00:00-04:00,0.06,3,20,2,0,2500,30573,33073
2014-03-12 21:00:00-04:00,0.06,3,21,2,0,2478,31583,34061
2014-03-12 22:00:00-04:00,0.07,3,22,2,0,2177,31402,33579
2014-03-12 23:00:00-04:00,0,3,23,2,0,1837,28811,30648
2014-03-13 00:00:00-04:00,0,3,0,3,0,1562,23435,24997
2014-03-13 01:00:00-04:00,0,3,1,3,0,1165,15510,16675
2014-03-13 02:00:00-04:00,0,3,2,3,0,767,9025,9792
2014-03-13 03:00:00-04:00,0,3,3,3,0,530,5613,6143
2014-03-13 04:00:00-04:00,0,3,4,3,0,427,3696,4123
2014-03-13 05:00:00-04:00,0,3,5,3,0,366,3624,3990
2014-03-13 06:00:00-04:00,0,3,6,3,0,327,5153,5480
2014-03-13 07:00:00-04:00,0,3,7,3,0,536,14957,15493
2014-03-13 08:00:00-04:00,0,3,8,3,0,1459,26403,27862
2014-03-13 09:00:00-04:00,0,3,9,3,0,2258,30313,32571
2014-03-13 10:00:00-04:00,0,3,10,3,0,2066,29072,31138
2014-03-13 11:00:00-04:00,0,3,11,3,0,1877,26548,28425
2014-03-13 12:00:00-04:00,0,3,12,3,0,1768,26425,28193
2014-03-13 13:00:00-04:00,0,3,13,3,0,1723,27338,29061
2014-03-13 14:00:00-04:00,0,3,14,3,0,1685,26014,27699
2014-03-13 15:00:00-04:00,0,3,15,3,0,1875,26986,28861
2014-03-13 16:00:00-04:00,0,3,16,3,0,2179,26054,28233
2014-03-13 17:00:00-04:00,0,3,17,3,0,2483,20538,23021
2014-03-13 18:00:00-04:00,0,3,18,3,0,2812,25950,28762
2014-03-13 19:00:00-04:00,0,3,19,3,0,3271,33671,36942
2014-03-13 20:00:00-04:00,0,3,20,3,0,3290,36043,39333
2014-03-13 21:00:00-04:00,0,3,21,3,0,3081,35090,38171
2014-03-13 22:00:00-04:00,0,3,22,3,0,2710,34080,36790
2014-03-13 23:00:00-04:00,0,3,23,3,0,2518,32248,34766
2014-03-14 00:00:00-04:00,0,3,0,4,0,1961,28840,30801
2014-03-14 01:00:00-04:00,0,3,1,4,0,1716,21805,23521
2014-03-14 02:00:00-04:00,0,3,2,4,0,1085,13243,14328
2014-03-14 03:00:00-04:00,0,3,3,4,0,730,8574,9304
2014-03-14 04:00:00-04:00,0,3,4,4,0,523,5784,6307
2014-03-14 05:00:00-04:00,0,3,5,4,0,503,4795,5298
2014-03-14 06:00:00-04:00,0,3,6,4,0,388,5506,5894
2014-03-14 07:00:00-04:00,0,3,7,4,0,546,12934,13480
2014-03-14 08:00:00-04:00,0,3,8,4,0,1247,23614,24861
2014-03-14 09:00:00-04:00,0,3,9,4,0,2051,28341,30392
2014-03-14 10:00:00-04:00,0,3,10,4,0,1940,27561,29501
2014-03-14 11:00:00-04:00,0,3,11,4,0,1747,24885,26632
2014-03-14 12:00:00-04:00,0,3,12,4,0,1650,25090,26740
2014-03-14 13:00:00-04:00,0,3,13,4,0,1716,25344,27060
2014-03-14 14:00:00-04:00,0,3,14,4,0,1654,23834,25488
2014-03-14 15:00:00-04:00,0,3,15,4,0,1909,25820,27729
2014-03-14 16:00:00-04:00,0,3,16,4,0,2091,23461,25552
2014-03-14 17:00:00-04:00,0,3,17,4,0,2555,18588,21143
2014-03-14 18:00:00-04:00,0,3,18,4,0,2872,24074,26946
2014-03-14 19:00:00-04:00,0,3,19,4,0,3325,31020,34345
2014-03-14 20:00:00-04:00,0,3,20,4,0,3529,34340,37869
2014-03-14 21:00:00-04:00,0,3,21,4,0,3431,33482,36913
2014-03-14 22:00:00-04:00,0,3,22,4,0,3344,32079,35423
2014-03-14 23:00:00-04:00,0,3,23,4,0,3244,32479,35723
2014-03-15 00:00:00-04:00,0,3,0,5,0,3219,32523,35742
2014-03-15 01:00:00-04:00,0,3,1,5,0,3104,30535,33639
2014-03-15 02:00:00-04:00,0,3,2,5,0,2648,25875,28523
2014-03-15 03:00:00-04:00,0,3,3,5,0,2315,20873,23188
2014-03-15 04:00:00-04:00,0,3,4,5,0,1821,16281,18102
2014-03-15 05:00:00-04:00,0,3,5,5,0,1437,10593,12030
2014-03-15 06:00:00-04:00,0,3,6,5,0,783,5543,6326
2014-03-15 07:00:00-04:00,0,3,7,5,0,607,5889,6496
2014-03-15 08:00:00-04:00,0,3,8,5,0,681,7704,8385
2014-03-15 09:00:00-04:00,0,3,9,5,0,952,11736,12688
2014-03-15 10:00:00-04:00,0,3,10,5,0,1219,16954,18173
2014-03-15 11:00:00-04:00,0,3,11,5,0,1457,20401,21858
2014-03-15 12:00:00-04:00,0,3,12,5,0,1624,23651,25275
2014-03-15 13:00:00-04:00,0,3,13,5,0,1797,26064,27861
2014-03-15 14:00:00-04:00,0,3,14,5,0,1927,26398,28325
2014-03-15 15:00:00-04:00,0,3,15,5,0,2132,25948,28080
2014-03-15 16:00:00-04:00,0,3,16,5,0,2408,25605,28013
2014-03-15 17:00:00-04:00,0,3,17,5,0,2515,22282,24797
2014-03-15 18:00:00-04:00,0,3,18,5,0,2832,25847,28679
2014-03-15 19:00:00-04:00,0,3,19,5,0,3208,32245,35453
2014-03-15 20:00:00-04:00,0,3,20,5,0,3460,34647,38107
2014-03-15 21:00:00-04:00,0,3,21,5,0,3656,32943,36599
2014-03-15 22:00:00-04:00,0,3,22,5,0,3630,31758,35388
2014-03-15 23:00:00-04:00,0,3,23,5,0,3698,33567,37265
2014-03-16 00:00:00-04:00,0,3,0,6,0,3672,34577,38249
2014-03-16 01:00:00-04:00,0,3,1,6,0,3579,32149,35728
2014-03-16 02:00:00-04:00,0,3,2,6,0,3226,29046,32272
2014-03-16 03:00:00-04:00,0,3,3,6,0,2687,24605,27292
2014-03-16 04:00:00-04:00,0,3,4,6,0,2393,19598,21991
2014-03-16 05:00:00-04:00,0,3,5,6,0,1908,12466,14374
2014-03-16 06:00:00-04:00,0,3,6,6,0,938,5916,6854
2014-03-16 07:00:00-04:00,0,3,7,6,0,623,7356,7979
2014-03-16 08:00:00-04:00,0,3,8,6,0,536,8056,8592
2014-03-16 09:00:00-04:00,0,3,9,6,0,640,9683,10323
2014-03-16 10:00:00-04:00,0,3,10,6,0,894,14479,15373
2014-03-16 11:00:00-04:00,0,3,11,6,0,1157,19583,20740
2014-03-16 12:00:00-04:00,0,3,12,6,0,1324,23531,24855
2014-03-16 13:00:00-04:00,0,3,13,6,0,1452,26286,27738
2014-03-16 14:00:00-04:00,0,3,14,6,0,1664,26302,27966
2014-03-16 15:00:00-04:00,0,3,15,6,0,1837,26507,28344
2014-03-16 16:00:00-04:00,0,3,16,6,0,2123,24868,26991
2014-03-16 17:00:00-04:00,0,3,17,6,0,2178,22685,24863
2014-03-16 18:00:00-04:00,0,3,18,6,0,2472,25121,27593
2014-03-16 19:00:00-04:00,0,3,19,6,0,2551,26150,28701
2014-03-16 20:00:00-04:00,0,3,20,6,0,2538,25072,27610
2014-03-16 21:00:00-04:00,0,3,21,6,0,2293,22326,24619
2014-03-16 22:00:00-04:00,0,3,22,6,0,2135,20911,23046
2014-03-16 23:00:00-04:00,0,3,23,6,0,1968,18432,20400
2014-03-17 00:00:00-04:00,0,3,0,0,0,1639,13880,15519
2014-03-17 01:00:00-04:00,0,3,1,0,0,1205,9449,10654
2014-03-17 02:00:00-04:00,0,3,2,0,0,749,5882,6631
2014-03-17 03:00:00-04:00,0,3,3,0,0,521,3949,4470
2014-03-17 04:00:00-04:00,0,3,4,0,0,437,2741,3178
2014-03-17 05:00:00-04:00,0,3,5,0,0,457,3137,3594
2014-03-17 06:00:00-04:00,0,3,6,0,0,329,4720,5049
2014-03-17 07:00:00-04:00,0,3,7,0,0,490,12308,12798
2014-03-17 08:00:00-04:00,0,3,8,0,0,1305,20658,21963
2014-03-17 09:00:00-04:00,0,3,9,0,0,2061,24073,26134
2014-03-17 10:00:00-04:00,0,3,10,0,0,1920,23862,25782
2014-03-17 11:00:00-04:00,0,3,11,0,0,1605,19988,21593
2014-03-17 12:00:00-04:00,0,3,12,0,0,1497,18971,20468
2014-03-17 13:00:00-04:00,0,3,13,0,0,1439,19471,20910
2014-03-17 14:00:00-04:00,0,3,14,0,0,1486,19138,20624
2014-03-17 15:00:00-04:00,0,3,15,0,0,1650,20714,22364
2014-03-17 16:00:00-04:00,0,3,16,0,0,1811,19985,21796
2014-03-17 17:00:00-04:00,0,3,17,0,0,2025,18842,20867
2014-03-17 18:00:00-04:00,0,3,18,0,0,2261,24644,26905
2014-03-17 19:00:00-04:00,0,3,19,0,0,2558,30234,32792
2014-03-17 20:00:00-04:00,0,3,20,0,0,2390,30602,32992
2014-03-17 21:00:00-04:00,0,3,21,0,0,2085,29112,31197
2014-03-17 22:00:00-04:00,0,3,22,0,0,1828,27994,29822
2014-03-17 23:00:00-04:00,0,3,23,0,0,1617,24497,26114
2014-03-18 00:00:00-04:00,0,3,0,1,0,1336,18350,19686
2014-03-18 01:00:00-04:00,0,3,1,1,0,1043,13362,14405
2014-03-18 02:00:00-04:00,0,3,2,1,0,720,8244,8964
2014-03-18 03:00:00-04:00,0,3,3,1,0,510,5388,5898
2014-03-18 04:00:00-04:00,0,3,4,1,0,367,3497,3864
2014-03-18 05:00:00-04:00,0,3,5,1,0,415,3294,3709
2014-03-18 06:00:00-04:00,0,3,6,1,0,324,4607,4931
2014-03-18 07:00:00-04:00,0,3,7,1,0,488,12356,12844
2014-03-18 08:00:00-04:00,0,3,8,1,0,1199,21803,23002
2014-03-18 09:00:00-04:00,0,3,9,1,0,1901,27043,28944
2014-03-18 10:00:00-04:00,0,3,10,1,0,1779,25519,27298
2014-03-18 11:00:00-04:00,0,3,11,1,0,1599,22471,24070
2014-03-18 12:00:00-04:00,0,3,12,1,0,1419,21859,23278
2014-03-18 13:00:00-04:00,0,3,13,1,0,1438,22950,24388
2014-03-18 14:00:00-04:00,0,3,14,1,0,1502,22050,23552
2014-03-18 15:00:00-04:00,0,3,15,1,0,1646,22896,24542
2014-03-18 16:00:00-04:00,0,3,16,1,0,1854,21983,23837
2014-03-18 17:00:00-04:00,0,3,17,1,0,1940,18393,20333
2014-03-18 18:00:00-04:00,0,3,18,1,0,2239,23621,25860
2014-03-18 19:00:00-04:00,0,3,19,1,0,2487,30527,33014
2014-03-18 20:00:00-04:00,0,3,20,1,0,2380,31360,33740
2014-03-18 21:00:00-04:00,0,3,21,1,0,2156,30164,32320
2014-03-18 22:00:00-04:00,0,3,22,1,0,1969,29681,31650
2014-03-18 23:00:00-04:00,0,3,23,1,0,1635,26716,28351
2014-03-19 00:00:00-04:00,0,3,0,2,0,1347,20191,21538
2014-03-19 01:00:00-04:00,0,3,1,2,0,1038,13548,14586
2014-03-19 02:00:00-04:00,0,3,2,2,0,714,7683,8397
2014-03-19 03:00:00-04:00,0,3,3,2,0,423,4658,5081
2014-03-19 04:00:00-04:00,0,3,4,2,0,359,3130,3489
2014-03-19 05:00:00-04:00,0,3,5,2,0,320,2948,3268
2014-03-19 06:00:00-04:00,0,3,6,2,0,256,4372,4628
2014-03-19 07:00:00-04:00,0,3,7,2,0,492,12262,12754
2014-03-19 08:00:00-04:00,0,3,8,2,0,1193,22268,23461
2014-03-19 09:00:00-04:00,0,3,9,2,0,1928,27348,29276
2014-03-19 10:00:00-04:00,0,3,10,2,0,1877,26994,28871
2014-03-19 11:00:00-04:00,0,3,11,2,0,1612,22927,24539
2014-03-19 12:00:00-04:00,0,3,12,2,0,1539,22968,24507
2014-03-19 13:00:00-04:00,0,3,13,2,0,1485,22680,24165
2014-03-19 14:00:00-04:00,0,3,14,2,0,1586,22538,24124
2014-03-19 15:00:00-04:00,0,3,15,2,0,1818,23761,25579
2014-03-19 16:00:00-04:00,0.01,3,16,2,0,2146,22838,24984
2014-03-19 17:00:00-04:00,0,3,17,2,0,2414,19096,21510
2014-03-19 18:00:00-04:00,0,3,18,2,0,2690,23743,26433
2014-03-19 19:00:00-04:00,0.11,3,19,2,0,2702,30140,32842
2014-03-19 20:00:00-04:00,0,3,20,2,0,3155,34284,37439
2014-03-19 21:00:00-04:00,0.11,3,21,2,0,2417,30431,32848
2014-03-19 22:00:00-04:00,0.25,3,22,2,0,2921,33298,36219
2014-03-19 23:00:00-04:00,0.41,3,23,2,0,2423,29611,32034
2014-03-20 00:00:00-04:00,0.1,3,0,3,0,1975,26041,28016
2014-03-20 01:00:00-04:00,0,3,1,3,0,1381,16606,17987
2014-03-20 02:00:00-04:00,0,3,2,3,0,781,9057,9838
2014-03-20 03:00:00-04:00,0,3,3,3,0,495,5485,5980
2014-03-20 04:00:00-04:00,0,3,4,3,0,336,3446,3782
2014-03-20 05:00:00-04:00,0,3,5,3,0,326,3274,3600
2014-03-20 06:00:00-04:00,0,3,6,3,0,269,4610,4879
2014-03-20 07:00:00-04:00,0,3,7,3,0,485,12409,12894
2014-03-20 08:00:00-04:00,0,3,8,3,0,1280,22555,23835
2014-03-20 09:00:00-04:00,0,3,9,3,0,1953,27428,29381
2014-03-20 10:00:00-04:00,0,3,10,3,0,1870,26364,28234
2014-03-20 11:00:00-04:00,0,3,11,3,0,1686,23034,24720
2014-03-20 12:00:00-04:00,0,3,12,3,0,1540,22656,24196
2014-03-20 13:00:00-04:00,0,3,13,3,0,1610,23641,25251
2014-03-20 14:00:00-04:00,0,3,14,3,0,1603,22887,24490
2014-03-20 15:00:00-04:00,0,3,15,3,0,1887,24108,25995
2014-03-20 16:00:00-04:00,0,3,16,3,0,2018,22339,24357
2014-03-20 17:00:00-04:00,0,3,17,3,0,2211,18150,20361
2014-03-20 18:00:00-04:00,0,3,18,3,0,2502,23562,26064
2014-03-20 19:00:00-04:00,0,3,19,3,0,2744,30653,33397
2014-03-20 20:00:00-04:00,0,3,20,3,0,2846,32556,35402
2014-03-20 21:00:00-04:00,0,3,21,3,0,2751,32749,35500
2014-03-20 22:00:00-04:00,0,3,22,3,0,2548,32603,35151
2014-03-20 23:00:00-04:00,0,3,23,3,0,2333,31601,33934
2014-03-21 00:00:00-04:00,0,3,0,4,0,2036,28297,30333
2014-03-21 01:00:00-04:00,0,3,1,4,0,1582,21573,23155
2014-03-21 02:00:00-04:00,0,3,2,4,0,1187,13545,14732
2014-03-21 03:00:00-04:00,0,3,3,4,0,774,8696,9470
2014-03-21 04:00:00-04:00,0,3,4,4,0,542,5883,6425
2014-03-21 05:00:00-04:00,0,3,5,4,0,501,4946,5447
2014-03-21 06:00:00-04:00,0,3,6,4,0,368,5073,5441
2014-03-21 07:00:00-04:00,0,3,7,4,0,508,11903,12411
2014-03-21 08:00:00-04:00,0,3,8,4,0,1200,21144,22344
2014-03-21 09:00:00-04:00,0,3,9,4,0,1874,25771,27645
2014-03-21 10:00:00-04:00,0,3,10,4,0,1831,25227,27058
2014-03-21 11:00:00-04:00,0,3,11,4,0,1625,22450,24075
2014-03-21 12:00:00-04:00,0,3,12,4,0,1535,22296,23831
2014-03-21 13:00:00-04:00,0,3,13,4,0,1532,23268,24800
2014-03-21 14:00:00-04:00,0,3,14,4,0,1530,22349,23879
2014-03-21 15:00:00-04:00,0,3,15,4,0,1778,23917,25695
2014-03-21 16:00:00-04:00,0,3,16,4,0,2060,22311,24371
2014-03-21 17:00:00-04:00,0,3,17,4,0,2335,18510,20845
2014-03-21 18:00:00-04:00,0,3,18,4,0,2865,23841,26706
2014-03-21 19:00:00-04:00,0,3,19,4,0,3277,31168,34445
2014-03-21 20:00:00-04:00,0,3,20,4,0,3486,33938,37424
2014-03-21 21:00:00-04:00,0,3,21,4,0,3406,32723,36129
2014-03-21 22:00:00-04:00,0,3,22,4,0,3257,31571,34828
2014-03-21 23:00:00-04:00,0,3,23,4,0,3353,32350,35703
2014-03-22 00:00:00-04:00,0,3,0,5,0,3302,32082,35384
2014-03-22 01:00:00-04:00,0,3,1,5,0,3240,30567,33807
2014-03-22 02:00:00-04:00,0,3,2,5,0,2890,26122,29012
2014-03-22 03:00:00-04:00,0,3,3,5,0,2370,21385,23755
2014-03-22 04:00:00-04:00,0,3,4,5,0,1987,16024,18011
2014-03-22 05:00:00-04:00,0,3,5,5,0,1550,10814,12364
2014-03-22 06:00:00-04:00,0,3,6,5,0,762,5538,6300
2014-03-22 07:00:00-04:00,0,3,7,5,0,516,5902,6418
2014-03-22 08:00:00-04:00,0,3,8,5,0,655,7963,8618
2014-03-22 09:00:00-04:00,0,3,9,5,0,952,12241,13193
2014-03-22 10:00:00-04:00,0,3,10,5,0,1244,16515,17759
2014-03-22 11:00:00-04:00,0,3,11,5,0,1344,19895,21239
2014-03-22 12:00:00-04:00,0,3,12,5,0,1528,23228,24756
2014-03-22 13:00:00-04:00,0,3,13,5,0,1718,24979,26697
2014-03-22 14:00:00-04:00,0,3,14,5,0,1787,24831,26618
2014-03-22 15:00:00-04:00,0,3,15,5,0,1906,24295,26201
2014-03-22 16:00:00-04:00,0,3,16,5,0,2218,24081,26299
2014-03-22 17:00:00-04:00,0,3,17,5,0,2469,22003,24472
2014-03-22 18:00:00-04:00,0,3,18,5,0,2594,25559,28153
2014-03-22 19:00:00-04:00,0,3,19,5,0,3105,30250,33355
2014-03-22 20:00:00-04:00,0,3,20,5,0,3408,33182,36590
2014-03-22 21:00:00-04:00,0,3,21,5,0,3612,30995,34607
2014-03-22 22:00:00-04:00,0,3,22,5,0,3656,30708,34364
2014-03-22 23:00:00-04:00,0,3,23,5,0,3740,33181,36921
2014-03-23 00:00:00-04:00,0,3,0,6,0,3726,34183,37909
2014-03-23 01:00:00-04:00,0,3,1,6,0,3509,32022,35531
2014-03-23 02:00:00-04:00,0,3,2,6,0,3290,28930,32220
2014-03-23 03:00:00-04:00,0,3,3,6,0,2892,25058,27950
2014-03-23 04:00:00-04:00,0,3,4,6,0,2412,19391,21803
2014-03-23 05:00:00-04:00,0,3,5,6,0,1886,12181,14067
2014-03-23 06:00:00-04:00,0,3,6,6,0,918,5681,6599
2014-03-23 07:00:00-04:00,0,3,7,6,0,586,5305,5891
2014-03-23 08:00:00-04:00,0,3,8,6,0,514,6374,6888
2014-03-23 09:00:00-04:00,0,3,9,6,0,653,9027,9680
2014-03-23 10:00:00-04:00,0,3,10,6,0,895,13875,14770
2014-03-23 11:00:00-04:00,0,3,11,6,0,1111,19334,20445
2014-03-23 12:00:00-04:00,0,3,12,6,0,1327,23200,24527
2014-03-23 13:00:00-04:00,0,3,13,6,0,1468,25356,26824
2014-03-23 14:00:00-04:00,0,3,14,6,0,1605,25691,27296
2014-03-23 15:00:00-04:00,0,3,15,6,0,1831,26159,27990
2014-03-23 16:00:00-04:00,0,3,16,6,0,2078,24887,26965
2014-03-23 17:00:00-04:00,0,3,17,6,0,2172,22943,25115
2014-03-23 18:00:00-04:00,0,3,18,6,0,2196,24688,26884
2014-03-23 19:00:00-04:00,0,3,19,6,0,2445,26149,28594
2014-03-23 20:00:00-04:00,0,3,20,6,0,2489,24888,27377
2014-03-23 21:00:00-04:00,0,3,21,6,0,2345,22465,24810
2014-03-23 22:00:00-04:00,0,3,22,6,0,2216,21809,24025
2014-03-23 23:00:00-04:00,0,3,23,6,0,2034,20131,22165
2014-03-24 00:00:00-04:00,0,3,0,0,0,1660,15200,16860
2014-03-24 01:00:00-04:00,0,3,1,0,0,1296,10121,11417
2014-03-24 02:00:00-04:00,0,3,2,0,0,790,6008,6798
2014-03-24 03:00:00-04:00,0,3,3,0,0,544,3950,4494
2014-03-24 04:00:00-04:00,0,3,4,0,0,414,2719,3133
2014-03-24 05:00:00-04:00,0,3,5,0,0,431,3032,3463
2014-03-24 06:00:00-04:00,0,3,6,0,0,333,5126,5459
2014-03-24 07:00:00-04:00,0,3,7,0,0,500,12790,13290
2014-03-24 08:00:00-04:00,0,3,8,0,0,1300,21876,23176
2014-03-24 09:00:00-04:00,0,3,9,0,0,1976,26059,28035
2014-03-24 10:00:00-04:00,0,3,10,0,0,1983,25266,27249
2014-03-24 11:00:00-04:00,0,3,11,0,0,1668,21342,23010
2014-03-24 12:00:00-04:00,0,3,12,0,0,1410,20668,22078
2014-03-24 13:00:00-04:00,0,3,13,0,0,1488,21923,23411
2014-03-24 14:00:00-04:00,0,3,14,0,0,1457,21106,22563
2014-03-24 15:00:00-04:00,0,3,15,0,0,1655,22069,23724
2014-03-24 16:00:00-04:00,0,3,16,0,0,1878,21507,23385
2014-03-24 17:00:00-04:00,0,3,17,0,0,2001,19782,21783
2014-03-24 18:00:00-04:00,0,3,18,0,0,2298,23959,26257
2014-03-24 19:00:00-04:00,0,3,19,0,0,2528,29866,32394
2014-03-24 20:00:00-04:00,0,3,20,0,0,2350,29556,31906
2014-03-24 21:00:00-04:00,0,3,21,0,0,2196,27891,30087
2014-03-24 22:00:00-04:00,0,3,22,0,0,1897,26569,28466
2014-03-24 23:00:00-04:00,0,3,23,0,0,1758,23444,25202
2014-03-25 00:00:00-04:00,0,3,0,1,0,1511,16693,18204
2014-03-25 01:00:00-04:00,0,3,1,1,0,1128,11031,12159
2014-03-25 02:00:00-04:00,0,3,2,1,0,669,6263,6932
2014-03-25 03:00:00-04:00,0,3,3,1,0,391,3644,4035
2014-03-25 04:00:00-04:00,0,3,4,1,0,303,2421,2724
2014-03-25 05:00:00-04:00,0,3,5,1,0,358,2467,2825
2014-03-25 06:00:00-04:00,0,3,6,1,0,267,4307,4574
2014-03-25 07:00:00-04:00,0,3,7,1,0,485,12256,12741
2014-03-25 08:00:00-04:00,0,3,8,1,0,1185,21716,22901
2014-03-25 09:00:00-04:00,0,3,9,1,0,1854,27004,28858
2014-03-25 10:00:00-04:00,0,3,10,1,0,1782,25808,27590
2014-03-25 11:00:00-04:00,0,3,11,1,0,1527,22317,23844
2014-03-25 12:00:00-04:00,0,3,12,1,0,1467,21019,22486
2014-03-25 13:00:00-04:00,0,3,13,1,0,1415,22069,23484
2014-03-25 14:00:00-04:00,0,3,14,1,0,1422,21656,23078
2014-03-25 15:00:00-04:00,0,3,15,1,0,1679,22827,24506
2014-03-25 16:00:00-04:00,0,3,16,1,0,1854,21883,23737
2014-03-25 17:00:00-04:00,0,3,17,1,0,2022,19054,21076
2014-03-25 18:00:00-04:00,0,3,18,1,0,2285,23867,26152
2014-03-25 19:00:00-04:00,0,3,19,1,0,2534,30283,32817
2014-03-25 20:00:00-04:00,0,3,20,1,0,2417,31493,33910
2014-03-25 21:00:00-04:00,0,3,21,1,0,2286,30235,32521
2014-03-25 22:00:00-04:00,0,3,22,1,0,2049,30291,32340
2014-03-25 23:00:00-04:00,0,3,23,1,0,1813,27440,29253
2014-03-26 00:00:00-04:00,0,3,0,2,0,1561,20180,21741
2014-03-26 01:00:00-04:00,0,3,1,2,0,1183,12800,13983
2014-03-26 02:00:00-04:00,0,3,2,2,0,717,7461,8178
2014-03-26 03:00:00-04:00,0,3,3,2,0,456,4623,5079
2014-03-26 04:00:00-04:00,0,3,4,2,0,347,2989,3336
2014-03-26 05:00:00-04:00,0,3,5,2,0,336,2800,3136
2014-03-26 06:00:00-04:00,0,3,6,2,0,259,4472,4731
2014-03-26 07:00:00-04:00,0,3,7,2,0,475,12289,12764
2014-03-26 08:00:00-04:00,0,3,8,2,0,1248,22399,23647
2014-03-26 09:00:00-04:00,0,3,9,2,0,1914,28013,29927
2014-03-26 10:00:00-04:00,0,3,10,2,0,1974,26872,28846
2014-03-26 11:00:00-04:00,0,3,11,2,0,1705,23393,25098
2014-03-26 12:00:00-04:00,0,3,12,2,0,1502,22966,24468
2014-03-26 13:00:00-04:00,0,3,13,2,0,1546,23597,25143
2014-03-26 14:00:00-04:00,0,3,14,2,0,1636,23602,25238
2014-03-26 15:00:00-04:00,0,3,15,2,0,1818,24008,25826
2014-03-26 16:00:00-04:00,0,3,16,2,0,2103,23385,25488
2014-03-26 17:00:00-04:00,0,3,17,2,0,2252,19746,21998
2014-03-26 18:00:00-04:00,0,3,18,2,0,2528,25250,27778
2014-03-26 19:00:00-04:00,0,3,19,2,0,2869,32497,35366
2014-03-26 20:00:00-04:00,0,3,20,2,0,3064,35625,38689
2014-03-26 21:00:00-04:00,0,3,21,2,0,2896,34279,37175
2014-03-26 22:00:00-04:00,0,3,22,2,0,2638,32761,35399
2014-03-26 23:00:00-04:00,0,3,23,2,0,2387,31232,33619
2014-03-27 00:00:00-04:00,0,3,0,3,0,1970,25698,27668
2014-03-27 01:00:00-04:00,0,3,1,3,0,1472,15850,17322
2014-03-27 02:00:00-04:00,0,3,2,3,0,942,8903,9845
2014-03-27 03:00:00-04:00,0,3,3,3,0,533,5274,5807
2014-03-27 04:00:00-04:00,0,3,4,3,0,411,3570,3981
2014-03-27 05:00:00-04:00,0,3,5,3,0,386,3246,3632
2014-03-27 06:00:00-04:00,0,3,6,3,0,313,4845,5158
2014-03-27 07:00:00-04:00,0,3,7,3,0,504,12931,13435
2014-03-27 08:00:00-04:00,0,3,8,3,0,1280,23260,24540
2014-03-27 09:00:00-04:00,0,3,9,3,0,2076,28201,30277
2014-03-27 10:00:00-04:00,0,3,10,3,0,2032,26745,28777
2014-03-27 11:00:00-04:00,0,3,11,3,0,1756,23932,25688
2014-03-27 12:00:00-04:00,0,3,12,3,0,1618,23358,24976
2014-03-27 13:00:00-04:00,0,3,13,3,0,1631,24090,25721
2014-03-27 14:00:00-04:00,0,3,14,3,0,1660,23415,25075
2014-03-27 15:00:00-04:00,0,3,15,3,0,1873,23958,25831
2014-03-27 16:00:00-04:00,0,3,16,3,0,2066,22839,24905
2014-03-27 17:00:00-04:00,0,3,17,3,0,2278,18828,21106
2014-03-27 18:00:00-04:00,0,3,18,3,0,2656,24008,26664
2014-03-27 19:00:00-04:00,0,3,19,3,0,2900,30434,33334
2014-03-27 20:00:00-04:00,0,3,20,3,0,2927,33157,36084
2014-03-27 21:00:00-04:00,0,3,21,3,0,2743,33066,35809
2014-03-27 22:00:00-04:00,0,3,22,3,0,2627,33338,35965
2014-03-27 23:00:00-04:00,0,3,23,3,0,2500,32235,34735
2014-03-28 00:00:00-04:00,0,3,0,4,0,2046,28424,30470
2014-03-28 01:00:00-04:00,0,3,1,4,0,1808,21513,23321
2014-03-28 02:00:00-04:00,0,3,2,4,0,1157,13332,14489
2014-03-28 03:00:00-04:00,0,3,3,4,0,761,8436,9197
2014-03-28 04:00:00-04:00,0,3,4,4,0,550,5636,6186
2014-03-28 05:00:00-04:00,0,3,5,4,0,491,4443,4934
2014-03-28 06:00:00-04:00,0,3,6,4,0,327,5061,5388
2014-03-28 07:00:00-04:00,0,3,7,4,0,521,12297,12818
2014-03-28 08:00:00-04:00,0,3,8,4,0,1255,21395,22650
2014-03-28 09:00:00-04:00,0,3,9,4,0,1961,26793,28754
2014-03-28 10:00:00-04:00,0,3,10,4,0,1977,26252,28229
2014-03-28 11:00:00-04:00,0.03,3,11,4,0,1760,24837,26597
2014-03-28 12:00:00-04:00,0,3,12,4,0,1743,25397,27140
2014-03-28 13:00:00-04:00,0,3,13,4,0,1577,23960,25537
2014-03-28 14:00:00-04:00,0,3,14,4,0,1556,22735,24291
2014-03-28 15:00:00-04:00,0,3,15,4,0,1949,24402,26351
2014-03-28 16:00:00-04:00,0,3,16,4,0,2204,22378,24582
2014-03-28 17:00:00-04:00,0,3,17,4,0,2525,18465,20990
2014-03-28 18:00:00-04:00,0,3,18,4,0,2762,24307,27069
2014-03-28 19:00:00-04:00,0,3,19,4,0,3110,30989,34099
2014-03-28 20:00:00-04:00,0,3,20,4,0,3251,33518,36769
2014-03-28 21:00:00-04:00,0,3,21,4,0,3199,31233,34432
2014-03-28 22:00:00-04:00,0,3,22,4,0,3277,31983,35260
2014-03-28 23:00:00-04:00,0,3,23,4,0,3291,32067,35358
2014-03-29 00:00:00-04:00,0,3,0,5,0,3052,30975,34027
2014-03-29 01:00:00-04:00,0,3,1,5,0,3105,30009,33114
2014-03-29 02:00:00-04:00,0,3,2,5,0,2753,26140,28893
2014-03-29 03:00:00-04:00,0,3,3,5,0,2345,21512,23857
2014-03-29 04:00:00-04:00,0,3,4,5,0,1925,16239,18164
2014-03-29 05:00:00-04:00,0,3,5,5,0,1522,10610,12132
2014-03-29 06:00:00-04:00,0,3,6,5,0,698,5224,5922
2014-03-29 07:00:00-04:00,0,3,7,5,0,544,5809,6353
2014-03-29 08:00:00-04:00,0,3,8,5,0,638,7901,8539
2014-03-29 09:00:00-04:00,0,3,9,5,0,1019,12928,13947
2014-03-29 10:00:00-04:00,0.02,3,10,5,0,1281,17809,19090
2014-03-29 11:00:00-04:00,0.02,3,11,5,0,1553,24005,25558
2014-03-29 12:00:00-04:00,0.02,3,12,5,0,1771,27282,29053
2014-03-29 13:00:00-04:00,0.06,3,13,5,0,1894,29876,31770
2014-03-29 14:00:00-04:00,0.12,3,14,5,0,2181,31664,33845
2014-03-29 15:00:00-04:00,0.06,3,15,5,0,2447,30510,32957
2014-03-29 16:00:00-04:00,0.08,3,16,5,0,2713,28421,31134
2014-03-29 17:00:00-04:00,0.08,3,17,5,0,2968,22907,25875
2014-03-29 18:00:00-04:00,0.08,3,18,5,0,3250,25477,28727
2014-03-29 19:00:00-04:00,0.14,3,19,5,0,3565,32460,36025
2014-03-29 20:00:00-04:00,0.06,3,20,5,0,3690,33416,37106
2014-03-29 21:00:00-04:00,0.12,3,21,5,0,3695,33163,36858
2014-03-29 22:00:00-04:00,0.21,3,22,5,0,3752,33351,37103
2014-03-29 23:00:00-04:00,0.22,3,23,5,0,3912,34153,38065
2014-03-30 00:00:00-04:00,0.44,3,0,6,0,3684,33664,37348
2014-03-30 01:00:00-04:00,0.21,3,1,6,0,3355,30033,33388
2014-03-30 02:00:00-04:00,0,3,2,6,0,2846,25815,28661
2014-03-30 03:00:00-04:00,0.01,3,3,6,0,2344,21928,24272
2014-03-30 04:00:00-04:00,0,3,4,6,0,1883,16717,18600
2014-03-30 05:00:00-04:00,0,3,5,6,0,1464,10705,12169
2014-03-30 06:00:00-04:00,0.02,3,6,6,0,770,4899,5669
2014-03-30 07:00:00-04:00,0,3,7,6,0,490,4872,5362
2014-03-30 08:00:00-04:00,0,3,8,6,0,532,6073,6605
2014-03-30 09:00:00-04:00,0,3,9,6,0,620,9739,10359
2014-03-30 10:00:00-04:00,0,3,10,6,0,896,15423,16319
2014-03-30 11:00:00-04:00,0,3,11,6,0,1148,20461,21609
2014-03-30 12:00:00-04:00,0,3,12,6,0,1369,23584,24953
2014-03-30 13:00:00-04:00,0,3,13,6,0,1525,26030,27555
2014-03-30 14:00:00-04:00,0,3,14,6,0,1683,26909,28592
2014-03-30 15:00:00-04:00,0,3,15,6,0,1935,25704,27639
2014-03-30 16:00:00-04:00,0,3,16,6,0,2164,23608,25772
2014-03-30 17:00:00-04:00,0,3,17,6,0,2338,20855,23193
2014-03-30 18:00:00-04:00,0.18,3,18,6,0,2438,23518,25956
2014-03-30 19:00:00-04:00,0.01,3,19,6,0,2997,27971,30968
2014-03-30 20:00:00-04:00,0,3,20,6,0,2407,25111,27518
2014-03-30 21:00:00-04:00,0,3,21,6,0,2263,21156,23419
2014-03-30 22:00:00-04:00,0,3,22,6,0,1998,20200,22198
2014-03-30 23:00:00-04:00,0,3,23,6,0,1833,17880,19713
2014-03-31 00:00:00-04:00,0,3,0,0,0,1563,13580,15143
2014-03-31 01:00:00-04:00,0,3,1,0,0,1260,9890,11150
2014-03-31 02:00:00-04:00,0,3,2,0,0,784,5955,6739
2014-03-31 03:00:00-04:00,0,3,3,0,0,559,3734,4293
2014-03-31 04:00:00-04:00,0.05,3,4,0,0,403,2592,2995
2014-03-31 05:00:00-04:00,0.01,3,5,0,0,437,3187,3624
2014-03-31 06:00:00-04:00,0.01,3,6,0,0,345,4993,5338
2014-03-31 07:00:00-04:00,0.03,3,7,0,0,531,13250,13781
2014-03-31 08:00:00-04:00,0.02,3,8,0,0,1434,22783,24217
2014-03-31 09:00:00-04:00,0,3,9,0,0,2215,26038,28253
2014-03-31 10:00:00-04:00,0,3,10,0,0,1935,24752,26687
2014-03-31 11:00:00-04:00,0,3,11,0,0,1665,21774,23439
2014-03-31 12:00:00-04:00,0,3,12,0,0,1523,20302,21825
2014-03-31 13:00:00-04:00,0,3,13,0,0,1448,20367,21815
2014-03-31 14:00:00-04:00,0,3,14,0,0,1474,19669,21143
2014-03-31 15:00:00-04:00,0,3,15,0,0,1640,21149,22789
2014-03-31 16:00:00-04:00,0,3,16,0,0,1755,21506,23261
2014-03-31 17:00:00-04:00,0,3,17,0,0,1987,18961,20948
2014-03-31 18:00:00-04:00,0,3,18,0,0,2224,23162,25386
2014-03-31 19:00:00-04:00,0,3,19,0,0,2352,27709,30061
2014-03-31 20:00:00-04:00,0,3,20,0,0,2335,28008,30343
2014-03-31 21:00:00-04:00,0,3,21,0,0,2056,26621,28677
2014-03-31 22:00:00-04:00,0,3,22,0,0,1880,25785,27665
2014-03-31 23:00:00-04:00,0,3,23,0,0,1657,23640,25297
2014-04-01 00:00:00-04:00,0,4,0,1,0,1374,16603,17977
2014-04-01 01:00:00-04:00,0,4,1,1,0,990,11155,12145
2014-04-01 02:00:00-04:00,0,4,2,1,0,689,6522,7211
2014-04-01 03:00:00-04:00,0,4,3,1,0,484,3986,4470
2014-04-01 04:00:00-04:00,0,4,4,1,0,340,2756,3096
2014-04-01 05:00:00-04:00,0,4,5,1,0,389,2670,3059
2014-04-01 06:00:00-04:00,0,4,6,1,0,303,4375,4678
2014-04-01 07:00:00-04:00,0,4,7,1,0,528,12518,13046
2014-04-01 08:00:00-04:00,0,4,8,1,0,1357,23323,24680
2014-04-01 09:00:00-04:00,0,4,9,1,0,1934,27252,29186
2014-04-01 10:00:00-04:00,0,4,10,1,0,1894,25077,26971
2014-04-01 11:00:00-04:00,0,4,11,1,0,1681,21573,23254
2014-04-01 12:00:00-04:00,0,4,12,1,0,1499,20844,22343
2014-04-01 13:00:00-04:00,0,4,13,1,0,1513,21728,23241
2014-04-01 14:00:00-04:00,0,4,14,1,0,1521,21095,22616
2014-04-01 15:00:00-04:00,0,4,15,1,0,1740,22786,24526
2014-04-01 16:00:00-04:00,0,4,16,1,0,2035,22067,24102
2014-04-01 17:00:00-04:00,0,4,17,1,0,2096,18954,21050
2014-04-01 18:00:00-04:00,0,4,18,1,0,2498,24504,27002
2014-04-01 19:00:00-04:00,0,4,19,1,0,2549,30626,33175
2014-04-01 20:00:00-04:00,0,4,20,1,0,2503,31179,33682
2014-04-01 21:00:00-04:00,0,4,21,1,0,2353,30217,32570
2014-04-01 22:00:00-04:00,0,4,22,1,0,2095,29831,31926
2014-04-01 23:00:00-04:00,0,4,23,1,0,1969,27347,29316
2014-04-02 00:00:00-04:00,0,4,0,2,0,1552,20118,21670
2014-04-02 01:00:00-04:00,0,4,1,2,0,1153,13473,14626
2014-04-02 02:00:00-04:00,0,4,2,2,0,816,7610,8426
2014-04-02 03:00:00-04:00,0,4,3,2,0,473,4780,5253
2014-04-02 04:00:00-04:00,0,4,4,2,0,343,3202,3545
2014-04-02 05:00:00-04:00,0,4,5,2,0,327,2913,3240
2014-04-02 06:00:00-04:00,0,4,6,2,0,271,4287,4558
2014-04-02 07:00:00-04:00,0,4,7,2,0,543,12436,12979
2014-04-02 08:00:00-04:00,0,4,8,2,0,1285,23325,24610
2014-04-02 09:00:00-04:00,0,4,9,2,0,1935,27644,29579
2014-04-02 10:00:00-04:00,0,4,10,2,0,1966,26423,28389
2014-04-02 11:00:00-04:00,0,4,11,2,0,1731,23964,25695
2014-04-02 12:00:00-04:00,0,4,12,2,0,1649,24408,26057
2014-04-02 13:00:00-04:00,0,4,13,2,0,1690,24369,26059
2014-04-02 14:00:00-04:00,0,4,14,2,0,1677,22915,24592
2014-04-02 15:00:00-04:00,0,4,15,2,0,1883,24187,26070
2014-04-02 16:00:00-04:00,0,4,16,2,0,2068,22583,24651
2014-04-02 17:00:00-04:00,0,4,17,2,0,2164,18149,20313
2014-04-02 18:00:00-04:00,0,4,18,2,0,2270,23303,25573
2014-04-02 19:00:00-04:00,0,4,19,2,0,2606,29669,32275
2014-04-02 20:00:00-04:00,0,4,20,2,0,2558,31546,34104
2014-04-02 21:00:00-04:00,0,4,21,2,0,2413,30853,33266
2014-04-02 22:00:00-04:00,0,4,22,2,0,2225,30607,32832
2014-04-02 23:00:00-04:00,0,4,23,2,0,2005,28816,30821
2014-04-03 00:00:00-04:00,0,4,0,3,0,1658,22379,24037
2014-04-03 01:00:00-04:00,0,4,1,3,0,1294,15182,16476
2014-04-03 02:00:00-04:00,0,4,2,3,0,894,9089,9983
2014-04-03 03:00:00-04:00,0,4,3,3,0,581,5674,6255
2014-04-03 04:00:00-04:00,0,4,4,3,0,404,3718,4122
2014-04-03 05:00:00-04:00,0,4,5,3,0,412,3502,3914
2014-04-03 06:00:00-04:00,0,4,6,3,0,317,4756,5073
2014-04-03 07:00:00-04:00,0,4,7,3,0,560,12933,13493
2014-04-03 08:00:00-04:00,0,4,8,3,0,1333,23502,24835
2014-04-03 09:00:00-04:00,0,4,9,3,0,1935,26964,28899
2014-04-03 10:00:00-04:00,0,4,10,3,0,1875,25449,27324
2014-04-03 11:00:00-04:00,0,4,11,3,0,1653,22713,24366
2014-04-03 12:00:00-04:00,0,4,12,3,0,1612,22340,23952
2014-04-03 13:00:00-04:00,0,4,13,3,0,1704,23399,25103
2014-04-03 14:00:00-04:00,0,4,14,3,0,1725,22944,24669
2014-04-03 15:00:00-04:00,0,4,15,3,0,2012,24531,26543
2014-04-03 16:00:00-04:00,0,4,16,3,0,2145,23150,25295
2014-04-03 17:00:00-04:00,0,4,17,3,0,2341,18623,20964
2014-04-03 18:00:00-04:00,0,4,18,3,0,2763,23953,26716
2014-04-03 19:00:00-04:00,0,4,19,3,0,2949,30712,33661
2014-04-03 20:00:00-04:00,0,4,20,3,0,2855,32662,35517
2014-04-03 21:00:00-04:00,0,4,21,3,0,2765,32037,34802
2014-04-03 22:00:00-04:00,0.01,4,22,3,0,2569,31769,34338
2014-04-03 23:00:00-04:00,0.03,4,23,3,0,2721,31492,34213
2014-04-04 00:00:00-04:00,0.03,4,0,4,0,2462,28818,31280
2014-04-04 01:00:00-04:00,0,4,1,4,0,1812,21505,23317
2014-04-04 02:00:00-04:00,0,4,2,4,0,1243,13794,15037
2014-04-04 03:00:00-04:00,0,4,3,4,0,781,9020,9801
2014-04-04 04:00:00-04:00,0,4,4,4,0,573,6134,6707
2014-04-04 05:00:00-04:00,0,4,5,4,0,470,4832,5302
2014-04-04 06:00:00-04:00,0,4,6,4,0,359,5452,5811
2014-04-04 07:00:00-04:00,0.02,4,7,4,0,522,13453,13975
2014-04-04 08:00:00-04:00,0,4,8,4,0,1374,23750,25124
2014-04-04 09:00:00-04:00,0,4,9,4,0,2043,28085,30128
2014-04-04 10:00:00-04:00,0,4,10,4,0,2029,26955,28984
2014-04-04 11:00:00-04:00,0,4,11,4,0,1866,23944,25810
2014-04-04 12:00:00-04:00,0,4,12,4,0,1751,24731,26482
2014-04-04 13:00:00-04:00,0,4,13,4,0,1712,25530,27242
2014-04-04 14:00:00-04:00,0,4,14,4,0,1744,24577,26321
2014-04-04 15:00:00-04:00,0,4,15,4,0,2219,26763,28982
2014-04-04 16:00:00-04:00,0,4,16,4,0,2503,23141,25644
2014-04-04 17:00:00-04:00,0,4,17,4,0,2879,18228,21107
2014-04-04 18:00:00-04:00,0.01,4,18,4,0,3411,24623,28034
2014-04-04 19:00:00-04:00,0.02,4,19,4,0,3758,32151,35909
2014-04-04 20:00:00-04:00,0.02,4,20,4,0,3971,34694,38665
2014-04-04 21:00:00-04:00,0,4,21,4,0,3845,33905,37750
2014-04-04 22:00:00-04:00,0.02,4,22,4,0,3512,32355,35867
2014-04-04 23:00:00-04:00,0,4,23,4,0,3647,33557,37204
2014-04-05 00:00:00-04:00,0.1,4,0,5,0,3759,33340,37099
2014-04-05 01:00:00-04:00,0,4,1,5,0,3385,29740,33125
2014-04-05 02:00:00-04:00,0,4,2,5,0,2846,24431,27277
2014-04-05 03:00:00-04:00,0,4,3,5,0,2147,19545,21692
2014-04-05 04:00:00-04:00,0,4,4,5,0,1800,14467,16267
2014-04-05 05:00:00-04:00,0,4,5,5,0,1387,9601,10988
2014-04-05 06:00:00-04:00,0,4,6,5,0,726,4800,5526
2014-04-05 07:00:00-04:00,0,4,7,5,0,636,6003,6639
2014-04-05 08:00:00-04:00,0,4,8,5,0,764,9358,10122
2014-04-05 09:00:00-04:00,0,4,9,5,0,1120,13503,14623
2014-04-05 10:00:00-04:00,0,4,10,5,0,1422,19456,20878
2014-04-05 11:00:00-04:00,0,4,11,5,0,1604,22563,24167
2014-04-05 12:00:00-04:00,0,4,12,5,0,1795,24889,26684
2014-04-05 13:00:00-04:00,0,4,13,5,0,1918,26980,28898
2014-04-05 14:00:00-04:00,0,4,14,5,0,2005,26853,28858
2014-04-05 15:00:00-04:00,0,4,15,5,0,2213,25621,27834
2014-04-05 16:00:00-04:00,0,4,16,5,0,2563,24363,26926
2014-04-05 17:00:00-04:00,0,4,17,5,0,2807,20676,23483
2014-04-05 18:00:00-04:00,0,4,18,5,0,3100,24861,27961
2014-04-05 19:00:00-04:00,0,4,19,5,0,3401,31307,34708
2014-04-05 20:00:00-04:00,0,4,20,5,0,3651,32277,35928
2014-04-05 21:00:00-04:00,0,4,21,5,0,3938,32258,36196
2014-04-05 22:00:00-04:00,0,4,22,5,0,3849,31683,35532
2014-04-05 23:00:00-04:00,0,4,23,5,0,4005,33737,37742
2014-04-06 00:00:00-04:00,0,4,0,6,0,4082,34203,38285
2014-04-06 01:00:00-04:00,0,4,1,6,0,3852,31973,35825
2014-04-06 02:00:00-04:00,0,4,2,6,0,3558,28762,32320
2014-04-06 03:00:00-04:00,0,4,3,6,0,3010,24779,27789
2014-04-06 04:00:00-04:00,0,4,4,6,0,2496,19631,22127
2014-04-06 05:00:00-04:00,0,4,5,6,0,1870,12372,14242
2014-04-06 06:00:00-04:00,0,4,6,6,0,926,5769,6695
2014-04-06 07:00:00-04:00,0,4,7,6,0,610,5195,5805
2014-04-06 08:00:00-04:00,0,4,8,6,0,600,7031,7631
2014-04-06 09:00:00-04:00,0,4,9,6,0,740,10237,10977
2014-04-06 10:00:00-04:00,0,4,10,6,0,1001,15554,16555
2014-04-06 11:00:00-04:00,0,4,11,6,0,1276,20409,21685
2014-04-06 12:00:00-04:00,0,4,12,6,0,1417,23255,24672
2014-04-06 13:00:00-04:00,0,4,13,6,0,1600,25324,26924
2014-04-06 14:00:00-04:00,0,4,14,6,0,1683,24901,26584
2014-04-06 15:00:00-04:00,0,4,15,6,0,1859,24862,26721
2014-04-06 16:00:00-04:00,0,4,16,6,0,2152,22963,25115
2014-04-06 17:00:00-04:00,0,4,17,6,0,2313,21397,23710
2014-04-06 18:00:00-04:00,0,4,18,6,0,2286,22930,25216
2014-04-06 19:00:00-04:00,0,4,19,6,0,2521,25104,27625
2014-04-06 20:00:00-04:00,0,4,20,6,0,2532,24324,26856
2014-04-06 21:00:00-04:00,0,4,21,6,0,2596,23176,25772
2014-04-06 22:00:00-04:00,0,4,22,6,0,2286,20296,22582
2014-04-06 23:00:00-04:00,0,4,23,6,0,2144,19996,22140
2014-04-07 00:00:00-04:00,0,4,0,0,0,1843,15027,16870
2014-04-07 01:00:00-04:00,0,4,1,0,0,1333,9706,11039
2014-04-07 02:00:00-04:00,0,4,2,0,0,799,5566,6365
2014-04-07 03:00:00-04:00,0,4,3,0,0,512,3729,4241
2014-04-07 04:00:00-04:00,0,4,4,0,0,399,2399,2798
2014-04-07 05:00:00-04:00,0,4,5,0,0,458,2816,3274
2014-04-07 06:00:00-04:00,0,4,6,0,0,346,4756,5102
2014-04-07 07:00:00-04:00,0,4,7,0,0,550,12413,12963
2014-04-07 08:00:00-04:00,0,4,8,0,0,1325,22201,23526
2014-04-07 09:00:00-04:00,0,4,9,0,0,1949,25692,27641
2014-04-07 10:00:00-04:00,0,4,10,0,0,1898,24076,25974
2014-04-07 11:00:00-04:00,0,4,11,0,0,1670,21271,22941
2014-04-07 12:00:00-04:00,0,4,12,0,0,1534,20562,22096
2014-04-07 13:00:00-04:00,0,4,13,0,0,1502,21012,22514
2014-04-07 14:00:00-04:00,0,4,14,0,0,1521,20890,22411
2014-04-07 15:00:00-04:00,0,4,15,0,0,1787,22772,24559
2014-04-07 16:00:00-04:00,0,4,16,0,0,2085,24008,26093
2014-04-07 17:00:00-04:00,0.07,4,17,0,0,2143,20342,22485
2014-04-07 18:00:00-04:00,0.12,4,18,0,0,2935,27705,30640
2014-04-07 19:00:00-04:00,0.08,4,19,0,0,3336,32963,36299
2014-04-07 20:00:00-04:00,0.16,4,20,0,0,2977,32447,35424
2014-04-07 21:00:00-04:00,0.11,4,21,0,0,2934,32302,35236
2014-04-07 22:00:00-04:00,0.06,4,22,0,0,2226,28444,30670
2014-04-07 23:00:00-04:00,0.05,4,23,0,0,1715,23930,25645
2014-04-08 00:00:00-04:00,0.01,4,0,1,0,1337,18612,19949
2014-04-08 01:00:00-04:00,0,4,1,1,0,885,10868,11753
2014-04-08 02:00:00-04:00,0,4,2,1,0,572,6408,6980
2014-04-08 03:00:00-04:00,0.01,4,3,1,0,348,3720,4068
2014-04-08 04:00:00-04:00,0.12,4,4,1,0,265,2363,2628
2014-04-08 05:00:00-04:00,0.1,4,5,1,0,317,2519,2836
2014-04-08 06:00:00-04:00,0.1,4,6,1,0,242,4433,4675
2014-04-08 07:00:00-04:00,0,4,7,1,0,512,13820,14332
2014-04-08 08:00:00-04:00,0,4,8,1,0,1357,23781,25138
2014-04-08 09:00:00-04:00,0.01,4,9,1,0,2027,27940,29967
2014-04-08 10:00:00-04:00,0,4,10,1,0,1947,26320,28267
2014-04-08 11:00:00-04:00,0,4,11,1,0,1661,22353,24014
2014-04-08 12:00:00-04:00,0,4,12,1,0,1516,21147,22663
2014-04-08 13:00:00-04:00,0,4,13,1,0,1470,22211,23681
2014-04-08 14:00:00-04:00,0,4,14,1,0,1484,21619,23103
2014-04-08 15:00:00-04:00,0,4,15,1,0,1745,23160,24905
2014-04-08 16:00:00-04:00,0,4,16,1,0,1946,22881,24827
2014-04-08 17:00:00-04:00,0,4,17,1,0,2064,18544,20608
2014-04-08 18:00:00-04:00,0,4,18,1,0,2427,23897,26324
2014-04-08 19:00:00-04:00,0,4,19,1,0,2398,29840,32238
2014-04-08 20:00:00-04:00,0,4,20,1,0,2448,30203,32651
2014-04-08 21:00:00-04:00,0,4,21,1,0,2148,30023,32171
2014-04-08 22:00:00-04:00,0,4,22,1,0,2279,30175,32454
2014-04-08 23:00:00-04:00,0,4,23,1,0,1903,27832,29735
2014-04-09 00:00:00-04:00,0,4,0,2,0,1593,20961,22554
2014-04-09 01:00:00-04:00,0,4,1,2,0,1153,13009,14162
2014-04-09 02:00:00-04:00,0,4,2,2,0,771,7444,8215
2014-04-09 03:00:00-04:00,0,4,3,2,0,464,4730,5194
2014-04-09 04:00:00-04:00,0,4,4,2,0,374,3103,3477
2014-04-09 05:00:00-04:00,0,4,5,2,0,378,3135,3513
2014-04-09 06:00:00-04:00,0,4,6,2,0,294,4508,4802
2014-04-09 07:00:00-04:00,0,4,7,2,0,531,12797,13328
2014-04-09 08:00:00-04:00,0,4,8,2,0,1200,23747,24947
2014-04-09 09:00:00-04:00,0,4,9,2,0,1925,27105,29030
2014-04-09 10:00:00-04:00,0,4,10,2,0,1971,25216,27187
2014-04-09 11:00:00-04:00,0,4,11,2,0,1662,22450,24112
2014-04-09 12:00:00-04:00,0,4,12,2,0,1577,21716,23293
2014-04-09 13:00:00-04:00,0,4,13,2,0,1606,22888,24494
2014-04-09 14:00:00-04:00,0,4,14,2,0,1595,22214,23809
2014-04-09 15:00:00-04:00,0,4,15,2,0,1878,24032,25910
2014-04-09 16:00:00-04:00,0,4,16,2,0,2102,22946,25048
2014-04-09 17:00:00-04:00,0,4,17,2,0,2156,18885,21041
2014-04-09 18:00:00-04:00,0,4,18,2,0,2589,24257,26846
2014-04-09 19:00:00-04:00,0,4,19,2,0,2746,31132,33878
2014-04-09 20:00:00-04:00,0,4,20,2,0,2741,32634,35375
2014-04-09 21:00:00-04:00,0,4,21,2,0,2636,32648,35284
2014-04-09 22:00:00-04:00,0,4,22,2,0,2454,31159,33613
2014-04-09 23:00:00-04:00,0,4,23,2,0,2221,29637,31858
2014-04-10 00:00:00-04:00,0,4,0,3,0,1764,23271,25035
2014-04-10 01:00:00-04:00,0,4,1,3,0,1367,15174,16541
2014-04-10 02:00:00-04:00,0,4,2,3,0,870,9134,10004
2014-04-10 03:00:00-04:00,0,4,3,3,0,634,5343,5977
2014-04-10 04:00:00-04:00,0,4,4,3,0,425,3624,4049
2014-04-10 05:00:00-04:00,0,4,5,3,0,425,3578,4003
2014-04-10 06:00:00-04:00,0,4,6,3,0,295,4931,5226
2014-04-10 07:00:00-04:00,0,4,7,3,0,576,13303,13879
2014-04-10 08:00:00-04:00,0,4,8,3,0,1301,24241,25542
2014-04-10 09:00:00-04:00,0,4,9,3,0,1977,27508,29485
2014-04-10 10:00:00-04:00,0,4,10,3,0,2006,25759,27765
2014-04-10 11:00:00-04:00,0,4,11,3,0,1725,23385,25110
2014-04-10 12:00:00-04:00,0,4,12,3,0,1647,23079,24726
2014-04-10 13:00:00-04:00,0,4,13,3,0,1721,23166,24887
2014-04-10 14:00:00-04:00,0,4,14,3,0,1623,22977,24600
2014-04-10 15:00:00-04:00,0,4,15,3,0,1928,24628,26556
2014-04-10 16:00:00-04:00,0,4,16,3,0,2079,22669,24748
2014-04-10 17:00:00-04:00,0,4,17,3,0,2418,17976,20394
2014-04-10 18:00:00-04:00,0,4,18,3,0,2711,23647,26358
2014-04-10 19:00:00-04:00,0,4,19,3,0,3050,30548,33598
2014-04-10 20:00:00-04:00,0,4,20,3,0,2942,32256,35198
2014-04-10 21:00:00-04:00,0,4,21,3,0,2821,32252,35073
2014-04-10 22:00:00-04:00,0,4,22,3,0,2555,31981,34536
2014-04-10 23:00:00-04:00,0,4,23,3,0,2567,30820,33387
2014-04-11 00:00:00-04:00,0,4,0,4,0,2136,26891,29027
2014-04-11 01:00:00-04:00,0,4,1,4,0,1712,20453,22165
2014-04-11 02:00:00-04:00,0,4,2,4,0,1190,13125,14315
2014-04-11 03:00:00-04:00,0,4,3,4,0,771,8640,9411
2014-04-11 04:00:00-04:00,0,4,4,4,0,600,5871,6471
2014-04-11 05:00:00-04:00,0,4,5,4,0,557,4700,5257
2014-04-11 06:00:00-04:00,0,4,6,4,0,378,5114,5492
2014-04-11 07:00:00-04:00,0,4,7,4,0,600,12625,13225
2014-04-11 08:00:00-04:00,0,4,8,4,0,1391,23031,24422
2014-04-11 09:00:00-04:00,0,4,9,4,0,2093,27012,29105
2014-04-11 10:00:00-04:00,0,4,10,4,0,1988,25512,27500
2014-04-11 11:00:00-04:00,0,4,11,4,0,1764,22536,24300
2014-04-11 12:00:00-04:00,0,4,12,4,0,1687,22885,24572
2014-04-11 13:00:00-04:00,0,4,13,4,0,1666,23516,25182
2014-04-11 14:00:00-04:00,0,4,14,4,0,1608,22506,24114
2014-04-11 15:00:00-04:00,0,4,15,4,0,1912,24603,26515
2014-04-11 16:00:00-04:00,0,4,16,4,0,2263,21231,23494
2014-04-11 17:00:00-04:00,0,4,17,4,0,2686,17282,19968
2014-04-11 18:00:00-04:00,0,4,18,4,0,3033,22560,25593
2014-04-11 19:00:00-04:00,0,4,19,4,0,3471,29548,33019
2014-04-11 20:00:00-04:00,0,4,20,4,0,3456,31017,34473
2014-04-11 21:00:00-04:00,0,4,21,4,0,3377,30690,34067
2014-04-11 22:00:00-04:00,0,4,22,4,0,3345,30340,33685
2014-04-11 23:00:00-04:00,0,4,23,4,0,3605,31599,35204
2014-04-12 00:00:00-04:00,0,4,0,5,0,3549,29629,33178
2014-04-12 01:00:00-04:00,0,4,1,5,0,3251,28468,31719
2014-04-12 02:00:00-04:00,0,4,2,5,0,2931,25266,28197
2014-04-12 03:00:00-04:00,0,4,3,5,0,2532,20920,23452
2014-04-12 04:00:00-04:00,0,4,4,5,0,2063,15213,17276
2014-04-12 05:00:00-04:00,0,4,5,5,0,1548,9896,11444
2014-04-12 06:00:00-04:00,0,4,6,5,0,778,4889,5667
2014-04-12 07:00:00-04:00,0,4,7,5,0,522,6181,6703
2014-04-12 08:00:00-04:00,0,4,8,5,0,691,9150,9841
2014-04-12 09:00:00-04:00,0,4,9,5,0,970,13644,14614
2014-04-12 10:00:00-04:00,0,4,10,5,0,1310,18617,19927
2014-04-12 11:00:00-04:00,0,4,11,5,0,1492,21332,22824
2014-04-12 12:00:00-04:00,0,4,12,5,0,1636,23947,25583
2014-04-12 13:00:00-04:00,0,4,13,5,0,1769,26023,27792
2014-04-12 14:00:00-04:00,0,4,14,5,0,1978,26094,28072
2014-04-12 15:00:00-04:00,0,4,15,5,0,2299,26005,28304
2014-04-12 16:00:00-04:00,0,4,16,5,0,2454,24993,27447
2014-04-12 17:00:00-04:00,0,4,17,5,0,2930,21484,24414
2014-04-12 18:00:00-04:00,0,4,18,5,0,3024,25031,28055
2014-04-12 19:00:00-04:00,0,4,19,5,0,3406,31153,34559
2014-04-12 20:00:00-04:00,0,4,20,5,0,3838,33537,37375
2014-04-12 21:00:00-04:00,0,4,21,5,0,3905,31591,35496
2014-04-12 22:00:00-04:00,0,4,22,5,0,3969,30691,34660
2014-04-12 23:00:00-04:00,0,4,23,5,0,4121,32606,36727
2014-04-13 00:00:00-04:00,0,4,0,6,0,3903,33471,37374
2014-04-13 01:00:00-04:00,0,4,1,6,0,3678,31232,34910
2014-04-13 02:00:00-04:00,0,4,2,6,0,3586,28783,32369
2014-04-13 03:00:00-04:00,0,4,3,6,0,2971,24054,27025
2014-04-13 04:00:00-04:00,0,4,4,6,0,2444,18100,20544
2014-04-13 05:00:00-04:00,0,4,5,6,0,1850,11669,13519
2014-04-13 06:00:00-04:00,0,4,6,6,0,909,5401,6310
2014-04-13 07:00:00-04:00,0,4,7,6,0,602,5318,5920
2014-04-13 08:00:00-04:00,0,4,8,6,0,571,7593,8164
2014-04-13 09:00:00-04:00,0,4,9,6,0,672,10101,10773
2014-04-13 10:00:00-04:00,0,4,10,6,0,932,14973,15905
2014-04-13 11:00:00-04:00,0,4,11,6,0,1221,20529,21750
2014-04-13 12:00:00-04:00,0,4,12,6,0,1451,23285,24736
2014-04-13 13:00:00-04:00,0,4,13,6,0,1553,24910,26463
2014-04-13 14:00:00-04:00,0,4,14,6,0,1710,25256,26966
2014-04-13 15:00:00-04:00,0,4,15,6,0,1999,25449,27448
2014-04-13 16:00:00-04:00,0,4,16,6,0,2120,24028,26148
2014-04-13 17:00:00-04:00,0,4,17,6,0,2261,22292,24553
2014-04-13 18:00:00-04:00,0,4,18,6,0,2216,23989,26205
2014-04-13 19:00:00-04:00,0,4,19,6,0,2235,24898,27133
2014-04-13 20:00:00-04:00,0,4,20,6,0,2465,24012,26477
2014-04-13 21:00:00-04:00,0,4,21,6,0,2455,21671,24126
2014-04-13 22:00:00-04:00,0,4,22,6,0,2182,20039,22221
2014-04-13 23:00:00-04:00,0,4,23,6,0,2068,18969,21037
2014-04-14 00:00:00-04:00,0,4,0,0,0,1855,15490,17345
2014-04-14 01:00:00-04:00,0,4,1,0,0,1408,10250,11658
2014-04-14 02:00:00-04:00,0,4,2,0,0,974,5778,6752
2014-04-14 03:00:00-04:00,0,4,3,0,0,679,3720,4399
2014-04-14 04:00:00-04:00,0,4,4,0,0,472,2741,3213
2014-04-14 05:00:00-04:00,0,4,5,0,0,497,2938,3435
2014-04-14 06:00:00-04:00,0,4,6,0,0,326,4661,4987
2014-04-14 07:00:00-04:00,0,4,7,0,0,541,11735,12276
2014-04-14 08:00:00-04:00,0,4,8,0,0,1034,19950,20984
2014-04-14 09:00:00-04:00,0,4,9,0,0,1653,23594,25247
2014-04-14 10:00:00-04:00,0,4,10,0,0,1643,22996,24639
2014-04-14 11:00:00-04:00,0,4,11,0,0,1494,20311,21805
2014-04-14 12:00:00-04:00,0,4,12,0,0,1386,20372,21758
2014-04-14 13:00:00-04:00,0,4,13,0,0,1442,21457,22899
2014-04-14 14:00:00-04:00,0,4,14,0,0,1458,21090,22548
2014-04-14 15:00:00-04:00,0,4,15,0,0,1633,22195,23828
2014-04-14 16:00:00-04:00,0,4,16,0,0,1909,22391,24300
2014-04-14 17:00:00-04:00,0,4,17,0,0,2174,18854,21028
2014-04-14 18:00:00-04:00,0,4,18,0,0,2224,22790,25014
2014-04-14 19:00:00-04:00,0,4,19,0,0,2365,26897,29262
2014-04-14 20:00:00-04:00,0,4,20,0,0,2281,25227,27508
2014-04-14 21:00:00-04:00,0,4,21,0,0,2158,23941,26099
2014-04-14 22:00:00-04:00,0,4,22,0,0,1805,24557,26362
2014-04-14 23:00:00-04:00,0,4,23,0,0,1690,23313,25003
2014-04-15 00:00:00-04:00,0,4,0,1,0,1406,17510,18916
2014-04-15 01:00:00-04:00,0,4,1,1,0,1057,10916,11973
2014-04-15 02:00:00-04:00,0,4,2,1,0,696,6428,7124
2014-04-15 03:00:00-04:00,0,4,3,1,0,470,3928,4398
2014-04-15 04:00:00-04:00,0,4,4,1,0,370,2656,3026
2014-04-15 05:00:00-04:00,0.05,4,5,1,0,350,2594,2944
2014-04-15 06:00:00-04:00,0.05,4,6,1,0,267,4410,4677
2014-04-15 07:00:00-04:00,0,4,7,1,0,504,11616,12120
2014-04-15 08:00:00-04:00,0,4,8,1,0,1000,19913,20913
2014-04-15 09:00:00-04:00,0.03,4,9,1,0,1614,25050,26664
2014-04-15 10:00:00-04:00,0.15,4,10,1,0,1887,25781,27668
2014-04-15 11:00:00-04:00,0,4,11,1,0,1720,23349,25069
2014-04-15 12:00:00-04:00,0.03,4,12,1,0,1601,24077,25678
2014-04-15 13:00:00-04:00,0,4,13,1,0,1666,24397,26063
2014-04-15 14:00:00-04:00,0.01,4,14,1,0,1580,22791,24371
2014-04-15 15:00:00-04:00,0.02,4,15,1,0,1770,23996,25766
2014-04-15 16:00:00-04:00,0,4,16,1,0,1931,21816,23747
2014-04-15 17:00:00-04:00,0,4,17,1,0,1989,18277,20266
2014-04-15 18:00:00-04:00,0.02,4,18,1,0,2517,25822,28339
2014-04-15 19:00:00-04:00,0.02,4,19,1,0,2973,31641,34614
2014-04-15 20:00:00-04:00,0.03,4,20,1,0,2990,33713,36703
2014-04-15 21:00:00-04:00,0.12,4,21,1,0,2892,33563,36455
2014-04-15 22:00:00-04:00,0.1,4,22,1,0,2732,32519,35251
2014-04-15 23:00:00-04:00,0.07,4,23,1,0,2394,29376,31770
2014-04-16 00:00:00-04:00,0.17,4,0,2,0,1865,22795,24660
2014-04-16 01:00:00-04:00,0.05,4,1,2,0,1503,14756,16259
2014-04-16 02:00:00-04:00,0,4,2,2,0,902,7670,8572
2014-04-16 03:00:00-04:00,0,4,3,2,0,502,4414,4916
2014-04-16 04:00:00-04:00,0,4,4,2,0,328,2843,3171
2014-04-16 05:00:00-04:00,0,4,5,2,0,337,2800,3137
2014-04-16 06:00:00-04:00,0,4,6,2,0,281,4499,4780
2014-04-16 07:00:00-04:00,0,4,7,2,0,479,12981,13460
2014-04-16 08:00:00-04:00,0,4,8,2,0,986,22923,23909
2014-04-16 09:00:00-04:00,0,4,9,2,0,1657,27632,29289
2014-04-16 10:00:00-04:00,0,4,10,2,0,1841,26989,28830
2014-04-16 11:00:00-04:00,0,4,11,2,0,1653,23568,25221
2014-04-16 12:00:00-04:00,0,4,12,2,0,1618,23536,25154
2014-04-16 13:00:00-04:00,0,4,13,2,0,1624,24881,26505
2014-04-16 14:00:00-04:00,0,4,14,2,0,1509,23626,25135
2014-04-16 15:00:00-04:00,0,4,15,2,0,1790,24359,26149
2014-04-16 16:00:00-04:00,0,4,16,2,0,1988,23268,25256
2014-04-16 17:00:00-04:00,0,4,17,2,0,2161,19384,21545
2014-04-16 18:00:00-04:00,0,4,18,2,0,2432,24123,26555
2014-04-16 19:00:00-04:00,0,4,19,2,0,2546,30620,33166
2014-04-16 20:00:00-04:00,0,4,20,2,0,2698,32302,35000
2014-04-16 21:00:00-04:00,0,4,21,2,0,2676,31881,34557
2014-04-16 22:00:00-04:00,0,4,22,2,0,2554,30995,33549
2014-04-16 23:00:00-04:00,0,4,23,2,0,2325,30145,32470
2014-04-17 00:00:00-04:00,0,4,0,3,0,1994,25243,27237
2014-04-17 01:00:00-04:00,0,4,1,3,0,1589,16597,18186
2014-04-17 02:00:00-04:00,0,4,2,3,0,1041,9723,10764
2014-04-17 03:00:00-04:00,0,4,3,3,0,710,6181,6891
2014-04-17 04:00:00-04:00,0,4,4,3,0,538,4027,4565
2014-04-17 05:00:00-04:00,0,4,5,3,0,513,3653,4166
2014-04-17 06:00:00-04:00,0,4,6,3,0,366,4779,5145
2014-04-17 07:00:00-04:00,0,4,7,3,0,506,12648,13154
2014-04-17 08:00:00-04:00,0,4,8,3,0,1090,22703,23793
2014-04-17 09:00:00-04:00,0,4,9,3,0,1773,27562,29335
2014-04-17 10:00:00-04:00,0,4,10,3,0,1842,26538,28380
2014-04-17 11:00:00-04:00,0,4,11,3,0,1650,24236,25886
2014-04-17 12:00:00-04:00,0,4,12,3,0,1662,24141,25803
2014-04-17 13:00:00-04:00,0,4,13,3,0,1603,25183,26786
2014-04-17 14:00:00-04:00,0,4,14,3,0,1704,24941,26645
2014-04-17 15:00:00-04:00,0,4,15,3,0,1952,25202,27154
2014-04-17 16:00:00-04:00,0,4,16,3,0,2052,22881,24933
2014-04-17 17:00:00-04:00,0,4,17,3,0,2298,16976,19274
2014-04-17 18:00:00-04:00,0,4,18,3,0,2575,21939,24514
2014-04-17 19:00:00-04:00,0,4,19,3,0,3076,27873,30949
2014-04-17 20:00:00-04:00,0,4,20,3,0,3007,32055,35062
2014-04-17 21:00:00-04:00,0,4,21,3,0,2917,33546,36463
2014-04-17 22:00:00-04:00,0,4,22,3,0,2921,33058,35979
2014-04-17 23:00:00-04:00,0,4,23,3,0,2675,32221,34896
2014-04-18 00:00:00-04:00,0,4,0,4,0,2508,29752,32260
2014-04-18 01:00:00-04:00,0,4,1,4,0,1951,23737,25688
2014-04-18 02:00:00-04:00,0,4,2,4,0,1401,16439,17840
2014-04-18 03:00:00-04:00,0,4,3,4,0,994,11167,12161
2014-04-18 04:00:00-04:00,0,4,4,4,0,644,7570,8214
2014-04-18 05:00:00-04:00,0,4,5,4,0,573,5791,6364
2014-04-18 06:00:00-04:00,0,4,6,4,0,358,4815,5173
2014-04-18 07:00:00-04:00,0,4,7,4,0,461,8698,9159
2014-04-18 08:00:00-04:00,0,4,8,4,0,816,13004,13820
2014-04-18 09:00:00-04:00,0,4,9,4,0,1447,20738,22185
2014-04-18 10:00:00-04:00,0,4,10,4,0,1694,24277,25971
2014-04-18 11:00:00-04:00,0,4,11,4,0,1701,23684,25385
2014-04-18 12:00:00-04:00,0,4,12,4,0,1695,24245,25940
2014-04-18 13:00:00-04:00,0,4,13,4,0,1597,25099,26696
2014-04-18 14:00:00-04:00,0,4,14,4,0,1526,24245,25771
2014-04-18 15:00:00-04:00,0,4,15,4,0,1824,25835,27659
2014-04-18 16:00:00-04:00,0,4,16,4,0,2124,24249,26373
2014-04-18 17:00:00-04:00,0,4,17,4,0,2434,20502,22936
2014-04-18 18:00:00-04:00,0,4,18,4,0,2794,25697,28491
2014-04-18 19:00:00-04:00,0,4,19,4,0,3206,30897,34103
2014-04-18 20:00:00-04:00,0,4,20,4,0,3371,32947,36318
2014-04-18 21:00:00-04:00,0,4,21,4,0,3328,30964,34292
2014-04-18 22:00:00-04:00,0,4,22,4,0,3377,29060,32437
2014-04-18 23:00:00-04:00,0,4,23,4,0,3326,30508,33834
2014-04-19 00:00:00-04:00,0,4,0,5,0,3377,30725,34102
2014-04-19 01:00:00-04:00,0,4,1,5,0,3180,28035,31215
2014-04-19 02:00:00-04:00,0,4,2,5,0,2773,24198,26971
2014-04-19 03:00:00-04:00,0,4,3,5,0,2293,19575,21868
2014-04-19 04:00:00-04:00,0,4,4,5,0,1928,14458,16386
2014-04-19 05:00:00-04:00,0,4,5,5,0,1480,9579,11059
2014-04-19 06:00:00-04:00,0,4,6,5,0,754,4607,5361
2014-04-19 07:00:00-04:00,0,4,7,5,0,562,5102,5664
2014-04-19 08:00:00-04:00,0,4,8,5,0,583,6698,7281
2014-04-19 09:00:00-04:00,0,4,9,5,0,837,9945,10782
2014-04-19 10:00:00-04:00,0,4,10,5,0,1118,15163,16281
2014-04-19 11:00:00-04:00,0,4,11,5,0,1344,19212,20556
2014-04-19 12:00:00-04:00,0,4,12,5,0,1550,22100,23650
2014-04-19 13:00:00-04:00,0,4,13,5,0,1758,23709,25467
2014-04-19 14:00:00-04:00,0,4,14,5,0,1833,24340,26173
2014-04-19 15:00:00-04:00,0,4,15,5,0,2039,23088,25127
2014-04-19 16:00:00-04:00,0,4,16,5,0,2318,22729,25047
2014-04-19 17:00:00-04:00,0,4,17,5,0,2518,20137,22655
2014-04-19 18:00:00-04:00,0,4,18,5,0,2764,23685,26449
2014-04-19 19:00:00-04:00,0,4,19,5,0,3152,27160,30312
2014-04-19 20:00:00-04:00,0,4,20,5,0,3343,28977,32320
2014-04-19 21:00:00-04:00,0,4,21,5,0,3368,26790,30158
2014-04-19 22:00:00-04:00,0,4,22,5,0,3615,25852,29467
2014-04-19 23:00:00-04:00,0,4,23,5,0,3800,28392,32192
2014-04-20 00:00:00-04:00,0,4,0,6,0,3791,30385,34176
2014-04-20 01:00:00-04:00,0,4,1,6,0,3570,27720,31290
2014-04-20 02:00:00-04:00,0,4,2,6,0,3304,23793,27097
2014-04-20 03:00:00-04:00,0,4,3,6,0,2783,19662,22445
2014-04-20 04:00:00-04:00,0,4,4,6,0,2254,14658,16912
2014-04-20 05:00:00-04:00,0,4,5,6,0,1798,9849,11647
2014-04-20 06:00:00-04:00,0,4,6,6,0,866,4616,5482
2014-04-20 07:00:00-04:00,0,4,7,6,0,580,4586,5166
2014-04-20 08:00:00-04:00,0,4,8,6,0,552,5738,6290
2014-04-20 09:00:00-04:00,0,4,9,6,0,737,8941,9678
2014-04-20 10:00:00-04:00,0,4,10,6,0,951,13298,14249
2014-04-20 11:00:00-04:00,0,4,11,6,0,1285,19614,20899
2014-04-20 12:00:00-04:00,0,4,12,6,0,1514,21798,23312
2014-04-20 13:00:00-04:00,0,4,13,6,0,1608,22597,24205
2014-04-20 14:00:00-04:00,0,4,14,6,0,1752,22651,24403
2014-04-20 15:00:00-04:00,0,4,15,6,0,1974,22049,24023
2014-04-20 16:00:00-04:00,0,4,16,6,0,2179,21236,23415
2014-04-20 17:00:00-04:00,0,4,17,6,0,2264,19835,22099
2014-04-20 18:00:00-04:00,0,4,18,6,0,2324,21586,23910
2014-04-20 19:00:00-04:00,0,4,19,6,0,2515,22716,25231
2014-04-20 20:00:00-04:00,0,4,20,6,0,2438,22687,25125
2014-04-20 21:00:00-04:00,0,4,21,6,0,2485,23103,25588
2014-04-20 22:00:00-04:00,0,4,22,6,0,2364,21511,23875
2014-04-20 23:00:00-04:00,0,4,23,6,0,2275,19308,21583
2014-04-21 00:00:00-04:00,0,4,0,0,0,1876,15514,17390
2014-04-21 01:00:00-04:00,0,4,1,0,0,1421,9538,10959
2014-04-21 02:00:00-04:00,0,4,2,0,0,943,5483,6426
2014-04-21 03:00:00-04:00,0,4,3,0,0,640,3544,4184
2014-04-21 04:00:00-04:00,0,4,4,0,0,496,2446,2942
2014-04-21 05:00:00-04:00,0,4,5,0,0,445,2846,3291
2014-04-21 06:00:00-04:00,0,4,6,0,0,345,4502,4847
2014-04-21 07:00:00-04:00,0,4,7,0,0,527,11351,11878
2014-04-21 08:00:00-04:00,0,4,8,0,0,913,19359,20272
2014-04-21 09:00:00-04:00,0,4,9,0,0,1482,23057,24539
2014-04-21 10:00:00-04:00,0,4,10,0,0,1642,22731,24373
2014-04-21 11:00:00-04:00,0,4,11,0,0,1406,20013,21419
2014-04-21 12:00:00-04:00,0,4,12,0,0,1322,19791,21113
2014-04-21 13:00:00-04:00,0,4,13,0,0,1356,20903,22259
2014-04-21 14:00:00-04:00,0,4,14,0,0,1337,20688,22025
2014-04-21 15:00:00-04:00,0,4,15,0,0,1483,22015,23498
2014-04-21 16:00:00-04:00,0,4,16,0,0,1698,21869,23567
2014-04-21 17:00:00-04:00,0,4,17,0,0,1842,19512,21354
2014-04-21 18:00:00-04:00,0,4,18,0,0,1947,24195,26142
2014-04-21 19:00:00-04:00,0,4,19,0,0,2196,29068,31264
2014-04-21 20:00:00-04:00,0,4,20,0,0,2261,28328,30589
2014-04-21 21:00:00-04:00,0,4,21,0,0,2107,26768,28875
2014-04-21 22:00:00-04:00,0,4,22,0,0,1864,24807,26671
2014-04-21 23:00:00-04:00,0,4,23,0,0,1668,21906,23574
2014-04-22 00:00:00-04:00,0,4,0,1,0,1342,16627,17969
2014-04-22 01:00:00-04:00,0,4,1,1,0,960,11013,11973
2014-04-22 02:00:00-04:00,0,4,2,1,0,629,6219,6848
2014-04-22 03:00:00-04:00,0,4,3,1,0,428,3751,4179
2014-04-22 04:00:00-04:00,0,4,4,1,0,328,2435,2763
2014-04-22 05:00:00-04:00,0,4,5,1,0,370,2475,2845
2014-04-22 06:00:00-04:00,0,4,6,1,0,282,4247,4529
2014-04-22 07:00:00-04:00,0,4,7,1,0,496,12465,12961
2014-04-22 08:00:00-04:00,0,4,8,1,0,1077,21646,22723
2014-04-22 09:00:00-04:00,0,4,9,1,0,1644,25731,27375
2014-04-22 10:00:00-04:00,0,4,10,1,0,1727,24918,26645
2014-04-22 11:00:00-04:00,0,4,11,1,0,1544,22059,23603
2014-04-22 12:00:00-04:00,0,4,12,1,0,1385,21300,22685
2014-04-22 13:00:00-04:00,0,4,13,1,0,1417,22242,23659
2014-04-22 14:00:00-04:00,0,4,14,1,0,1401,21993,23394
2014-04-22 15:00:00-04:00,0,4,15,1,0,1597,23402,24999
2014-04-22 16:00:00-04:00,0,4,16,1,0,1794,23279,25073
2014-04-22 17:00:00-04:00,0,4,17,1,0,2203,21249,23452
2014-04-22 18:00:00-04:00,0,4,18,1,0,2396,24958,27354
2014-04-22 19:00:00-04:00,0,4,19,1,0,2529,30417,32946
2014-04-22 20:00:00-04:00,0,4,20,1,0,2436,32102,34538
2014-04-22 21:00:00-04:00,0,4,21,1,0,2161,29826,31987
2014-04-22 22:00:00-04:00,0,4,22,1,0,1895,28978,30873
2014-04-22 23:00:00-04:00,0,4,23,1,0,1850,26449,28299
2014-04-23 00:00:00-04:00,0,4,0,2,0,1475,20253,21728
2014-04-23 01:00:00-04:00,0,4,1,2,0,1146,12683,13829
2014-04-23 02:00:00-04:00,0,4,2,2,0,708,7506,8214
2014-04-23 03:00:00-04:00,0,4,3,2,0,457,4607,5064
2014-04-23 04:00:00-04:00,0,4,4,2,0,380,3033,3413
2014-04-23 05:00:00-04:00,0,4,5,2,0,370,2862,3232
2014-04-23 06:00:00-04:00,0,4,6,2,0,315,4485,4800
2014-04-23 07:00:00-04:00,0,4,7,2,0,546,12948,13494
2014-04-23 08:00:00-04:00,0,4,8,2,0,1304,23328,24632
2014-04-23 09:00:00-04:00,0,4,9,2,0,1988,27666,29654
2014-04-23 10:00:00-04:00,0,4,10,2,0,1914,26465,28379
2014-04-23 11:00:00-04:00,0,4,11,2,0,1786,23948,25734
2014-04-23 12:00:00-04:00,0,4,12,2,0,1590,23913,25503
2014-04-23 13:00:00-04:00,0,4,13,2,0,1598,24229,25827
2014-04-23 14:00:00-04:00,0,4,14,2,0,1639,23812,25451
2014-04-23 15:00:00-04:00,0,4,15,2,0,1831,24882,26713
2014-04-23 16:00:00-04:00,0,4,16,2,0,2025,23425,25450
2014-04-23 17:00:00-04:00,0,4,17,2,0,2124,18429,20553
2014-04-23 18:00:00-04:00,0,4,18,2,0,2504,23866,26370
2014-04-23 19:00:00-04:00,0,4,19,2,0,2796,31248,34044
2014-04-23 20:00:00-04:00,0,4,20,2,0,2979,34606,37585
2014-04-23 21:00:00-04:00,0,4,21,2,0,2833,33537,36370
2014-04-23 22:00:00-04:00,0,4,22,2,0,2576,32791,35367
2014-04-23 23:00:00-04:00,0,4,23,2,0,2529,31278,33807
2014-04-24 00:00:00-04:00,0,4,0,3,0,2126,25788,27914
2014-04-24 01:00:00-04:00,0,4,1,3,0,1558,16417,17975
2014-04-24 02:00:00-04:00,0,4,2,3,0,895,9274,10169
2014-04-24 03:00:00-04:00,0,4,3,3,0,593,5718,6311
2014-04-24 04:00:00-04:00,0,4,4,3,0,402,3915,4317
2014-04-24 05:00:00-04:00,0,4,5,3,0,421,3550,3971
2014-04-24 06:00:00-04:00,0,4,6,3,0,361,4949,5310
2014-04-24 07:00:00-04:00,0,4,7,3,0,605,13412,14017
2014-04-24 08:00:00-04:00,0,4,8,3,0,1345,23974,25319
2014-04-24 09:00:00-04:00,0,4,9,3,0,2120,27268,29388
2014-04-24 10:00:00-04:00,0,4,10,3,0,2020,26349,28369
2014-04-24 11:00:00-04:00,0,4,11,3,0,1778,23933,25711
2014-04-24 12:00:00-04:00,0,4,12,3,0,1578,23868,25446
2014-04-24 13:00:00-04:00,0,4,13,3,0,1652,24883,26535
2014-04-24 14:00:00-04:00,0,4,14,3,0,1623,23523,25146
2014-04-24 15:00:00-04:00,0,4,15,3,0,1771,24890,26661
2014-04-24 16:00:00-04:00,0,4,16,3,0,2022,22299,24321
2014-04-24 17:00:00-04:00,0,4,17,3,0,2324,17240,19564
2014-04-24 18:00:00-04:00,0,4,18,3,0,2601,22087,24688
2014-04-24 19:00:00-04:00,0,4,19,3,0,2815,29459,32274
2014-04-24 20:00:00-04:00,0,4,20,3,0,2878,32246,35124
2014-04-24 21:00:00-04:00,0,4,21,3,0,2776,32886,35662
2014-04-24 22:00:00-04:00,0,4,22,3,0,2618,32542,35160
2014-04-24 23:00:00-04:00,0,4,23,3,0,2693,31412,34105
2014-04-25 00:00:00-04:00,0,4,0,4,0,2377,28962,31339
2014-04-25 01:00:00-04:00,0,4,1,4,0,1939,21946,23885
2014-04-25 02:00:00-04:00,0,4,2,4,0,1356,14046,15402
2014-04-25 03:00:00-04:00,0,4,3,4,0,927,9347,10274
2014-04-25 04:00:00-04:00,0,4,4,4,0,640,6129,6769
2014-04-25 05:00:00-04:00,0,4,5,4,0,514,4845,5359
2014-04-25 06:00:00-04:00,0,4,6,4,0,379,5367,5746
2014-04-25 07:00:00-04:00,0,4,7,4,0,597,13066,13663
2014-04-25 08:00:00-04:00,0,4,8,4,0,1371,22701,24072
2014-04-25 09:00:00-04:00,0,4,9,4,0,1929,26672,28601
2014-04-25 10:00:00-04:00,0,4,10,4,0,1891,25467,27358
2014-04-25 11:00:00-04:00,0,4,11,4,0,1684,23315,24999
2014-04-25 12:00:00-04:00,0,4,12,4,0,1625,22974,24599
2014-04-25 13:00:00-04:00,0,4,13,4,0,1621,23584,25205
2014-04-25 14:00:00-04:00,0,4,14,4,0,1616,22519,24135
2014-04-25 15:00:00-04:00,0,4,15,4,0,1834,24299,26133
2014-04-25 16:00:00-04:00,0,4,16,4,0,2238,22050,24288
2014-04-25 17:00:00-04:00,0,4,17,4,0,2557,17433,19990
2014-04-25 18:00:00-04:00,0,4,18,4,0,3072,23291,26363
2014-04-25 19:00:00-04:00,0,4,19,4,0,3414,30291,33705
2014-04-25 20:00:00-04:00,0,4,20,4,0,3681,33902,37583
2014-04-25 21:00:00-04:00,0,4,21,4,0,3699,33232,36931
2014-04-25 22:00:00-04:00,0,4,22,4,0,3776,33266,37042
2014-04-25 23:00:00-04:00,0,4,23,4,0,3822,33802,37624
2014-04-26 00:00:00-04:00,0,4,0,5,0,3901,32738,36639
2014-04-26 01:00:00-04:00,0.02,4,1,5,0,3605,30347,33952
2014-04-26 02:00:00-04:00,0.08,4,2,5,0,3075,25596,28671
2014-04-26 03:00:00-04:00,0.08,4,3,5,0,2793,22760,25553
2014-04-26 04:00:00-04:00,0.08,4,4,5,0,2170,16325,18495
2014-04-26 05:00:00-04:00,0.08,4,5,5,0,1644,9963,11607
2014-04-26 06:00:00-04:00,0.02,4,6,5,0,792,5038,5830
2014-04-26 07:00:00-04:00,0,4,7,5,0,656,5993,6649
2014-04-26 08:00:00-04:00,0,4,8,5,0,748,8637,9385
2014-04-26 09:00:00-04:00,0,4,9,5,0,1064,13602,14666
2014-04-26 10:00:00-04:00,0,4,10,5,0,1396,19408,20804
2014-04-26 11:00:00-04:00,0,4,11,5,0,1552,22330,23882
2014-04-26 12:00:00-04:00,0,4,12,5,0,1750,24318,26068
2014-04-26 13:00:00-04:00,0,4,13,5,0,1827,26219,28046
2014-04-26 14:00:00-04:00,0,4,14,5,0,1942,25612,27554
2014-04-26 15:00:00-04:00,0,4,15,5,0,2202,24967,27169
2014-04-26 16:00:00-04:00,0.03,4,16,5,0,2689,24447,27136
2014-04-26 17:00:00-04:00,0.01,4,17,5,0,3179,20629,23808
2014-04-26 18:00:00-04:00,0.01,4,18,5,0,3384,23485,26869
2014-04-26 19:00:00-04:00,0,4,19,5,0,3643,29295,32938
2014-04-26 20:00:00-04:00,0,4,20,5,0,3893,31687,35580
2014-04-26 21:00:00-04:00,0.01,4,21,5,0,4247,32247,36494
2014-04-26 22:00:00-04:00,0,4,22,5,0,3989,31398,35387
2014-04-26 23:00:00-04:00,0,4,23,5,0,4134,32421,36555
2014-04-27 00:00:00-04:00,0,4,0,6,0,4068,33366,37434
2014-04-27 01:00:00-04:00,0,4,1,6,0,3945,31826,35771
2014-04-27 02:00:00-04:00,0,4,2,6,0,3510,28441,31951
2014-04-27 03:00:00-04:00,0,4,3,6,0,3125,24336,27461
2014-04-27 04:00:00-04:00,0,4,4,6,0,2504,18170,20674
2014-04-27 05:00:00-04:00,0,4,5,6,0,1870,11489,13359
2014-04-27 06:00:00-04:00,0,4,6,6,0,935,5330,6265
2014-04-27 07:00:00-04:00,0,4,7,6,0,577,5368,5945
2014-04-27 08:00:00-04:00,0,4,8,6,0,592,7925,8517
2014-04-27 09:00:00-04:00,0,4,9,6,0,760,10659,11419
2014-04-27 10:00:00-04:00,0,4,10,6,0,1054,15866,16920
2014-04-27 11:00:00-04:00,0,4,11,6,0,1336,20640,21976
2014-04-27 12:00:00-04:00,0,4,12,6,0,1563,24909,26472
2014-04-27 13:00:00-04:00,0,4,13,6,0,1661,26075,27736
2014-04-27 14:00:00-04:00,0,4,14,6,0,1829,25883,27712
2014-04-27 15:00:00-04:00,0,4,15,6,0,1993,25320,27313
2014-04-27 16:00:00-04:00,0,4,16,6,0,2232,23717,25949
2014-04-27 17:00:00-04:00,0,4,17,6,0,2333,20225,22558
2014-04-27 18:00:00-04:00,0,4,18,6,0,2490,22987,25477
2014-04-27 19:00:00-04:00,0,4,19,6,0,2606,25126,27732
2014-04-27 20:00:00-04:00,0,4,20,6,0,2586,23079,25665
2014-04-27 21:00:00-04:00,0,4,21,6,0,2514,21964,24478
2014-04-27 22:00:00-04:00,0,4,22,6,0,2367,20021,22388
2014-04-27 23:00:00-04:00,0,4,23,6,0,2145,18669,20814
2014-04-28 00:00:00-04:00,0,4,0,0,0,1865,15185,17050
2014-04-28 01:00:00-04:00,0,4,1,0,0,1391,10057,11448
2014-04-28 02:00:00-04:00,0,4,2,0,0,925,5971,6896
2014-04-28 03:00:00-04:00,0,4,3,0,0,625,3806,4431
2014-04-28 04:00:00-04:00,0,4,4,0,0,439,2570,3009
2014-04-28 05:00:00-04:00,0,4,5,0,0,478,2885,3363
2014-04-28 06:00:00-04:00,0,4,6,0,0,409,5085,5494
2014-04-28 07:00:00-04:00,0,4,7,0,0,592,12716,13308
2014-04-28 08:00:00-04:00,0,4,8,0,0,1348,21879,23227
2014-04-28 09:00:00-04:00,0,4,9,0,0,1935,25033,26968
2014-04-28 10:00:00-04:00,0,4,10,0,0,1876,23589,25465
2014-04-28 11:00:00-04:00,0,4,11,0,0,1570,20326,21896
2014-04-28 12:00:00-04:00,0,4,12,0,0,1501,20330,21831
2014-04-28 13:00:00-04:00,0,4,13,0,0,1411,20797,22208
2014-04-28 14:00:00-04:00,0,4,14,0,0,1416,20644,22060
2014-04-28 15:00:00-04:00,0,4,15,0,0,1699,22292,23991
2014-04-28 16:00:00-04:00,0,4,16,0,0,1866,22072,23938
2014-04-28 17:00:00-04:00,0,4,17,0,0,2003,19379,21382
2014-04-28 18:00:00-04:00,0,4,18,0,0,2153,24008,26161
2014-04-28 19:00:00-04:00,0,4,19,0,0,2398,29701,32099
2014-04-28 20:00:00-04:00,0,4,20,0,0,2250,28518,30768
2014-04-28 21:00:00-04:00,0,4,21,0,0,2052,27833,29885
2014-04-28 22:00:00-04:00,0,4,22,0,0,1813,26466,28279
2014-04-28 23:00:00-04:00,0,4,23,0,0,1543,22933,24476
2014-04-29 00:00:00-04:00,0,4,0,1,0,1131,17356,18487
2014-04-29 01:00:00-04:00,0,4,1,1,0,964,11088,12052
2014-04-29 02:00:00-04:00,0,4,2,1,0,735,6546,7281
2014-04-29 03:00:00-04:00,0,4,3,1,0,453,3980,4433
2014-04-29 04:00:00-04:00,0,4,4,1,0,388,2612,3000
2014-04-29 05:00:00-04:00,0,4,5,1,0,394,2626,3020
2014-04-29 06:00:00-04:00,0,4,6,1,0,309,4429,4738
2014-04-29 07:00:00-04:00,0,4,7,1,0,556,12770,13326
2014-04-29 08:00:00-04:00,0,4,8,1,0,1311,23640,24951
2014-04-29 09:00:00-04:00,0,4,9,1,0,1985,27929,29914
2014-04-29 10:00:00-04:00,0,4,10,1,0,2018,26296,28314
2014-04-29 11:00:00-04:00,0,4,11,1,0,1788,23334,25122
2014-04-29 12:00:00-04:00,0,4,12,1,0,1644,23180,24824
2014-04-29 13:00:00-04:00,0,4,13,1,0,1646,23452,25098
2014-04-29 14:00:00-04:00,0,4,14,1,0,1626,23017,24643
2014-04-29 15:00:00-04:00,0,4,15,1,0,1966,25669,27635
2014-04-29 16:00:00-04:00,0,4,16,1,0,2251,24109,26360
2014-04-29 17:00:00-04:00,0,4,17,1,0,2430,18722,21152
2014-04-29 18:00:00-04:00,0.01,4,18,1,0,2700,24274,26974
2014-04-29 19:00:00-04:00,0,4,19,1,0,3167,31128,34295
2014-04-29 20:00:00-04:00,0,4,20,1,0,2788,31606,34394
2014-04-29 21:00:00-04:00,0,4,21,1,0,2647,31908,34555
2014-04-29 22:00:00-04:00,0.02,4,22,1,0,2381,31095,33476
2014-04-29 23:00:00-04:00,0,4,23,1,0,2206,28479,30685
2014-04-30 00:00:00-04:00,0,4,0,2,0,1642,21258,22900
2014-04-30 01:00:00-04:00,0,4,1,2,0,1228,14153,15381
2014-04-30 02:00:00-04:00,0.1,4,2,2,0,826,8551,9377
2014-04-30 03:00:00-04:00,0.13,4,3,2,0,577,5317,5894
2014-04-30 04:00:00-04:00,0.13,4,4,2,0,432,3306,3738
2014-04-30 05:00:00-04:00,0.02,4,5,2,0,386,3178,3564
2014-04-30 06:00:00-04:00,0.04,4,6,2,0,320,5044,5364
2014-04-30 07:00:00-04:00,0.1,4,7,2,0,664,14961,15625
2014-04-30 08:00:00-04:00,0.07,4,8,2,0,1574,25898,27472
2014-04-30 09:00:00-04:00,0.03,4,9,2,0,2227,29038,31265
2014-04-30 10:00:00-04:00,0.06,4,10,2,0,2145,27633,29778
2014-04-30 11:00:00-04:00,0.17,4,11,2,0,1972,25282,27254
2014-04-30 12:00:00-04:00,0.18,4,12,2,0,1981,26209,28190
2014-04-30 13:00:00-04:00,0.27,4,13,2,0,2010,25645,27655
2014-04-30 14:00:00-04:00,0.22,4,14,2,0,1914,24503,26417
2014-04-30 15:00:00-04:00,0.05,4,15,2,0,2247,24370,26617
2014-04-30 16:00:00-04:00,0.22,4,16,2,0,2638,22245,24883
2014-04-30 17:00:00-04:00,0.36,4,17,2,0,2927,18092,21019
2014-04-30 18:00:00-04:00,0.41,4,18,2,0,3601,23576,27177
2014-04-30 19:00:00-04:00,0.46,4,19,2,0,3751,28877,32628
2014-04-30 20:00:00-04:00,0.35,4,20,2,0,3596,30618,34214
2014-04-30 21:00:00-04:00,0.42,4,21,2,0,3157,30022,33179
2014-04-30 22:00:00-04:00,0.65,4,22,2,0,2987,29918,32905
2014-04-30 23:00:00-04:00,0.5,4,23,2,0,2589,27583,30172
2014-05-01 00:00:00-04:00,0.3,5,0,3,0,2006,23550,25556
2014-05-01 01:00:00-04:00,0.08,5,1,3,0,1400,15629,17029
2014-05-01 02:00:00-04:00,0.06,5,2,3,0,819,9080,9899
2014-05-01 03:00:00-04:00,0.01,5,3,3,0,440,5267,5707
2014-05-01 04:00:00-04:00,0.01,5,4,3,0,374,3440,3814
2014-05-01 05:00:00-04:00,0,5,5,3,0,352,3177,3529
2014-05-01 06:00:00-04:00,0,5,6,3,0,302,4774,5076
2014-05-01 07:00:00-04:00,0,5,7,3,0,570,13623,14193
2014-05-01 08:00:00-04:00,0,5,8,3,0,1448,23653,25101
2014-05-01 09:00:00-04:00,0,5,9,3,0,2169,27237,29406
2014-05-01 10:00:00-04:00,0,5,10,3,0,2189,25563,27752
2014-05-01 11:00:00-04:00,0,5,11,3,0,1976,22853,24829
2014-05-01 12:00:00-04:00,0,5,12,3,0,1777,22383,24160
2014-05-01 13:00:00-04:00,0,5,13,3,0,1804,23281,25085
2014-05-01 14:00:00-04:00,0,5,14,3,0,1792,22383,24175
2014-05-01 15:00:00-04:00,0,5,15,3,0,2003,23834,25837
2014-05-01 16:00:00-04:00,0,5,16,3,0,2265,22432,24697
2014-05-01 17:00:00-04:00,0,5,17,3,0,2565,17656,20221
2014-05-01 18:00:00-04:00,0,5,18,3,0,2747,22311,25058
2014-05-01 19:00:00-04:00,0,5,19,3,0,3044,29335,32379
2014-05-01 20:00:00-04:00,0,5,20,3,0,2914,31208,34122
2014-05-01 21:00:00-04:00,0,5,21,3,0,2814,31233,34047
2014-05-01 22:00:00-04:00,0.01,5,22,3,0,2705,31756,34461
2014-05-01 23:00:00-04:00,0,5,23,3,0,3204,32154,35358
2014-05-02 00:00:00-04:00,0,5,0,4,0,2508,28429,30937
2014-05-02 01:00:00-04:00,0,5,1,4,0,1985,22681,24666
2014-05-02 02:00:00-04:00,0,5,2,4,0,1464,14902,16366
2014-05-02 03:00:00-04:00,0,5,3,4,0,998,9882,10880
2014-05-02 04:00:00-04:00,0,5,4,4,0,738,6839,7577
2014-05-02 05:00:00-04:00,0,5,5,4,0,579,5162,5741
2014-05-02 06:00:00-04:00,0,5,6,4,0,436,5467,5903
2014-05-02 07:00:00-04:00,0,5,7,4,0,646,13003,13649
2014-05-02 08:00:00-04:00,0,5,8,4,0,1452,23022,24474
2014-05-02 09:00:00-04:00,0,5,9,4,0,2198,26768,28966
2014-05-02 10:00:00-04:00,0,5,10,4,0,2099,25507,27606
2014-05-02 11:00:00-04:00,0,5,11,4,0,2021,23667,25688
2014-05-02 12:00:00-04:00,0,5,12,4,0,1980,24214,26194
2014-05-02 13:00:00-04:00,0,5,13,4,0,1897,24032,25929
2014-05-02 14:00:00-04:00,0,5,14,4,0,1948,22096,24044
2014-05-02 15:00:00-04:00,0,5,15,4,0,2284,23570,25854
2014-05-02 16:00:00-04:00,0,5,16,4,0,2715,21248,23963
2014-05-02 17:00:00-04:00,0,5,17,4,0,3097,16706,19803
2014-05-02 18:00:00-04:00,0,5,18,4,0,3379,20288,23667
2014-05-02 19:00:00-04:00,0,5,19,4,0,3850,27755,31605
2014-05-02 20:00:00-04:00,0,5,20,4,0,3846,31902,35748
2014-05-02 21:00:00-04:00,0,5,21,4,0,3626,32385,36011
2014-05-02 22:00:00-04:00,0,5,22,4,0,3617,31557,35174
2014-05-02 23:00:00-04:00,0,5,23,4,0,3887,32375,36262
2014-05-03 00:00:00-04:00,0,5,0,5,0,3781,31957,35738
2014-05-03 01:00:00-04:00,0,5,1,5,0,3631,29465,33096
2014-05-03 02:00:00-04:00,0,5,2,5,0,3276,25492,28768
2014-05-03 03:00:00-04:00,0,5,3,5,0,2600,20883,23483
2014-05-03 04:00:00-04:00,0,5,4,5,0,2096,15449,17545
2014-05-03 05:00:00-04:00,0,5,5,5,0,1621,9988,11609
2014-05-03 06:00:00-04:00,0,5,6,5,0,832,5381,6213
2014-05-03 07:00:00-04:00,0,5,7,5,0,675,5889,6564
2014-05-03 08:00:00-04:00,0,5,8,5,0,809,9277,10086
2014-05-03 09:00:00-04:00,0,5,9,5,0,1138,14158,15296
2014-05-03 10:00:00-04:00,0,5,10,5,0,1519,18735,20254
2014-05-03 11:00:00-04:00,0,5,11,5,0,1716,21781,23497
2014-05-03 12:00:00-04:00,0,5,12,5,0,1904,24395,26299
2014-05-03 13:00:00-04:00,0,5,13,5,0,1951,26176,28127
2014-05-03 14:00:00-04:00,0,5,14,5,0,2179,26564,28743
2014-05-03 15:00:00-04:00,0,5,15,5,0,2413,26789,29202
2014-05-03 16:00:00-04:00,0,5,16,5,0,2809,26073,28882
2014-05-03 17:00:00-04:00,0,5,17,5,0,3125,21005,24130
2014-05-03 18:00:00-04:00,0,5,18,5,0,3462,24526,27988
2014-05-03 19:00:00-04:00,0.02,5,19,5,0,3659,29826,33485
2014-05-03 20:00:00-04:00,0.01,5,20,5,0,4302,34120,38422
2014-05-03 21:00:00-04:00,0,5,21,5,0,4204,31213,35417
2014-05-03 22:00:00-04:00,0,5,22,5,0,3952,30373,34325
2014-05-03 23:00:00-04:00,0,5,23,5,0,4317,33030,37347
2014-05-04 00:00:00-04:00,0,5,0,6,0,4043,33475,37518
2014-05-04 01:00:00-04:00,0,5,1,6,0,3763,30934,34697
2014-05-04 02:00:00-04:00,0,5,2,6,0,3728,29148,32876
2014-05-04 03:00:00-04:00,0,5,3,6,0,3170,23575,26745
2014-05-04 04:00:00-04:00,0,5,4,6,0,2537,17336,19873
2014-05-04 05:00:00-04:00,0,5,5,6,0,1939,11120,13059
2014-05-04 06:00:00-04:00,0,5,6,6,0,962,5522,6484
2014-05-04 07:00:00-04:00,0,5,7,6,0,607,5221,5828
2014-05-04 08:00:00-04:00,0,5,8,6,0,630,7117,7747
2014-05-04 09:00:00-04:00,0,5,9,6,0,765,10489,11254
2014-05-04 10:00:00-04:00,0,5,10,6,0,1056,14559,15615
2014-05-04 11:00:00-04:00,0,5,11,6,0,1231,19886,21117
2014-05-04 12:00:00-04:00,0,5,12,6,0,1444,22976,24420
2014-05-04 13:00:00-04:00,0,5,13,6,0,1661,25659,27320
2014-05-04 14:00:00-04:00,0,5,14,6,0,1821,26350,28171
2014-05-04 15:00:00-04:00,0,5,15,6,0,2024,25356,27380
2014-05-04 16:00:00-04:00,0,5,16,6,0,2216,23390,25606
2014-05-04 17:00:00-04:00,0,5,17,6,0,2451,22318,24769
2014-05-04 18:00:00-04:00,0,5,18,6,0,2549,24019,26568
2014-05-04 19:00:00-04:00,0,5,19,6,0,2446,25100,27546
2014-05-04 20:00:00-04:00,0,5,20,6,0,2510,24573,27083
2014-05-04 21:00:00-04:00,0,5,21,6,0,2424,23155,25579
2014-05-04 22:00:00-04:00,0,5,22,6,0,2277,21548,23825
2014-05-04 23:00:00-04:00,0,5,23,6,0,2135,20509,22644
2014-05-05 00:00:00-04:00,0,5,0,0,0,1811,15929,17740
2014-05-05 01:00:00-04:00,0,5,1,0,0,1383,10488,11871
2014-05-05 02:00:00-04:00,0,5,2,0,0,881,6121,7002
2014-05-05 03:00:00-04:00,0,5,3,0,0,602,3836,4438
2014-05-05 04:00:00-04:00,0,5,4,0,0,461,2572,3033
2014-05-05 05:00:00-04:00,0,5,5,0,0,477,2890,3367
2014-05-05 06:00:00-04:00,0,5,6,0,0,393,5107,5500
2014-05-05 07:00:00-04:00,0,5,7,0,0,617,12708,13325
2014-05-05 08:00:00-04:00,0,5,8,0,0,1350,21946,23296
2014-05-05 09:00:00-04:00,0,5,9,0,0,1940,25085,27025
2014-05-05 10:00:00-04:00,0,5,10,0,0,1868,23981,25849
2014-05-05 11:00:00-04:00,0,5,11,0,0,1659,21521,23180
2014-05-05 12:00:00-04:00,0,5,12,0,0,1572,21925,23497
2014-05-05 13:00:00-04:00,0,5,13,0,0,1530,22402,23932
2014-05-05 14:00:00-04:00,0,5,14,0,0,1511,21625,23136
2014-05-05 15:00:00-04:00,0,5,15,0,0,1695,23496,25191
2014-05-05 16:00:00-04:00,0,5,16,0,0,1936,22620,24556
2014-05-05 17:00:00-04:00,0,5,17,0,0,2088,19766,21854
2014-05-05 18:00:00-04:00,0,5,18,0,0,2209,24436,26645
2014-05-05 19:00:00-04:00,0,5,19,0,0,2507,30452,32959
2014-05-05 20:00:00-04:00,0,5,20,0,0,2422,30914,33336
2014-05-05 21:00:00-04:00,0,5,21,0,0,2223,29363,31586
2014-05-05 22:00:00-04:00,0,5,22,0,0,2038,28926,30964
2014-05-05 23:00:00-04:00,0,5,23,0,0,1866,27097,28963
2014-05-06 00:00:00-04:00,0,5,0,1,0,1617,22065,23682
2014-05-06 01:00:00-04:00,0,5,1,1,0,1276,14653,15929
2014-05-06 02:00:00-04:00,0,5,2,1,0,848,9018,9866
2014-05-06 03:00:00-04:00,0,5,3,1,0,588,5767,6355
2014-05-06 04:00:00-04:00,0,5,4,1,0,457,3913,4370
2014-05-06 05:00:00-04:00,0,5,5,1,0,439,3396,3835
2014-05-06 06:00:00-04:00,0,5,6,1,0,366,4774,5140
2014-05-06 07:00:00-04:00,0,5,7,1,0,599,12600,13199
2014-05-06 08:00:00-04:00,0,5,8,1,0,1392,23129,24521
2014-05-06 09:00:00-04:00,0,5,9,1,0,2015,26921,28936
2014-05-06 10:00:00-04:00,0,5,10,1,0,1954,25507,27461
2014-05-06 11:00:00-04:00,0,5,11,1,0,1709,23076,24785
2014-05-06 12:00:00-04:00,0,5,12,1,0,1596,22741,24337
2014-05-06 13:00:00-04:00,0,5,13,1,0,1494,23320,24814
2014-05-06 14:00:00-04:00,0,5,14,1,0,1582,22526,24108
2014-05-06 15:00:00-04:00,0,5,15,1,0,1820,23893,25713
2014-05-06 16:00:00-04:00,0,5,16,1,0,2024,22911,24935
2014-05-06 17:00:00-04:00,0,5,17,1,0,2114,18791,20905
2014-05-06 18:00:00-04:00,0,5,18,1,0,2335,24200,26535
2014-05-06 19:00:00-04:00,0,5,19,1,0,2489,30496,32985
2014-05-06 20:00:00-04:00,0,5,20,1,0,2553,31161,33714
2014-05-06 21:00:00-04:00,0,5,21,1,0,2320,29981,32301
2014-05-06 22:00:00-04:00,0,5,22,1,0,2169,30009,32178
2014-05-06 23:00:00-04:00,0,5,23,1,0,2019,28096,30115
2014-05-07 00:00:00-04:00,0,5,0,2,0,1691,22366,24057
2014-05-07 01:00:00-04:00,0,5,1,2,0,1317,14302,15619
2014-05-07 02:00:00-04:00,0,5,2,2,0,811,8072,8883
2014-05-07 03:00:00-04:00,0,5,3,2,0,494,4950,5444
2014-05-07 04:00:00-04:00,0,5,4,2,0,397,3132,3529
2014-05-07 05:00:00-04:00,0,5,5,2,0,375,3005,3380
2014-05-07 06:00:00-04:00,0,5,6,2,0,348,4676,5024
2014-05-07 07:00:00-04:00,0,5,7,2,0,616,13088,13704
2014-05-07 08:00:00-04:00,0,5,8,2,0,1362,23941,25303
2014-05-07 09:00:00-04:00,0,5,9,2,0,1993,27162,29155
2014-05-07 10:00:00-04:00,0,5,10,2,0,1938,25686,27624
2014-05-07 11:00:00-04:00,0,5,11,2,0,1736,23364,25100
2014-05-07 12:00:00-04:00,0,5,12,2,0,1647,23416,25063
2014-05-07 13:00:00-04:00,0,5,13,2,0,1636,23640,25276
2014-05-07 14:00:00-04:00,0,5,14,2,0,1603,22929,24532
2014-05-07 15:00:00-04:00,0,5,15,2,0,1880,23947,25827
2014-05-07 16:00:00-04:00,0,5,16,2,0,2077,22251,24328
2014-05-07 17:00:00-04:00,0,5,17,2,0,2226,17700,19926
2014-05-07 18:00:00-04:00,0,5,18,2,0,2694,22842,25536
2014-05-07 19:00:00-04:00,0,5,19,2,0,2950,29436,32386
2014-05-07 20:00:00-04:00,0,5,20,2,0,2810,31771,34581
2014-05-07 21:00:00-04:00,0,5,21,2,0,2510,31066,33576
2014-05-07 22:00:00-04:00,0,5,22,2,0,2313,30804,33117
2014-05-07 23:00:00-04:00,0,5,23,2,0,2076,28754,30830
2014-05-08 00:00:00-04:00,0,5,0,3,0,1809,24618,26427
2014-05-08 01:00:00-04:00,0,5,1,3,0,1424,16054,17478
2014-05-08 02:00:00-04:00,0.02,5,2,3,0,964,9747,10711
2014-05-08 03:00:00-04:00,0.06,5,3,3,0,608,6327,6935
2014-05-08 04:00:00-04:00,0.1,5,4,3,0,467,4267,4734
2014-05-08 05:00:00-04:00,0.08,5,5,3,0,425,3714,4139
2014-05-08 06:00:00-04:00,0.04,5,6,3,0,358,5327,5685
2014-05-08 07:00:00-04:00,0.02,5,7,3,0,634,14682,15316
2014-05-08 08:00:00-04:00,0.04,5,8,3,0,1469,24754,26223
2014-05-08 09:00:00-04:00,0.02,5,9,3,0,2325,27825,30150
2014-05-08 10:00:00-04:00,0.01,5,10,3,0,2256,27012,29268
2014-05-08 11:00:00-04:00,0,5,11,3,0,1901,24405,26306
2014-05-08 12:00:00-04:00,0,5,12,3,0,1720,23139,24859
2014-05-08 13:00:00-04:00,0,5,13,3,0,1793,23741,25534
2014-05-08 14:00:00-04:00,0,5,14,3,0,1818,23136,24954
2014-05-08 15:00:00-04:00,0,5,15,3,0,2105,24118,26223
2014-05-08 16:00:00-04:00,0,5,16,3,0,2332,22487,24819
2014-05-08 17:00:00-04:00,0,5,17,3,0,2472,17594,20066
2014-05-08 18:00:00-04:00,0,5,18,3,0,2799,23340,26139
2014-05-08 19:00:00-04:00,0,5,19,3,0,3078,30280,33358
2014-05-08 20:00:00-04:00,0,5,20,3,0,3004,32661,35665
2014-05-08 21:00:00-04:00,0,5,21,3,0,2702,31902,34604
2014-05-08 22:00:00-04:00,0,5,22,3,0,2558,31842,34400
2014-05-08 23:00:00-04:00,0,5,23,3,0,2483,31225,33708
2014-05-09 00:00:00-04:00,0,5,0,4,0,2198,28525,30723
2014-05-09 01:00:00-04:00,0,5,1,4,0,1831,21584,23415
2014-05-09 02:00:00-04:00,0,5,2,4,0,1192,13675,14867
2014-05-09 03:00:00-04:00,0.02,5,3,4,0,815,9695,10510
2014-05-09 04:00:00-04:00,0,5,4,4,0,565,6327,6892
2014-05-09 05:00:00-04:00,0,5,5,4,0,505,4671,5176
2014-05-09 06:00:00-04:00,0,5,6,4,0,412,5359,5771
2014-05-09 07:00:00-04:00,0,5,7,4,0,619,12799,13418
2014-05-09 08:00:00-04:00,0,5,8,4,0,1407,23162,24569
2014-05-09 09:00:00-04:00,0,5,9,4,0,2138,27203,29341
2014-05-09 10:00:00-04:00,0,5,10,4,0,2064,25930,27994
2014-05-09 11:00:00-04:00,0,5,11,4,0,1936,23865,25801
2014-05-09 12:00:00-04:00,0,5,12,4,0,1853,24513,26366
2014-05-09 13:00:00-04:00,0,5,13,4,0,1694,24893,26587
2014-05-09 14:00:00-04:00,0,5,14,4,0,1747,23201,24948
2014-05-09 15:00:00-04:00,0,5,15,4,0,2038,25002,27040
2014-05-09 16:00:00-04:00,0,5,16,4,0,2398,21900,24298
2014-05-09 17:00:00-04:00,0,5,17,4,0,2806,17146,19952
2014-05-09 18:00:00-04:00,0,5,18,4,0,3226,23484,26710
2014-05-09 19:00:00-04:00,0,5,19,4,0,3769,31103,34872
2014-05-09 20:00:00-04:00,0,5,20,4,0,3927,33627,37554
2014-05-09 21:00:00-04:00,0,5,21,4,0,3602,31211,34813
2014-05-09 22:00:00-04:00,0,5,22,4,0,3482,31047,34529
2014-05-09 23:00:00-04:00,0,5,23,4,0,3545,31190,34735
2014-05-10 00:00:00-04:00,0,5,0,5,0,3571,31349,34920
2014-05-10 01:00:00-04:00,0,5,1,5,0,3331,29510,32841
2014-05-10 02:00:00-04:00,0,5,2,5,0,3081,25523,28604
2014-05-10 03:00:00-04:00,0,5,3,5,0,2563,20702,23265
2014-05-10 04:00:00-04:00,0,5,4,5,0,1963,15657,17620
2014-05-10 05:00:00-04:00,0,5,5,5,0,1495,10097,11592
2014-05-10 06:00:00-04:00,0,5,6,5,0,692,5127,5819
2014-05-10 07:00:00-04:00,0,5,7,5,0,604,5899,6503
2014-05-10 08:00:00-04:00,0,5,8,5,0,680,8339,9019
2014-05-10 09:00:00-04:00,0,5,9,5,0,1023,12982,14005
2014-05-10 10:00:00-04:00,0,5,10,5,0,1301,18625,19926
2014-05-10 11:00:00-04:00,0,5,11,5,0,1545,22561,24106
2014-05-10 12:00:00-04:00,0,5,12,5,0,1707,25493,27200
2014-05-10 13:00:00-04:00,0,5,13,5,0,1961,26817,28778
2014-05-10 14:00:00-04:00,0,5,14,5,0,2062,27383,29445
2014-05-10 15:00:00-04:00,0,5,15,5,0,2577,29198,31775
2014-05-10 16:00:00-04:00,0,5,16,5,0,2748,25276,28024
2014-05-10 17:00:00-04:00,0.88,5,17,5,0,3013,20347,23360
2014-05-10 18:00:00-04:00,0,5,18,5,0,3528,23252,26780
2014-05-10 19:00:00-04:00,0,5,19,5,0,3580,29197,32777
2014-05-10 20:00:00-04:00,0,5,20,5,0,3656,30797,34453
2014-05-10 21:00:00-04:00,0,5,21,5,0,3704,27954,31658
2014-05-10 22:00:00-04:00,0,5,22,5,0,3817,26051,29868
2014-05-10 23:00:00-04:00,0,5,23,5,0,3933,28693,32626
2014-05-11 00:00:00-04:00,0.02,5,0,6,0,4122,32057,36179
2014-05-11 01:00:00-04:00,0.02,5,1,6,0,4110,30917,35027
2014-05-11 02:00:00-04:00,0,5,2,6,0,3571,25561,29132
2014-05-11 03:00:00-04:00,0.01,5,3,6,0,2849,21455,24304
2014-05-11 04:00:00-04:00,0,5,4,6,0,2336,15704,18040
2014-05-11 05:00:00-04:00,0,5,5,6,0,1751,10293,12044
2014-05-11 06:00:00-04:00,0,5,6,6,0,872,5007,5879
2014-05-11 07:00:00-04:00,0,5,7,6,0,545,4814,5359
2014-05-11 08:00:00-04:00,0,5,8,6,0,584,6951,7535
2014-05-11 09:00:00-04:00,0,5,9,6,0,749,10152,10901
2014-05-11 10:00:00-04:00,0,5,10,6,0,1078,15504,16582
2014-05-11 11:00:00-04:00,0,5,11,6,0,1475,20900,22375
2014-05-11 12:00:00-04:00,0,5,12,6,0,1669,23993,25662
2014-05-11 13:00:00-04:00,0,5,13,6,0,1863,25333,27196
2014-05-11 14:00:00-04:00,0,5,14,6,0,1935,24487,26422
2014-05-11 15:00:00-04:00,0,5,15,6,0,2314,24545,26859
2014-05-11 16:00:00-04:00,0,5,16,6,0,2549,22316,24865
2014-05-11 17:00:00-04:00,0,5,17,6,0,2736,19854,22590
2014-05-11 18:00:00-04:00,0,5,18,6,0,2739,21334,24073
2014-05-11 19:00:00-04:00,0,5,19,6,0,2869,23940,26809
2014-05-11 20:00:00-04:00,0,5,20,6,0,2927,22680,25607
2014-05-11 21:00:00-04:00,0,5,21,6,0,2738,22024,24762
2014-05-11 22:00:00-04:00,0,5,22,6,0,2707,20951,23658
2014-05-11 23:00:00-04:00,0,5,23,6,0,2510,19549,22059
2014-05-12 00:00:00-04:00,0,5,0,0,0,2124,15856,17980
2014-05-12 01:00:00-04:00,0,5,1,0,0,1602,10127,11729
2014-05-12 02:00:00-04:00,0,5,2,0,0,1017,6196,7213
2014-05-12 03:00:00-04:00,0,5,3,0,0,690,4181,4871
2014-05-12 04:00:00-04:00,0,5,4,0,0,471,2772,3243
2014-05-12 05:00:00-04:00,0,5,5,0,0,473,3036,3509
2014-05-12 06:00:00-04:00,0,5,6,0,0,431,5044,5475
2014-05-12 07:00:00-04:00,0,5,7,0,0,635,12553,13188
2014-05-12 08:00:00-04:00,0,5,8,0,0,1277,20997,22274
2014-05-12 09:00:00-04:00,0,5,9,0,0,1829,24301,26130
2014-05-12 10:00:00-04:00,0,5,10,0,0,1759,23133,24892
2014-05-12 11:00:00-04:00,0,5,11,0,0,1570,21334,22904
2014-05-12 12:00:00-04:00,0,5,12,0,0,1558,21245,22803
2014-05-12 13:00:00-04:00,0,5,13,0,0,1523,21968,23491
2014-05-12 14:00:00-04:00,0,5,14,0,0,1525,21854,23379
2014-05-12 15:00:00-04:00,0,5,15,0,0,1783,23554,25337
2014-05-12 16:00:00-04:00,0,5,16,0,0,1946,22874,24820
2014-05-12 17:00:00-04:00,0,5,17,0,0,2159,19537,21696
2014-05-12 18:00:00-04:00,0,5,18,0,0,2408,24474,26882
2014-05-12 19:00:00-04:00,0,5,19,0,0,2555,28406,30961
2014-05-12 20:00:00-04:00,0,5,20,0,0,2343,27848,30191
2014-05-12 21:00:00-04:00,0,5,21,0,0,1910,26092,28002
2014-05-12 22:00:00-04:00,0,5,22,0,0,1788,25227,27015
2014-05-12 23:00:00-04:00,0,5,23,0,0,1737,23014,24751
2014-05-13 00:00:00-04:00,0,5,0,1,0,1450,17725,19175
2014-05-13 01:00:00-04:00,0,5,1,1,0,1156,11926,13082
2014-05-13 02:00:00-04:00,0,5,2,1,0,741,7097,7838
2014-05-13 03:00:00-04:00,0,5,3,1,0,492,4582,5074
2014-05-13 04:00:00-04:00,0,5,4,1,0,357,3048,3405
2014-05-13 05:00:00-04:00,0,5,5,1,0,354,2874,3228
2014-05-13 06:00:00-04:00,0,5,6,1,0,305,4584,4889
2014-05-13 07:00:00-04:00,0,5,7,1,0,588,12610,13198
2014-05-13 08:00:00-04:00,0,5,8,1,0,1385,23016,24401
2014-05-13 09:00:00-04:00,0,5,9,1,0,1966,26500,28466
2014-05-13 10:00:00-04:00,0,5,10,1,0,1911,24793,26704
2014-05-13 11:00:00-04:00,0,5,11,1,0,1652,22346,23998
2014-05-13 12:00:00-04:00,0,5,12,1,0,1611,22172,23783
2014-05-13 13:00:00-04:00,0,5,13,1,0,1610,22405,24015
2014-05-13 14:00:00-04:00,0,5,14,1,0,1604,22002,23606
2014-05-13 15:00:00-04:00,0,5,15,1,0,1875,23784,25659
2014-05-13 16:00:00-04:00,0,5,16,1,0,1983,22151,24134
2014-05-13 17:00:00-04:00,0,5,17,1,0,2077,17934,20011
2014-05-13 18:00:00-04:00,0,5,18,1,0,2316,23108,25424
2014-05-13 19:00:00-04:00,0,5,19,1,0,2622,29165,31787
2014-05-13 20:00:00-04:00,0,5,20,1,0,2595,31272,33867
2014-05-13 21:00:00-04:00,0,5,21,1,0,2416,31042,33458
2014-05-13 22:00:00-04:00,0,5,22,1,0,2300,31101,33401
2014-05-13 23:00:00-04:00,0,5,23,1,0,2237,29380,31617
2014-05-14 00:00:00-04:00,0,5,0,2,0,1860,24152,26012
2014-05-14 01:00:00-04:00,0,5,1,2,0,1509,16020,17529
2014-05-14 02:00:00-04:00,0,5,2,2,0,917,8869,9786
2014-05-14 03:00:00-04:00,0,5,3,2,0,596,5345,5941
2014-05-14 04:00:00-04:00,0,5,4,2,0,431,3505,3936
2014-05-14 05:00:00-04:00,0,5,5,2,0,413,3228,3641
2014-05-14 06:00:00-04:00,0,5,6,2,0,335,4682,5017
2014-05-14 07:00:00-04:00,0,5,7,2,0,630,12739,13369
2014-05-14 08:00:00-04:00,0,5,8,2,0,1308,23888,25196
2014-05-14 09:00:00-04:00,0,5,9,2,0,2019,27411,29430
2014-05-14 10:00:00-04:00,0,5,10,2,0,1978,25549,27527
2014-05-14 11:00:00-04:00,0,5,11,2,0,1769,22775,24544
2014-05-14 12:00:00-04:00,0,5,12,2,0,1648,23057,24705
2014-05-14 13:00:00-04:00,0,5,13,2,0,1638,22965,24603
2014-05-14 14:00:00-04:00,0,5,14,2,0,1678,22294,23972
2014-05-14 15:00:00-04:00,0,5,15,2,0,1943,23023,24966
2014-05-14 16:00:00-04:00,0,5,16,2,0,2182,20907,23089
2014-05-14 17:00:00-04:00,0,5,17,2,0,2243,15575,17818
2014-05-14 18:00:00-04:00,0,5,18,2,0,2652,19010,21662
2014-05-14 19:00:00-04:00,0,5,19,2,0,2944,24376,27320
2014-05-14 20:00:00-04:00,0,5,20,2,0,2951,29777,32728
2014-05-14 21:00:00-04:00,0,5,21,2,0,2558,29191,31749
2014-05-14 22:00:00-04:00,0,5,22,2,0,2531,30421,32952
2014-05-14 23:00:00-04:00,0,5,23,2,0,2211,28643,30854
2014-05-15 00:00:00-04:00,0,5,0,3,0,1871,23416,25287
2014-05-15 01:00:00-04:00,0.02,5,1,3,0,1497,16557,18054
2014-05-15 02:00:00-04:00,0.03,5,2,3,0,1056,10296,11352
2014-05-15 03:00:00-04:00,0,5,3,3,0,679,6621,7300
2014-05-15 04:00:00-04:00,0,5,4,3,0,449,4111,4560
2014-05-15 05:00:00-04:00,0.01,5,5,3,0,400,3648,4048
2014-05-15 06:00:00-04:00,0,5,6,3,0,353,5227,5580
2014-05-15 07:00:00-04:00,0.08,5,7,3,0,618,13984,14602
2014-05-15 08:00:00-04:00,0,5,8,3,0,1470,23810,25280
2014-05-15 09:00:00-04:00,0,5,9,3,0,2146,25756,27902
2014-05-15 10:00:00-04:00,0,5,10,3,0,2052,24254,26306
2014-05-15 11:00:00-04:00,0,5,11,3,0,1771,22683,24454
2014-05-15 12:00:00-04:00,0,5,12,3,0,1790,24336,26126
2014-05-15 13:00:00-04:00,0,5,13,3,0,1805,23796,25601
2014-05-15 14:00:00-04:00,0,5,14,3,0,1770,22494,24264
2014-05-15 15:00:00-04:00,0,5,15,3,0,2001,23548,25549
2014-05-15 16:00:00-04:00,0,5,16,3,0,2281,21737,24018
2014-05-15 17:00:00-04:00,0,5,17,3,0,2439,17219,19658
2014-05-15 18:00:00-04:00,0,5,18,3,0,2913,21860,24773
2014-05-15 19:00:00-04:00,0,5,19,3,0,3065,29378,32443
2014-05-15 20:00:00-04:00,0,5,20,3,0,2953,32528,35481
2014-05-15 21:00:00-04:00,0,5,21,3,0,2695,31494,34189
2014-05-15 22:00:00-04:00,0,5,22,3,0,2597,31414,34011
2014-05-15 23:00:00-04:00,0,5,23,3,0,2591,30426,33017
2014-05-16 00:00:00-04:00,0,5,0,4,0,2271,27826,30097
2014-05-16 01:00:00-04:00,0,5,1,4,0,1978,21903,23881
2014-05-16 02:00:00-04:00,0,5,2,4,0,1437,15476,16913
2014-05-16 03:00:00-04:00,0.02,5,3,4,0,956,10041,10997
2014-05-16 04:00:00-04:00,0.01,5,4,4,0,687,6462,7149
2014-05-16 05:00:00-04:00,0,5,5,4,0,525,5129,5654
2014-05-16 06:00:00-04:00,0,5,6,4,0,406,5535,5941
2014-05-16 07:00:00-04:00,0,5,7,4,0,648,12756,13404
2014-05-16 08:00:00-04:00,0,5,8,4,0,1450,22468,23918
2014-05-16 09:00:00-04:00,0,5,9,4,0,2253,26123,28376
2014-05-16 10:00:00-04:00,0,5,10,4,0,2324,25623,27947
2014-05-16 11:00:00-04:00,0,5,11,4,0,1940,23886,25826
2014-05-16 12:00:00-04:00,0,5,12,4,0,1847,23800,25647
2014-05-16 13:00:00-04:00,0,5,13,4,0,1694,24055,25749
2014-05-16 14:00:00-04:00,0.01,5,14,4,0,1724,23308,25032
2014-05-16 15:00:00-04:00,0.01,5,15,4,0,2160,24586,26746
2014-05-16 16:00:00-04:00,0,5,16,4,0,2470,20666,23136
2014-05-16 17:00:00-04:00,0.02,5,17,4,0,2782,15561,18343
2014-05-16 18:00:00-04:00,0,5,18,4,0,3132,20754,23886
2014-05-16 19:00:00-04:00,0,5,19,4,0,3401,28713,32114
2014-05-16 20:00:00-04:00,0.12,5,20,4,0,3795,32191,35986
2014-05-16 21:00:00-04:00,0.22,5,21,4,0,4259,33691,37950
2014-05-16 22:00:00-04:00,1.11,5,22,4,0,4211,32146,36357
2014-05-16 23:00:00-04:00,0.09,5,23,4,0,4171,32177,36348
2014-05-17 00:00:00-04:00,0,5,0,5,0,3435,28784,32219
2014-05-17 01:00:00-04:00,0,5,1,5,0,3092,26835,29927
2014-05-17 02:00:00-04:00,0,5,2,5,0,2674,22401,25075
2014-05-17 03:00:00-04:00,0,5,3,5,0,2145,17317,19462
2014-05-17 04:00:00-04:00,0,5,4,5,0,1672,12671,14343
2014-05-17 05:00:00-04:00,0,5,5,5,0,1277,8683,9960
2014-05-17 06:00:00-04:00,0,5,6,5,0,776,5787,6563
2014-05-17 07:00:00-04:00,0,5,7,5,0,650,7193,7843
2014-05-17 08:00:00-04:00,0,5,8,5,0,690,8760,9450
2014-05-17 09:00:00-04:00,0,5,9,5,0,1047,13560,14607
2014-05-17 10:00:00-04:00,0,5,10,5,0,1349,19093,20442
2014-05-17 11:00:00-04:00,0,5,11,5,0,1548,21973,23521
2014-05-17 12:00:00-04:00,0,5,12,5,0,1725,24012,25737
2014-05-17 13:00:00-04:00,0,5,13,5,0,2008,25196,27204
2014-05-17 14:00:00-04:00,0,5,14,5,0,2223,25152,27375
2014-05-17 15:00:00-04:00,0,5,15,5,0,2385,24638,27023
2014-05-17 16:00:00-04:00,0,5,16,5,0,2650,22875,25525
2014-05-17 17:00:00-04:00,0,5,17,5,0,3029,18605,21634
2014-05-17 18:00:00-04:00,0,5,18,5,0,3105,22262,25367
2014-05-17 19:00:00-04:00,0,5,19,5,0,3515,27811,31326
2014-05-17 20:00:00-04:00,0,5,20,5,0,3695,29738,33433
2014-05-17 21:00:00-04:00,0,5,21,5,0,3746,29399,33145
2014-05-17 22:00:00-04:00,0,5,22,5,0,4035,30075,34110
2014-05-17 23:00:00-04:00,0,5,23,5,0,4236,31096,35332
2014-05-18 00:00:00-04:00,0,5,0,6,0,4213,31699,35912
2014-05-18 01:00:00-04:00,0,5,1,6,0,4059,30181,34240
2014-05-18 02:00:00-04:00,0,5,2,6,0,3742,27559,31301
2014-05-18 03:00:00-04:00,0,5,3,6,0,3277,24250,27527
2014-05-18 04:00:00-04:00,0,5,4,6,0,2718,18845,21563
2014-05-18 05:00:00-04:00,0,5,5,6,0,2023,12296,14319
2014-05-18 06:00:00-04:00,0,5,6,6,0,1026,6133,7159
2014-05-18 07:00:00-04:00,0,5,7,6,0,614,5333,5947
2014-05-18 08:00:00-04:00,0,5,8,6,0,570,7104,7674
2014-05-18 09:00:00-04:00,0,5,9,6,0,688,11123,11811
2014-05-18 10:00:00-04:00,0,5,10,6,0,967,15958,16925
2014-05-18 11:00:00-04:00,0,5,11,6,0,1284,20031,21315
2014-05-18 12:00:00-04:00,0,5,12,6,0,1504,23021,24525
2014-05-18 13:00:00-04:00,0,5,13,6,0,1647,24261,25908
2014-05-18 14:00:00-04:00,0,5,14,6,0,1868,24821,26689
2014-05-18 15:00:00-04:00,0,5,15,6,0,2178,24821,26999
2014-05-18 16:00:00-04:00,0,5,16,6,0,2331,23148,25479
2014-05-18 17:00:00-04:00,0,5,17,6,0,2468,20379,22847
2014-05-18 18:00:00-04:00,0,5,18,6,0,2490,22531,25021
2014-05-18 19:00:00-04:00,0,5,19,6,0,2595,24519,27114
2014-05-18 20:00:00-04:00,0,5,20,6,0,2556,23957,26513
2014-05-18 21:00:00-04:00,0,5,21,6,0,2410,22964,25374
2014-05-18 22:00:00-04:00,0,5,22,6,0,2430,22399,24829
2014-05-18 23:00:00-04:00,0,5,23,6,0,2249,21362,23611
2014-05-19 00:00:00-04:00,0,5,0,0,0,1941,16936,18877
2014-05-19 01:00:00-04:00,0,5,1,0,0,1502,10832,12334
2014-05-19 02:00:00-04:00,0,5,2,0,0,957,6499,7456
2014-05-19 03:00:00-04:00,0,5,3,0,0,648,4259,4907
2014-05-19 04:00:00-04:00,0,5,4,0,0,560,2723,3283
2014-05-19 05:00:00-04:00,0,5,5,0,0,529,2982,3511
2014-05-19 06:00:00-04:00,0,5,6,0,0,402,5224,5626
2014-05-19 07:00:00-04:00,0,5,7,0,0,604,12498,13102
2014-05-19 08:00:00-04:00,0,5,8,0,0,1307,21334,22641
2014-05-19 09:00:00-04:00,0,5,9,0,0,1943,24200,26143
2014-05-19 10:00:00-04:00,0,5,10,0,0,1799,23805,25604
2014-05-19 11:00:00-04:00,0,5,11,0,0,1638,21492,23130
2014-05-19 12:00:00-04:00,0,5,12,0,0,1525,21464,22989
2014-05-19 13:00:00-04:00,0,5,13,0,0,1528,22731,24259
2014-05-19 14:00:00-04:00,0,5,14,0,0,1487,22661,24148
2014-05-19 15:00:00-04:00,0,5,15,0,0,1709,23898,25607
2014-05-19 16:00:00-04:00,0,5,16,0,0,2026,22825,24851
2014-05-19 17:00:00-04:00,0,5,17,0,0,2111,19046,21157
2014-05-19 18:00:00-04:00,0,5,18,0,0,2304,22873,25177
2014-05-19 19:00:00-04:00,0,5,19,0,0,2283,28860,31143
2014-05-19 20:00:00-04:00,0,5,20,0,0,2425,30433,32858
2014-05-19 21:00:00-04:00,0,5,21,0,0,2074,28235,30309
2014-05-19 22:00:00-04:00,0,5,22,0,0,1969,28213,30182
2014-05-19 23:00:00-04:00,0,5,23,0,0,1713,25662,27375
2014-05-20 00:00:00-04:00,0,5,0,1,0,1433,20174,21607
2014-05-20 01:00:00-04:00,0,5,1,1,0,1161,12992,14153
2014-05-20 02:00:00-04:00,0,5,2,1,0,817,7903,8720
2014-05-20 03:00:00-04:00,0,5,3,1,0,510,4991,5501
2014-05-20 04:00:00-04:00,0,5,4,1,0,392,3057,3449
2014-05-20 05:00:00-04:00,0,5,5,1,0,390,3036,3426
2014-05-20 06:00:00-04:00,0,5,6,1,0,329,4804,5133
2014-05-20 07:00:00-04:00,0,5,7,1,0,602,12371,12973
2014-05-20 08:00:00-04:00,0,5,8,1,0,1292,22854,24146
2014-05-20 09:00:00-04:00,0,5,9,1,0,1950,26332,28282
2014-05-20 10:00:00-04:00,0,5,10,1,0,1870,24991,26861
2014-05-20 11:00:00-04:00,0,5,11,1,0,1671,22749,24420
2014-05-20 12:00:00-04:00,0,5,12,1,0,1532,22814,24346
2014-05-20 13:00:00-04:00,0,5,13,1,0,1559,23254,24813
2014-05-20 14:00:00-04:00,0,5,14,1,0,1647,22908,24555
2014-05-20 15:00:00-04:00,0,5,15,1,0,1885,23991,25876
2014-05-20 16:00:00-04:00,0,5,16,1,0,2000,21638,23638
2014-05-20 17:00:00-04:00,0,5,17,1,0,1830,16845,18675
2014-05-20 18:00:00-04:00,0,5,18,1,0,2059,21268,23327
2014-05-20 19:00:00-04:00,0,5,19,1,0,2615,28608,31223
2014-05-20 20:00:00-04:00,0,5,20,1,0,2616,30854,33470
2014-05-20 21:00:00-04:00,0,5,21,1,0,2300,30014,32314
2014-05-20 22:00:00-04:00,0,5,22,1,0,2237,30540,32777
2014-05-20 23:00:00-04:00,0,5,23,1,0,2041,28892,30933
2014-05-21 00:00:00-04:00,0,5,0,2,0,1913,24493,26406
2014-05-21 01:00:00-04:00,0,5,1,2,0,1394,15842,17236
2014-05-21 02:00:00-04:00,0,5,2,2,0,944,9411,10355
2014-05-21 03:00:00-04:00,0,5,3,2,0,609,5687,6296
2014-05-21 04:00:00-04:00,0,5,4,2,0,435,3848,4283
2014-05-21 05:00:00-04:00,0,5,5,2,0,398,3460,3858
2014-05-21 06:00:00-04:00,0,5,6,2,0,345,5136,5481
2014-05-21 07:00:00-04:00,0,5,7,2,0,604,12964,13568
2014-05-21 08:00:00-04:00,0,5,8,2,0,1298,23638,24936
2014-05-21 09:00:00-04:00,0,5,9,2,0,1999,26560,28559
2014-05-21 10:00:00-04:00,0,5,10,2,0,1892,25758,27650
2014-05-21 11:00:00-04:00,0,5,11,2,0,1638,23257,24895
2014-05-21 12:00:00-04:00,0,5,12,2,0,1611,22786,24397
2014-05-21 13:00:00-04:00,0,5,13,2,0,1720,23515,25235
2014-05-21 14:00:00-04:00,0,5,14,2,0,1801,23236,25037
2014-05-21 15:00:00-04:00,0,5,15,2,0,1900,23687,25587
2014-05-21 16:00:00-04:00,0,5,16,2,0,2112,21438,23550
2014-05-21 17:00:00-04:00,0,5,17,2,0,2357,16252,18609
2014-05-21 18:00:00-04:00,0,5,18,2,0,2560,21675,24235
2014-05-21 19:00:00-04:00,0,5,19,2,0,2803,28368,31171
2014-05-21 20:00:00-04:00,0,5,20,2,0,2813,31377,34190
2014-05-21 21:00:00-04:00,0,5,21,2,0,2478,30020,32498
2014-05-21 22:00:00-04:00,0,5,22,2,0,2365,30947,33312
2014-05-21 23:00:00-04:00,0,5,23,2,0,2194,29800,31994
2014-05-22 00:00:00-04:00,0,5,0,3,0,1841,25317,27158
2014-05-22 01:00:00-04:00,0,5,1,3,0,1499,17203,18702
2014-05-22 02:00:00-04:00,0,5,2,3,0,1031,10378,11409
2014-05-22 03:00:00-04:00,0.15,5,3,3,0,675,6808,7483
2014-05-22 04:00:00-04:00,0.12,5,4,3,0,524,4940,5464
2014-05-22 05:00:00-04:00,0,5,5,3,0,451,4083,4534
2014-05-22 06:00:00-04:00,0,5,6,3,0,367,5303,5670
2014-05-22 07:00:00-04:00,0,5,7,3,0,571,13757,14328
2014-05-22 08:00:00-04:00,0,5,8,3,0,1382,23408,24790
2014-05-22 09:00:00-04:00,0,5,9,3,0,1911,27267,29178
2014-05-22 10:00:00-04:00,0,5,10,3,0,2107,26138,28245
2014-05-22 11:00:00-04:00,0,5,11,3,0,1770,23692,25462
2014-05-22 12:00:00-04:00,0,5,12,3,0,1761,24126,25887
2014-05-22 13:00:00-04:00,0,5,13,3,0,1763,23598,25361
2014-05-22 14:00:00-04:00,0,5,14,3,0,1793,23581,25374
2014-05-22 15:00:00-04:00,0,5,15,3,0,1921,23204,25125
2014-05-22 16:00:00-04:00,0,5,16,3,0,2162,19988,22150
2014-05-22 17:00:00-04:00,0,5,17,3,0,2416,15098,17514
2014-05-22 18:00:00-04:00,0.01,5,18,3,0,2816,20529,23345
2014-05-22 19:00:00-04:00,0,5,19,3,0,3385,26998,30383
2014-05-22 20:00:00-04:00,0,5,20,3,0,3117,30131,33248
2014-05-22 21:00:00-04:00,0,5,21,3,0,2688,30309,32997
2014-05-22 22:00:00-04:00,0,5,22,3,0,2609,31403,34012
2014-05-22 23:00:00-04:00,0,5,23,3,0,2542,29302,31844
2014-05-23 00:00:00-04:00,0,5,0,4,0,2391,28018,30409
2014-05-23 01:00:00-04:00,0,5,1,4,0,2015,22152,24167
2014-05-23 02:00:00-04:00,0,5,2,4,0,1438,15355,16793
2014-05-23 03:00:00-04:00,0,5,3,4,0,965,10377,11342
2014-05-23 04:00:00-04:00,0,5,4,4,0,713,6921,7634
2014-05-23 05:00:00-04:00,0,5,5,4,0,549,5379,5928
2014-05-23 06:00:00-04:00,0,5,6,4,0,441,5742,6183
2014-05-23 07:00:00-04:00,0,5,7,4,0,622,12170,12792
2014-05-23 08:00:00-04:00,0,5,8,4,0,1300,20605,21905
2014-05-23 09:00:00-04:00,0,5,9,4,0,1910,24559,26469
2014-05-23 10:00:00-04:00,0,5,10,4,0,1871,24283,26154
2014-05-23 11:00:00-04:00,0,5,11,4,0,1811,21537,23348
2014-05-23 12:00:00-04:00,0,5,12,4,0,1690,21523,23213
2014-05-23 13:00:00-04:00,0,5,13,4,0,1708,22535,24243
2014-05-23 14:00:00-04:00,0,5,14,4,0,1663,22091,23754
2014-05-23 15:00:00-04:00,0,5,15,4,0,2012,22755,24767
2014-05-23 16:00:00-04:00,0.02,5,16,4,0,2540,20173,22713
2014-05-23 17:00:00-04:00,0.02,5,17,4,0,2928,16374,19302
2014-05-23 18:00:00-04:00,0,5,18,4,0,3183,21239,24422
2014-05-23 19:00:00-04:00,0,5,19,4,0,3269,26137,29406
2014-05-23 20:00:00-04:00,0,5,20,4,0,3870,33088,36958
2014-05-23 21:00:00-04:00,0.16,5,21,4,0,4248,32328,36576
2014-05-23 22:00:00-04:00,0.41,5,22,4,0,4312,31035,35347
2014-05-23 23:00:00-04:00,0.09,5,23,4,0,4090,29128,33218
2014-05-24 00:00:00-04:00,0.37,5,0,5,0,3750,28373,32123
2014-05-24 01:00:00-04:00,0.02,5,1,5,0,3393,25544,28937
2014-05-24 02:00:00-04:00,0,5,2,5,0,2718,19859,22577
2014-05-24 03:00:00-04:00,0,5,3,5,0,2110,14551,16661
2014-05-24 04:00:00-04:00,0,5,4,5,0,1573,11158,12731
2014-05-24 05:00:00-04:00,0,5,5,5,0,1299,7898,9197
2014-05-24 06:00:00-04:00,0,5,6,5,0,722,4525,5247
2014-05-24 07:00:00-04:00,0,5,7,5,0,524,5269,5793
2014-05-24 08:00:00-04:00,0,5,8,5,0,688,7153,7841
2014-05-24 09:00:00-04:00,0,5,9,5,0,933,9794,10727
2014-05-24 10:00:00-04:00,0,5,10,5,0,1188,13882,15070
2014-05-24 11:00:00-04:00,0,5,11,5,0,1458,16546,18004
2014-05-24 12:00:00-04:00,0,5,12,5,0,1548,18659,20207
2014-05-24 13:00:00-04:00,0,5,13,5,0,1750,19747,21497
2014-05-24 14:00:00-04:00,0,5,14,5,0,1868,20858,22726
2014-05-24 15:00:00-04:00,0,5,15,5,0,2254,20231,22485
2014-05-24 16:00:00-04:00,0,5,16,5,0,2393,19161,21554
2014-05-24 17:00:00-04:00,0.01,5,17,5,0,3060,19683,22743
2014-05-24 18:00:00-04:00,0,5,18,5,0,3539,24583,28122
2014-05-24 19:00:00-04:00,0,5,19,5,0,3170,23324,26494
2014-05-24 20:00:00-04:00,0.01,5,20,5,0,3107,22126,25233
2014-05-24 21:00:00-04:00,0,5,21,5,0,3161,20535,23696
2014-05-24 22:00:00-04:00,0,5,22,5,0,3246,20839,24085
2014-05-24 23:00:00-04:00,0,5,23,5,0,3468,22776,26244
2014-05-25 00:00:00-04:00,0,5,0,6,0,3520,24610,28130
2014-05-25 01:00:00-04:00,0,5,1,6,0,3439,23175,26614
2014-05-25 02:00:00-04:00,0,5,2,6,0,3026,19802,22828
2014-05-25 03:00:00-04:00,0,5,3,6,0,2689,16501,19190
2014-05-25 04:00:00-04:00,0,5,4,6,0,2139,13214,15353
2014-05-25 05:00:00-04:00,0,5,5,6,0,1716,8790,10506
2014-05-25 06:00:00-04:00,0,5,6,6,0,817,4168,4985
2014-05-25 07:00:00-04:00,0,5,7,6,0,525,4070,4595
2014-05-25 08:00:00-04:00,0,5,8,6,0,493,5202,5695
2014-05-25 09:00:00-04:00,0,5,9,6,0,675,7118,7793
2014-05-25 10:00:00-04:00,0,5,10,6,0,907,10878,11785
2014-05-25 11:00:00-04:00,0,5,11,6,0,1225,14362,15587
2014-05-25 12:00:00-04:00,0,5,12,6,0,1419,16959,18378
2014-05-25 13:00:00-04:00,0,5,13,6,0,1551,18570,20121
2014-05-25 14:00:00-04:00,0,5,14,6,0,1776,19401,21177
2014-05-25 15:00:00-04:00,0,5,15,6,0,1919,20053,21972
2014-05-25 16:00:00-04:00,0,5,16,6,0,2122,18687,20809
2014-05-25 17:00:00-04:00,0,5,17,6,0,2274,18003,20277
2014-05-25 18:00:00-04:00,0,5,18,6,0,2290,19819,22109
2014-05-25 19:00:00-04:00,0,5,19,6,0,2450,21236,23686
2014-05-25 20:00:00-04:00,0,5,20,6,0,2633,20520,23153
2014-05-25 21:00:00-04:00,0,5,21,6,0,2527,19120,21647
2014-05-25 22:00:00-04:00,0,5,22,6,0,2521,19196,21717
2014-05-25 23:00:00-04:00,0,5,23,6,0,2562,18934,21496
2014-05-26 00:00:00-04:00,0,5,0,0,1,2607,20295,22902
2014-05-26 01:00:00-04:00,0,5,1,0,1,2447,17822,20269
2014-05-26 02:00:00-04:00,0,5,2,0,1,2015,13692,15707
2014-05-26 03:00:00-04:00,0,5,3,0,1,1547,10188,11735
2014-05-26 04:00:00-04:00,0,5,4,0,1,1156,7046,8202
2014-05-26 05:00:00-04:00,0,5,5,0,1,959,5067,6026
2014-05-26 06:00:00-04:00,0,5,6,0,1,558,3362,3920
2014-05-26 07:00:00-04:00,0,5,7,0,1,409,4097,4506
2014-05-26 08:00:00-04:00,0,5,8,0,1,472,5199,5671
2014-05-26 09:00:00-04:00,0,5,9,0,1,551,6675,7226
2014-05-26 10:00:00-04:00,0,5,10,0,1,752,9566,10318
2014-05-26 11:00:00-04:00,0,5,11,0,1,910,12901,13811
2014-05-26 12:00:00-04:00,0,5,12,0,1,1121,15091,16212
2014-05-26 13:00:00-04:00,0,5,13,0,1,1310,16817,18127
2014-05-26 14:00:00-04:00,0,5,14,0,1,1414,17953,19367
2014-05-26 15:00:00-04:00,0,5,15,0,1,1686,18733,20419
2014-05-26 16:00:00-04:00,0,5,16,0,1,1833,19265,21098
2014-05-26 17:00:00-04:00,0,5,17,0,1,2041,17938,19979
2014-05-26 18:00:00-04:00,0,5,18,0,1,2144,19652,21796
2014-05-26 19:00:00-04:00,0,5,19,0,1,2219,20993,23212
2014-05-26 20:00:00-04:00,0,5,20,0,1,2307,20974,23281
2014-05-26 21:00:00-04:00,0,5,21,0,1,2149,19772,21921
2014-05-26 22:00:00-04:00,0,5,22,0,1,2236,19993,22229
2014-05-26 23:00:00-04:00,0,5,23,0,1,1984,18706,20690
2014-05-27 00:00:00-04:00,0,5,0,1,0,1789,14671,16460
2014-05-27 01:00:00-04:00,0,5,1,1,0,1405,10148,11553
2014-05-27 02:00:00-04:00,0,5,2,1,0,879,5721,6600
2014-05-27 03:00:00-04:00,0,5,3,1,0,572,3613,4185
2014-05-27 04:00:00-04:00,0,5,4,1,0,424,2350,2774
2014-05-27 05:00:00-04:00,0,5,5,1,0,395,2788,3183
2014-05-27 06:00:00-04:00,0,5,6,1,0,379,4840,5219
2014-05-27 07:00:00-04:00,0,5,7,1,0,579,12287,12866
2014-05-27 08:00:00-04:00,0,5,8,1,0,1290,21466,22756
2014-05-27 09:00:00-04:00,0,5,9,1,0,1817,25022,26839
2014-05-27 10:00:00-04:00,0,5,10,1,0,1734,23601,25335
2014-05-27 11:00:00-04:00,0,5,11,1,0,1564,20854,22418
2014-05-27 12:00:00-04:00,0,5,12,1,0,1500,21280,22780
2014-05-27 13:00:00-04:00,0,5,13,1,0,1502,22007,23509
2014-05-27 14:00:00-04:00,0,5,14,1,0,1504,21932,23436
2014-05-27 15:00:00-04:00,0,5,15,1,0,1759,24871,26630
2014-05-27 16:00:00-04:00,0,5,16,1,0,1868,21470,23338
2014-05-27 17:00:00-04:00,0,5,17,1,0,1990,17657,19647
2014-05-27 18:00:00-04:00,0,5,18,1,0,2244,21945,24189
2014-05-27 19:00:00-04:00,0,5,19,1,0,2406,28154,30560
2014-05-27 20:00:00-04:00,0,5,20,1,0,2339,29300,31639
2014-05-27 21:00:00-04:00,0,5,21,1,0,2022,25759,27781
2014-05-27 22:00:00-04:00,0,5,22,1,0,1816,25316,27132
2014-05-27 23:00:00-04:00,0,5,23,1,0,1604,22644,24248
2014-05-28 00:00:00-04:00,0,5,0,2,0,1378,17944,19322
2014-05-28 01:00:00-04:00,0,5,1,2,0,1154,12067,13221
2014-05-28 02:00:00-04:00,0,5,2,2,0,730,7904,8634
2014-05-28 03:00:00-04:00,0,5,3,2,0,429,4430,4859
2014-05-28 04:00:00-04:00,0,5,4,2,0,377,2846,3223
2014-05-28 05:00:00-04:00,0,5,5,2,0,310,2858,3168
2014-05-28 06:00:00-04:00,0,5,6,2,0,351,4527,4878
2014-05-28 07:00:00-04:00,0,5,7,2,0,569,12293,12862
2014-05-28 08:00:00-04:00,0,5,8,2,0,1298,23023,24321
2014-05-28 09:00:00-04:00,0,5,9,2,0,1994,27113,29107
2014-05-28 10:00:00-04:00,0,5,10,2,0,1958,26114,28072
2014-05-28 11:00:00-04:00,0,5,11,2,0,1831,23717,25548
2014-05-28 12:00:00-04:00,0,5,12,2,0,1682,23380,25062
2014-05-28 13:00:00-04:00,0,5,13,2,0,1692,23937,25629
2014-05-28 14:00:00-04:00,0,5,14,2,0,1664,23027,24691
2014-05-28 15:00:00-04:00,0,5,15,2,0,1868,23403,25271
2014-05-28 16:00:00-04:00,0,5,16,2,0,2051,21424,23475
2014-05-28 17:00:00-04:00,0,5,17,2,0,2290,16395,18685
2014-05-28 18:00:00-04:00,0,5,18,2,0,2661,21631,24292
2014-05-28 19:00:00-04:00,0,5,19,2,0,2874,27169,30043
2014-05-28 20:00:00-04:00,0,5,20,2,0,2865,30750,33615
2014-05-28 21:00:00-04:00,0,5,21,2,0,2444,30708,33152
2014-05-28 22:00:00-04:00,0,5,22,2,0,2327,31447,33774
2014-05-28 23:00:00-04:00,0,5,23,2,0,2052,28900,30952
2014-05-29 00:00:00-04:00,0,5,0,3,0,1852,23357,25209
2014-05-29 01:00:00-04:00,0,5,1,3,0,1514,15717,17231
2014-05-29 02:00:00-04:00,0,5,2,3,0,985,9281,10266
2014-05-29 03:00:00-04:00,0,5,3,3,0,601,5587,6188
2014-05-29 04:00:00-04:00,0,5,4,3,0,462,3652,4114
2014-05-29 05:00:00-04:00,0,5,5,3,0,397,3225,3622
2014-05-29 06:00:00-04:00,0,5,6,3,0,383,4709,5092
2014-05-29 07:00:00-04:00,0,5,7,3,0,588,12814,13402
2014-05-29 08:00:00-04:00,0,5,8,3,0,1378,23370,24748
2014-05-29 09:00:00-04:00,0,5,9,3,0,2063,26919,28982
2014-05-29 10:00:00-04:00,0,5,10,3,0,1970,25258,27228
2014-05-29 11:00:00-04:00,0,5,11,3,0,1699,22291,23990
2014-05-29 12:00:00-04:00,0,5,12,3,0,1697,22124,23821
2014-05-29 13:00:00-04:00,0,5,13,3,0,1613,22875,24488
2014-05-29 14:00:00-04:00,0,5,14,3,0,1659,22677,24336
2014-05-29 15:00:00-04:00,0,5,15,3,0,1996,23688,25684
2014-05-29 16:00:00-04:00,0,5,16,3,0,2193,21891,24084
2014-05-29 17:00:00-04:00,0,5,17,3,0,2334,16938,19272
2014-05-29 18:00:00-04:00,0,5,18,3,0,2516,22048,24564
2014-05-29 19:00:00-04:00,0,5,19,3,0,2989,29697,32686
2014-05-29 20:00:00-04:00,0,5,20,3,0,2977,33472,36449
2014-05-29 21:00:00-04:00,0,5,21,3,0,2740,31208,33948
2014-05-29 22:00:00-04:00,0,5,22,3,0,2677,31126,33803
2014-05-29 23:00:00-04:00,0,5,23,3,0,2500,30646,33146
2014-05-30 00:00:00-04:00,0,5,0,4,0,2290,28526,30816
2014-05-30 01:00:00-04:00,0,5,1,4,0,1956,21283,23239
2014-05-30 02:00:00-04:00,0,5,2,4,0,1349,13932,15281
2014-05-30 03:00:00-04:00,0,5,3,4,0,992,9153,10145
2014-05-30 04:00:00-04:00,0,5,4,4,0,618,6205,6823
2014-05-30 05:00:00-04:00,0,5,5,4,0,548,4799,5347
2014-05-30 06:00:00-04:00,0,5,6,4,0,445,5474,5919
2014-05-30 07:00:00-04:00,0,5,7,4,0,708,12299,13007
2014-05-30 08:00:00-04:00,0,5,8,4,0,1334,22462,23796
2014-05-30 09:00:00-04:00,0,5,9,4,0,2005,26002,28007
2014-05-30 10:00:00-04:00,0,5,10,4,0,1956,24266,26222
2014-05-30 11:00:00-04:00,0,5,11,4,0,1806,22349,24155
2014-05-30 12:00:00-04:00,0,5,12,4,0,1745,22228,23973
2014-05-30 13:00:00-04:00,0,5,13,4,0,1780,22841,24621
2014-05-30 14:00:00-04:00,0,5,14,4,0,1655,22028,23683
2014-05-30 15:00:00-04:00,0,5,15,4,0,2017,23358,25375
2014-05-30 16:00:00-04:00,0,5,16,4,0,2358,20950,23308
2014-05-30 17:00:00-04:00,0,5,17,4,0,2728,16650,19378
2014-05-30 18:00:00-04:00,0,5,18,4,0,2960,21705,24665
2014-05-30 19:00:00-04:00,0.03,5,19,4,0,3422,28928,32350
2014-05-30 20:00:00-04:00,0,5,20,4,0,4171,34694,38865
2014-05-30 21:00:00-04:00,0,5,21,4,0,3499,29857,33356
2014-05-30 22:00:00-04:00,0,5,22,4,0,3599,29958,33557
2014-05-30 23:00:00-04:00,0,5,23,4,0,3597,31281,34878
2014-05-31 00:00:00-04:00,0,5,0,5,0,3858,31275,35133
2014-05-31 01:00:00-04:00,0,5,1,5,0,3654,29613,33267
2014-05-31 02:00:00-04:00,0,5,2,5,0,3180,25036,28216
2014-05-31 03:00:00-04:00,0,5,3,5,0,2560,20582,23142
2014-05-31 04:00:00-04:00,0,5,4,5,0,2073,15033,17106
2014-05-31 05:00:00-04:00,0,5,5,5,0,1539,9520,11059
2014-05-31 06:00:00-04:00,0,5,6,5,0,765,4840,5605
2014-05-31 07:00:00-04:00,0,5,7,5,0,573,5722,6295
2014-05-31 08:00:00-04:00,0,5,8,5,0,772,8600,9372
2014-05-31 09:00:00-04:00,0,5,9,5,0,1166,13717,14883
2014-05-31 10:00:00-04:00,0,5,10,5,0,1425,18498,19923
2014-05-31 11:00:00-04:00,0,5,11,5,0,1655,21578,23233
2014-05-31 12:00:00-04:00,0,5,12,5,0,1801,23097,24898
2014-05-31 13:00:00-04:00,0,5,13,5,0,2010,24749,26759
2014-05-31 14:00:00-04:00,0,5,14,5,0,2152,25490,27642
2014-05-31 15:00:00-04:00,0.01,5,15,5,0,2483,25013,27496
2014-05-31 16:00:00-04:00,0,5,16,5,0,3028,25009,28037
2014-05-31 17:00:00-04:00,0,5,17,5,0,3012,19166,22178
2014-05-31 18:00:00-04:00,0,5,18,5,0,3137,21607,24744
2014-05-31 19:00:00-04:00,0,5,19,5,0,3518,27462,30980
2014-05-31 20:00:00-04:00,0,5,20,5,0,3845,30267,34112
2014-05-31 21:00:00-04:00,0,5,21,5,0,3649,27637,31286
2014-05-31 22:00:00-04:00,0,5,22,5,0,3963,28459,32422
2014-05-31 23:00:00-04:00,0,5,23,5,0,3972,29901,33873
2014-06-01 00:00:00-04:00,0,6,0,6,0,3994,31395,35389
2014-06-01 01:00:00-04:00,0,6,1,6,0,3831,29746,33577
2014-06-01 02:00:00-04:00,0,6,2,6,0,3363,26245,29608
2014-06-01 03:00:00-04:00,0,6,3,6,0,3033,22498,25531
2014-06-01 04:00:00-04:00,0,6,4,6,0,2541,17255,19796
2014-06-01 05:00:00-04:00,0,6,5,6,0,1924,10820,12744
2014-06-01 06:00:00-04:00,0,6,6,6,0,1010,5075,6085
2014-06-01 07:00:00-04:00,0,6,7,6,0,595,5012,5607
2014-06-01 08:00:00-04:00,0,6,8,6,0,606,6862,7468
2014-06-01 09:00:00-04:00,0,6,9,6,0,779,9261,10040
2014-06-01 10:00:00-04:00,0,6,10,6,0,1080,14321,15401
2014-06-01 11:00:00-04:00,0,6,11,6,0,1382,19260,20642
2014-06-01 12:00:00-04:00,0,6,12,6,0,1550,21441,22991
2014-06-01 13:00:00-04:00,0,6,13,6,0,1642,21896,23538
2014-06-01 14:00:00-04:00,0,6,14,6,0,1834,21435,23269
2014-06-01 15:00:00-04:00,0,6,15,6,0,1989,21388,23377
2014-06-01 16:00:00-04:00,0,6,16,6,0,2268,20350,22618
2014-06-01 17:00:00-04:00,0,6,17,6,0,2367,17865,20232
2014-06-01 18:00:00-04:00,0,6,18,6,0,2367,19749,22116
2014-06-01 19:00:00-04:00,0,6,19,6,0,2483,22624,25107
2014-06-01 20:00:00-04:00,0,6,20,6,0,2503,22723,25226
2014-06-01 21:00:00-04:00,0,6,21,6,0,2461,21705,24166
2014-06-01 22:00:00-04:00,0,6,22,6,0,2454,21170,23624
2014-06-01 23:00:00-04:00,0,6,23,6,0,2231,18984,21215
2014-06-02 00:00:00-04:00,0,6,0,0,0,2111,17478,19589
2014-06-02 01:00:00-04:00,0,6,1,0,0,1588,10515,12103
2014-06-02 02:00:00-04:00,0,6,2,0,0,1047,6552,7599
2014-06-02 03:00:00-04:00,0,6,3,0,0,696,3986,4682
2014-06-02 04:00:00-04:00,0,6,4,0,0,507,2712,3219
2014-06-02 05:00:00-04:00,0,6,5,0,0,523,2994,3517
2014-06-02 06:00:00-04:00,0,6,6,0,0,433,5051,5484
2014-06-02 07:00:00-04:00,0,6,7,0,0,614,12424,13038
2014-06-02 08:00:00-04:00,0,6,8,0,0,1268,20790,22058
2014-06-02 09:00:00-04:00,0,6,9,0,0,1880,23861,25741
2014-06-02 10:00:00-04:00,0,6,10,0,0,1767,22329,24096
2014-06-02 11:00:00-04:00,0,6,11,0,0,1549,19682,21231
2014-06-02 12:00:00-04:00,0,6,12,0,0,1423,19844,21267
2014-06-02 13:00:00-04:00,0,6,13,0,0,1412,20659,22071
2014-06-02 14:00:00-04:00,0,6,14,0,0,1488,20379,21867
2014-06-02 15:00:00-04:00,0,6,15,0,0,1602,21868,23470
2014-06-02 16:00:00-04:00,0,6,16,0,0,1926,21612,23538
2014-06-02 17:00:00-04:00,0,6,17,0,0,1922,18606,20528
2014-06-02 18:00:00-04:00,0,6,18,0,0,2177,23217,25394
2014-06-02 19:00:00-04:00,0,6,19,0,0,2358,27916,30274
2014-06-02 20:00:00-04:00,0,6,20,0,0,2191,28018,30209
2014-06-02 21:00:00-04:00,0,6,21,0,0,1950,25767,27717
2014-06-02 22:00:00-04:00,0,6,22,0,0,1913,26000,27913
2014-06-02 23:00:00-04:00,0,6,23,0,0,1636,24088,25724
2014-06-03 00:00:00-04:00,0,6,0,1,0,1438,19252,20690
2014-06-03 01:00:00-04:00,0,6,1,1,0,1168,12087,13255
2014-06-03 02:00:00-04:00,0,6,2,1,0,747,6853,7600
2014-06-03 03:00:00-04:00,0,6,3,1,0,471,4232,4703
2014-06-03 04:00:00-04:00,0,6,4,1,0,378,2730,3108
2014-06-03 05:00:00-04:00,0,6,5,1,0,336,2634,2970
2014-06-03 06:00:00-04:00,0,6,6,1,0,371,4482,4853
2014-06-03 07:00:00-04:00,0,6,7,1,0,634,12325,12959
2014-06-03 08:00:00-04:00,0,6,8,1,0,1324,22585,23909
2014-06-03 09:00:00-04:00,0,6,9,1,0,1878,25776,27654
2014-06-03 10:00:00-04:00,0,6,10,1,0,1944,24170,26114
2014-06-03 11:00:00-04:00,0,6,11,1,0,1747,21688,23435
2014-06-03 12:00:00-04:00,0,6,12,1,0,1750,22732,24482
2014-06-03 13:00:00-04:00,0,6,13,1,0,1766,23466,25232
2014-06-03 14:00:00-04:00,0,6,14,1,0,1724,23372,25096
2014-06-03 15:00:00-04:00,0,6,15,1,0,1769,24045,25814
2014-06-03 16:00:00-04:00,0,6,16,1,0,1955,22147,24102
2014-06-03 17:00:00-04:00,0,6,17,1,0,2255,17436,19691
2014-06-03 18:00:00-04:00,0.01,6,18,1,0,2902,23955,26857
2014-06-03 19:00:00-04:00,0.05,6,19,1,0,3620,30986,34606
2014-06-03 20:00:00-04:00,0,6,20,1,0,2925,29526,32451
2014-06-03 21:00:00-04:00,0,6,21,1,0,2169,27521,29690
2014-06-03 22:00:00-04:00,0,6,22,1,0,2054,28488,30542
2014-06-03 23:00:00-04:00,0,6,23,1,0,1888,27790,29678
2014-06-04 00:00:00-04:00,0,6,0,2,0,1676,21644,23320
2014-06-04 01:00:00-04:00,0,6,1,2,0,1273,14169,15442
2014-06-04 02:00:00-04:00,0,6,2,2,0,807,7961,8768
2014-06-04 03:00:00-04:00,0,6,3,2,0,522,4877,5399
2014-06-04 04:00:00-04:00,0,6,4,2,0,373,3233,3606
2014-06-04 05:00:00-04:00,0,6,5,2,0,360,3170,3530
2014-06-04 06:00:00-04:00,0,6,6,2,0,332,4653,4985
2014-06-04 07:00:00-04:00,0,6,7,2,0,632,12389,13021
2014-06-04 08:00:00-04:00,0,6,8,2,0,1350,23295,24645
2014-06-04 09:00:00-04:00,0,6,9,2,0,1934,26801,28735
2014-06-04 10:00:00-04:00,0,6,10,2,0,1947,24405,26352
2014-06-04 11:00:00-04:00,0,6,11,2,0,1839,22767,24606
2014-06-04 12:00:00-04:00,0,6,12,2,0,1718,22404,24122
2014-06-04 13:00:00-04:00,0,6,13,2,0,1713,23024,24737
2014-06-04 14:00:00-04:00,0,6,14,2,0,1606,22631,24237
2014-06-04 15:00:00-04:00,0,6,15,2,0,1956,23651,25607
2014-06-04 16:00:00-04:00,0,6,16,2,0,2110,21900,24010
2014-06-04 17:00:00-04:00,0,6,17,2,0,2345,17734,20079
2014-06-04 18:00:00-04:00,0,6,18,2,0,2632,22819,25451
2014-06-04 19:00:00-04:00,0,6,19,2,0,2868,29431,32299
2014-06-04 20:00:00-04:00,0,6,20,2,0,2912,32207,35119
2014-06-04 21:00:00-04:00,0,6,21,2,0,2649,30337,32986
2014-06-04 22:00:00-04:00,0,6,22,2,0,2639,31199,33838
2014-06-04 23:00:00-04:00,0,6,23,2,0,2230,29707,31937
2014-06-05 00:00:00-04:00,0,6,0,3,0,2180,27584,29764
2014-06-05 01:00:00-04:00,0,6,1,3,0,1637,17170,18807
2014-06-05 02:00:00-04:00,0.01,6,2,3,0,1137,10583,11720
2014-06-05 03:00:00-04:00,0,6,3,3,0,685,6341,7026
2014-06-05 04:00:00-04:00,0.03,6,4,3,0,561,4359,4920
2014-06-05 05:00:00-04:00,0.04,6,5,3,0,498,3829,4327
2014-06-05 06:00:00-04:00,0.19,6,6,3,0,405,5356,5761
2014-06-05 07:00:00-04:00,0.13,6,7,3,0,709,14742,15451
2014-06-05 08:00:00-04:00,0.03,6,8,3,0,1454,24258,25712
2014-06-05 09:00:00-04:00,0.24,6,9,3,0,2135,26821,28956
2014-06-05 10:00:00-04:00,0.03,6,10,3,0,2231,26181,28412
2014-06-05 11:00:00-04:00,0.01,6,11,3,0,1806,24000,25806
2014-06-05 12:00:00-04:00,0,6,12,3,0,1750,22712,24462
2014-06-05 13:00:00-04:00,0,6,13,3,0,1563,22719,24282
2014-06-05 14:00:00-04:00,0,6,14,3,0,1605,22238,23843
2014-06-05 15:00:00-04:00,0,6,15,3,0,1882,22959,24841
2014-06-05 16:00:00-04:00,0,6,16,3,0,2065,21786,23851
2014-06-05 17:00:00-04:00,0,6,17,3,0,2343,17715,20058
2014-06-05 18:00:00-04:00,0,6,18,3,0,2536,22938,25474
2014-06-05 19:00:00-04:00,0,6,19,3,0,2870,29481,32351
2014-06-05 20:00:00-04:00,0,6,20,3,0,2855,32193,35048
2014-06-05 21:00:00-04:00,0,6,21,3,0,2678,31357,34035
2014-06-05 22:00:00-04:00,0,6,22,3,0,2702,32193,34895
2014-06-05 23:00:00-04:00,0,6,23,3,0,2492,31059,33551
2014-06-06 00:00:00-04:00,0,6,0,4,0,2450,28704,31154
2014-06-06 01:00:00-04:00,0,6,1,4,0,1998,23281,25279
2014-06-06 02:00:00-04:00,0,6,2,4,0,1485,15253,16738
2014-06-06 03:00:00-04:00,0,6,3,4,0,994,10026,11020
2014-06-06 04:00:00-04:00,0,6,4,4,0,759,6643,7402
2014-06-06 05:00:00-04:00,0,6,5,4,0,583,5210,5793
2014-06-06 06:00:00-04:00,0,6,6,4,0,430,5533,5963
2014-06-06 07:00:00-04:00,0,6,7,4,0,653,12297,12950
2014-06-06 08:00:00-04:00,0,6,8,4,0,1328,21512,22840
2014-06-06 09:00:00-04:00,0,6,9,4,0,2036,25429,27465
2014-06-06 10:00:00-04:00,0,6,10,4,0,1986,24054,26040
2014-06-06 11:00:00-04:00,0,6,11,4,0,1782,22327,24109
2014-06-06 12:00:00-04:00,0,6,12,4,0,1749,22841,24590
2014-06-06 13:00:00-04:00,0,6,13,4,0,1696,22406,24102
2014-06-06 14:00:00-04:00,0,6,14,4,0,1652,21841,23493
2014-06-06 15:00:00-04:00,0,6,15,4,0,1975,23137,25112
2014-06-06 16:00:00-04:00,0,6,16,4,0,2288,20829,23117
2014-06-06 17:00:00-04:00,0,6,17,4,0,2679,16405,19084
2014-06-06 18:00:00-04:00,0,6,18,4,0,3110,20946,24056
2014-06-06 19:00:00-04:00,0,6,19,4,0,3394,27176,30570
2014-06-06 20:00:00-04:00,0,6,20,4,0,3416,29770,33186
2014-06-06 21:00:00-04:00,0,6,21,4,0,3327,28929,32256
2014-06-06 22:00:00-04:00,0,6,22,4,0,3422,28590,32012
2014-06-06 23:00:00-04:00,0,6,23,4,0,3566,30094,33660
2014-06-07 00:00:00-04:00,0,6,0,5,0,3729,30641,34370
2014-06-07 01:00:00-04:00,0,6,1,5,0,3593,28926,32519
2014-06-07 02:00:00-04:00,0,6,2,5,0,3164,24854,28018
2014-06-07 03:00:00-04:00,0,6,3,5,0,2652,20540,23192
2014-06-07 04:00:00-04:00,0,6,4,5,0,2084,15033,17117
2014-06-07 05:00:00-04:00,0,6,5,5,0,1597,9619,11216
2014-06-07 06:00:00-04:00,0,6,6,5,0,776,4904,5680
2014-06-07 07:00:00-04:00,0,6,7,5,0,577,5829,6406
2014-06-07 08:00:00-04:00,0,6,8,5,0,765,10200,10965
2014-06-07 09:00:00-04:00,0,6,9,5,0,1066,12725,13791
2014-06-07 10:00:00-04:00,0,6,10,5,0,1347,17616,18963
2014-06-07 11:00:00-04:00,0,6,11,5,0,1584,21001,22585
2014-06-07 12:00:00-04:00,0,6,12,5,0,1739,23622,25361
2014-06-07 13:00:00-04:00,0,6,13,5,0,1934,25088,27022
2014-06-07 14:00:00-04:00,0,6,14,5,0,2152,24727,26879
2014-06-07 15:00:00-04:00,0,6,15,5,0,2403,24094,26497
2014-06-07 16:00:00-04:00,0,6,16,5,0,2635,23197,25832
2014-06-07 17:00:00-04:00,0,6,17,5,0,2937,20489,23426
2014-06-07 18:00:00-04:00,0,6,18,5,0,2999,23863,26862
2014-06-07 19:00:00-04:00,0,6,19,5,0,3363,26882,30245
2014-06-07 20:00:00-04:00,0,6,20,5,0,3739,29031,32770
2014-06-07 21:00:00-04:00,0,6,21,5,0,3557,24869,28426
2014-06-07 22:00:00-04:00,0,6,22,5,0,3870,25958,29828
2014-06-07 23:00:00-04:00,0,6,23,5,0,4069,28501,32570
2014-06-08 00:00:00-04:00,0,6,0,6,0,4284,32588,36872
2014-06-08 01:00:00-04:00,0,6,1,6,0,4043,30919,34962
2014-06-08 02:00:00-04:00,0,6,2,6,0,3706,26572,30278
2014-06-08 03:00:00-04:00,0,6,3,6,0,3306,21617,24923
2014-06-08 04:00:00-04:00,0,6,4,6,0,2558,16401,18959
2014-06-08 05:00:00-04:00,0,6,5,6,0,1921,10854,12775
2014-06-08 06:00:00-04:00,0,6,6,6,0,933,5151,6084
2014-06-08 07:00:00-04:00,0,6,7,6,0,562,4839,5401
2014-06-08 08:00:00-04:00,0,6,8,6,0,545,6395,6940
2014-06-08 09:00:00-04:00,0,6,9,6,0,721,9373,10094
2014-06-08 10:00:00-04:00,0,6,10,6,0,1018,13930,14948
2014-06-08 11:00:00-04:00,0,6,11,6,0,1298,18056,19354
2014-06-08 12:00:00-04:00,0,6,12,6,0,1486,20640,22126
2014-06-08 13:00:00-04:00,0,6,13,6,0,1683,22099,23782
2014-06-08 14:00:00-04:00,0,6,14,6,0,1791,22605,24396
2014-06-08 15:00:00-04:00,0,6,15,6,0,2033,22179,24212
2014-06-08 16:00:00-04:00,0,6,16,6,0,2294,20967,23261
2014-06-08 17:00:00-04:00,0,6,17,6,0,2466,18530,20996
2014-06-08 18:00:00-04:00,0,6,18,6,0,2422,21171,23593
2014-06-08 19:00:00-04:00,0,6,19,6,0,2612,23276,25888
2014-06-08 20:00:00-04:00,0,6,20,6,0,2620,22107,24727
2014-06-08 21:00:00-04:00,0,6,21,6,0,2318,20149,22467
2014-06-08 22:00:00-04:00,0,6,22,6,0,2344,19781,22125
2014-06-08 23:00:00-04:00,0,6,23,6,0,2396,18848,21244
2014-06-09 00:00:00-04:00,0,6,0,0,0,2297,18397,20694
2014-06-09 01:00:00-04:00,0,6,1,0,0,1675,12052,13727
2014-06-09 02:00:00-04:00,0,6,2,0,0,1058,7487,8545
2014-06-09 03:00:00-04:00,0,6,3,0,0,684,4835,5519
2014-06-09 04:00:00-04:00,0.06,6,4,0,0,488,3073,3561
2014-06-09 05:00:00-04:00,0.11,6,5,0,0,545,3474,4019
2014-06-09 06:00:00-04:00,0.18,6,6,0,0,455,5631,6086
2014-06-09 07:00:00-04:00,0.18,6,7,0,0,746,14083,14829
2014-06-09 08:00:00-04:00,0.3,6,8,0,0,1486,21244,22730
2014-06-09 09:00:00-04:00,0.31,6,9,0,0,2305,24442,26747
2014-06-09 10:00:00-04:00,0.17,6,10,0,0,2152,23742,25894
2014-06-09 11:00:00-04:00,0.01,6,11,0,0,1774,21860,23634
2014-06-09 12:00:00-04:00,0,6,12,0,0,1585,21212,22797
2014-06-09 13:00:00-04:00,0,6,13,0,0,1463,21008,22471
2014-06-09 14:00:00-04:00,0,6,14,0,0,1474,20740,22214
2014-06-09 15:00:00-04:00,0,6,15,0,0,1603,22285,23888
2014-06-09 16:00:00-04:00,0,6,16,0,0,1939,21757,23696
2014-06-09 17:00:00-04:00,0,6,17,0,0,2046,19253,21299
2014-06-09 18:00:00-04:00,0,6,18,0,0,2200,22953,25153
2014-06-09 19:00:00-04:00,0,6,19,0,0,2275,27861,30136
2014-06-09 20:00:00-04:00,0,6,20,0,0,2365,28685,31050
2014-06-09 21:00:00-04:00,0,6,21,0,0,2003,25717,27720
2014-06-09 22:00:00-04:00,0,6,22,0,0,1760,25178,26938
2014-06-09 23:00:00-04:00,0,6,23,0,0,1497,23290,24787
2014-06-10 00:00:00-04:00,0,6,0,1,0,1355,18300,19655
2014-06-10 01:00:00-04:00,0,6,1,1,0,1065,11787,12852
2014-06-10 02:00:00-04:00,0,6,2,1,0,668,6751,7419
2014-06-10 03:00:00-04:00,0,6,3,1,0,442,4161,4603
2014-06-10 04:00:00-04:00,0,6,4,1,0,354,2747,3101
2014-06-10 05:00:00-04:00,0,6,5,1,0,366,2803,3169
2014-06-10 06:00:00-04:00,0,6,6,1,0,351,4715,5066
2014-06-10 07:00:00-04:00,0,6,7,1,0,609,12572,13181
2014-06-10 08:00:00-04:00,0,6,8,1,0,1371,22177,23548
2014-06-10 09:00:00-04:00,0,6,9,1,0,2012,25639,27651
2014-06-10 10:00:00-04:00,0,6,10,1,0,1850,24385,26235
2014-06-10 11:00:00-04:00,0,6,11,1,0,1624,22295,23919
2014-06-10 12:00:00-04:00,0,6,12,1,0,1484,22075,23559
2014-06-10 13:00:00-04:00,0,6,13,1,0,1605,23495,25100
2014-06-10 14:00:00-04:00,0,6,14,1,0,1581,22930,24511
2014-06-10 15:00:00-04:00,0,6,15,1,0,1780,23311,25091
2014-06-10 16:00:00-04:00,0,6,16,1,0,2052,22174,24226
2014-06-10 17:00:00-04:00,0,6,17,1,0,2192,17596,19788
2014-06-10 18:00:00-04:00,0,6,18,1,0,2409,22870,25279
2014-06-10 19:00:00-04:00,0,6,19,1,0,2660,28985,31645
2014-06-10 20:00:00-04:00,0,6,20,1,0,2535,30483,33018
2014-06-10 21:00:00-04:00,0,6,21,1,0,2157,28485,30642
2014-06-10 22:00:00-04:00,0,6,22,1,0,2142,29600,31742
2014-06-10 23:00:00-04:00,0,6,23,1,0,1963,28152,30115
2014-06-11 00:00:00-04:00,0,6,0,2,0,1694,23426,25120
2014-06-11 01:00:00-04:00,0,6,1,2,0,1323,15430,16753
2014-06-11 02:00:00-04:00,0,6,2,2,0,870,8935,9805
2014-06-11 03:00:00-04:00,0,6,3,2,0,544,5366,5910
2014-06-11 04:00:00-04:00,0,6,4,2,0,400,3490,3890
2014-06-11 05:00:00-04:00,0,6,5,2,0,346,3295,3641
2014-06-11 06:00:00-04:00,0.04,6,6,2,0,315,5075,5390
2014-06-11 07:00:00-04:00,0,6,7,2,0,639,13751,14390
2014-06-11 08:00:00-04:00,0.01,6,8,2,0,1406,23298,24704
2014-06-11 09:00:00-04:00,0,6,9,2,0,2140,27201,29341
2014-06-11 10:00:00-04:00,0,6,10,2,0,2024,26001,28025
2014-06-11 11:00:00-04:00,0,6,11,2,0,1832,23301,25133
2014-06-11 12:00:00-04:00,0,6,12,2,0,1585,22475,24060
2014-06-11 13:00:00-04:00,0,6,13,2,0,1632,23452,25084
2014-06-11 14:00:00-04:00,0,6,14,2,0,1593,22505,24098
2014-06-11 15:00:00-04:00,0,6,15,2,0,1802,23469,25271
2014-06-11 16:00:00-04:00,0,6,16,2,0,2243,21444,23687
2014-06-11 17:00:00-04:00,0,6,17,2,0,2336,16499,18835
2014-06-11 18:00:00-04:00,0,6,18,2,0,2529,20749,23278
2014-06-11 19:00:00-04:00,0,6,19,2,0,2706,27688,30394
2014-06-11 20:00:00-04:00,0,6,20,2,0,2788,30353,33141
2014-06-11 21:00:00-04:00,0,6,21,2,0,2433,28703,31136
2014-06-11 22:00:00-04:00,0,6,22,2,0,2351,29444,31795
2014-06-11 23:00:00-04:00,0,6,23,2,0,2118,28297,30415
2014-06-12 00:00:00-04:00,0,6,0,3,0,2066,26998,29064
2014-06-12 01:00:00-04:00,0,6,1,3,0,1585,18361,19946
2014-06-12 02:00:00-04:00,0,6,2,3,0,1037,10654,11691
2014-06-12 03:00:00-04:00,0,6,3,3,0,663,6878,7541
2014-06-12 04:00:00-04:00,0,6,4,3,0,456,4387,4843
2014-06-12 05:00:00-04:00,0,6,5,3,0,417,3687,4104
2014-06-12 06:00:00-04:00,0,6,6,3,0,376,4941,5317
2014-06-12 07:00:00-04:00,0,6,7,3,0,626,12908,13534
2014-06-12 08:00:00-04:00,0,6,8,3,0,1389,23194,24583
2014-06-12 09:00:00-04:00,0.01,6,9,3,0,2276,27425,29701
2014-06-12 10:00:00-04:00,0,6,10,3,0,2175,26170,28345
2014-06-12 11:00:00-04:00,0,6,11,3,0,1987,24365,26352
2014-06-12 12:00:00-04:00,0,6,12,3,0,1762,23835,25597
2014-06-12 13:00:00-04:00,0,6,13,3,0,1743,24170,25913
2014-06-12 14:00:00-04:00,0,6,14,3,0,1853,23399,25252
2014-06-12 15:00:00-04:00,0,6,15,3,0,2045,24096,26141
2014-06-12 16:00:00-04:00,0,6,16,3,0,2314,21174,23488
2014-06-12 17:00:00-04:00,0,6,17,3,0,2513,16560,19073
2014-06-12 18:00:00-04:00,0,6,18,3,0,2656,22610,25266
2014-06-12 19:00:00-04:00,0,6,19,3,0,3085,29274,32359
2014-06-12 20:00:00-04:00,0,6,20,3,0,3035,32513,35548
2014-06-12 21:00:00-04:00,0,6,21,3,0,2667,30966,33633
2014-06-12 22:00:00-04:00,0,6,22,3,0,2621,30525,33146
2014-06-12 23:00:00-04:00,0,6,23,3,0,2523,29411,31934
2014-06-13 00:00:00-04:00,0.01,6,0,4,0,2329,27354,29683
2014-06-13 01:00:00-04:00,0.01,6,1,4,0,1896,22695,24591
2014-06-13 02:00:00-04:00,0.04,6,2,4,0,1362,14798,16160
2014-06-13 03:00:00-04:00,0.01,6,3,4,0,995,9723,10718
2014-06-13 04:00:00-04:00,0.03,6,4,4,0,652,6476,7128
2014-06-13 05:00:00-04:00,0.02,6,5,4,0,580,4938,5518
2014-06-13 06:00:00-04:00,0.01,6,6,4,0,468,5809,6277
2014-06-13 07:00:00-04:00,0,6,7,4,0,646,12768,13414
2014-06-13 08:00:00-04:00,0,6,8,4,0,1307,20756,22063
2014-06-13 09:00:00-04:00,0.48,6,9,4,0,2047,25810,27857
2014-06-13 10:00:00-04:00,0.12,6,10,4,0,2319,25979,28298
2014-06-13 11:00:00-04:00,0.02,6,11,4,0,1963,22975,24938
2014-06-13 12:00:00-04:00,0,6,12,4,0,1752,21886,23638
2014-06-13 13:00:00-04:00,0,6,13,4,0,1663,21811,23474
2014-06-13 14:00:00-04:00,0,6,14,4,0,1585,21583,23168
2014-06-13 15:00:00-04:00,0,6,15,4,0,1891,22798,24689
2014-06-13 16:00:00-04:00,0,6,16,4,0,2318,20872,23190
2014-06-13 17:00:00-04:00,0,6,17,4,0,2698,17158,19856
2014-06-13 18:00:00-04:00,0.59,6,18,4,0,3435,23364,26799
2014-06-13 19:00:00-04:00,0.16,6,19,4,0,4850,31393,36243
2014-06-13 20:00:00-04:00,0.06,6,20,4,0,4564,32766,37330
2014-06-13 21:00:00-04:00,0,6,21,4,0,3553,28101,31654
2014-06-13 22:00:00-04:00,0,6,22,4,0,3221,26426,29647
2014-06-13 23:00:00-04:00,0,6,23,4,0,3228,27497,30725
2014-06-14 00:00:00-04:00,0,6,0,5,0,3480,28134,31614
2014-06-14 01:00:00-04:00,0,6,1,5,0,3319,28581,31900
2014-06-14 02:00:00-04:00,0,6,2,5,0,2894,23698,26592
2014-06-14 03:00:00-04:00,0,6,3,5,0,2439,19055,21494
2014-06-14 04:00:00-04:00,0,6,4,5,0,2021,14161,16182
2014-06-14 05:00:00-04:00,0,6,5,5,0,1522,9267,10789
2014-06-14 06:00:00-04:00,0,6,6,5,0,838,4897,5735
2014-06-14 07:00:00-04:00,0,6,7,5,0,586,5910,6496
2014-06-14 08:00:00-04:00,0,6,8,5,0,702,8814,9516
2014-06-14 09:00:00-04:00,0,6,9,5,0,998,12254,13252
2014-06-14 10:00:00-04:00,0,6,10,5,0,1395,17436,18831
2014-06-14 11:00:00-04:00,0,6,11,5,0,1616,20505,22121
2014-06-14 12:00:00-04:00,0,6,12,5,0,1801,22499,24300
2014-06-14 13:00:00-04:00,0,6,13,5,0,2043,23328,25371
2014-06-14 14:00:00-04:00,0,6,14,5,0,2091,23031,25122
2014-06-14 15:00:00-04:00,0,6,15,5,0,2412,22144,24556
2014-06-14 16:00:00-04:00,0,6,16,5,0,2660,21910,24570
2014-06-14 17:00:00-04:00,0,6,17,5,0,2935,19794,22729
2014-06-14 18:00:00-04:00,0,6,18,5,0,3287,24342,27629
2014-06-14 19:00:00-04:00,0,6,19,5,0,3579,27619,31198
2014-06-14 20:00:00-04:00,0,6,20,5,0,3617,26975,30592
2014-06-14 21:00:00-04:00,0,6,21,5,0,3918,26453,30371
2014-06-14 22:00:00-04:00,0,6,22,5,0,3969,25960,29929
2014-06-14 23:00:00-04:00,0,6,23,5,0,3999,28854,32853
2014-06-15 00:00:00-04:00,0,6,0,6,0,4092,30124,34216
2014-06-15 01:00:00-04:00,0,6,1,6,0,3937,27784,31721
2014-06-15 02:00:00-04:00,0,6,2,6,0,3598,24610,28208
2014-06-15 03:00:00-04:00,0,6,3,6,0,3101,20834,23935
2014-06-15 04:00:00-04:00,0,6,4,6,0,2510,15290,17800
2014-06-15 05:00:00-04:00,0,6,5,6,0,1879,9590,11469
2014-06-15 06:00:00-04:00,0,6,6,6,0,917,4734,5651
2014-06-15 07:00:00-04:00,0,6,7,6,0,546,4572,5118
2014-06-15 08:00:00-04:00,0,6,8,6,0,552,6332,6884
2014-06-15 09:00:00-04:00,0,6,9,6,0,688,8753,9441
2014-06-15 10:00:00-04:00,0,6,10,6,0,975,12813,13788
2014-06-15 11:00:00-04:00,0,6,11,6,0,1316,17141,18457
2014-06-15 12:00:00-04:00,0,6,12,6,0,1558,19823,21381
2014-06-15 13:00:00-04:00,0,6,13,6,0,1799,20503,22302
2014-06-15 14:00:00-04:00,0,6,14,6,0,1734,20532,22266
2014-06-15 15:00:00-04:00,0,6,15,6,0,2133,21541,23674
2014-06-15 16:00:00-04:00,0,6,16,6,0,2308,19887,22195
2014-06-15 17:00:00-04:00,0,6,17,6,0,2436,18763,21199
2014-06-15 18:00:00-04:00,0,6,18,6,0,2547,20960,23507
2014-06-15 19:00:00-04:00,0,6,19,6,0,2591,22366,24957
2014-06-15 20:00:00-04:00,0,6,20,6,0,2551,21475,24026
2014-06-15 21:00:00-04:00,0,6,21,6,0,2485,20382,22867
2014-06-15 22:00:00-04:00,0,6,22,6,0,2607,20596,23203
2014-06-15 23:00:00-04:00,0,6,23,6,0,2371,19134,21505
2014-06-16 00:00:00-04:00,0,6,0,0,0,2258,16002,18260
2014-06-16 01:00:00-04:00,0,6,1,0,0,1635,9907,11542
2014-06-16 02:00:00-04:00,0,6,2,0,0,1136,5504,6640
2014-06-16 03:00:00-04:00,0,6,3,0,0,798,3845,4643
2014-06-16 04:00:00-04:00,0,6,4,0,0,549,2536,3085
2014-06-16 05:00:00-04:00,0,6,5,0,0,544,2878,3422
2014-06-16 06:00:00-04:00,0,6,6,0,0,436,4906,5342
2014-06-16 07:00:00-04:00,0,6,7,0,0,583,11872,12455
2014-06-16 08:00:00-04:00,0,6,8,0,0,1194,19275,20469
2014-06-16 09:00:00-04:00,0,6,9,0,0,1830,22829,24659
2014-06-16 10:00:00-04:00,0,6,10,0,0,1685,22287,23972
2014-06-16 11:00:00-04:00,0,6,11,0,0,1587,19595,21182
2014-06-16 12:00:00-04:00,0,6,12,0,0,1448,19582,21030
2014-06-16 13:00:00-04:00,0,6,13,0,0,1507,20602,22109
2014-06-16 14:00:00-04:00,0,6,14,0,0,1501,19904,21405
2014-06-16 15:00:00-04:00,0,6,15,0,0,1736,21701,23437
2014-06-16 16:00:00-04:00,0,6,16,0,0,1923,21015,22938
2014-06-16 17:00:00-04:00,0,6,17,0,0,2000,18644,20644
2014-06-16 18:00:00-04:00,0,6,18,0,0,2293,23490,25783
2014-06-16 19:00:00-04:00,0,6,19,0,0,2435,28266,30701
2014-06-16 20:00:00-04:00,0,6,20,0,0,2135,27043,29178
2014-06-16 21:00:00-04:00,0,6,21,0,0,2157,27745,29902
2014-06-16 22:00:00-04:00,0,6,22,0,0,2047,26961,29008
2014-06-16 23:00:00-04:00,0,6,23,0,0,1769,24435,26204
2014-06-17 00:00:00-04:00,0,6,0,1,0,1519,18353,19872
2014-06-17 01:00:00-04:00,0,6,1,1,0,1133,11809,12942
2014-06-17 02:00:00-04:00,0,6,2,1,0,713,6812,7525
2014-06-17 03:00:00-04:00,0,6,3,1,0,452,4130,4582
2014-06-17 04:00:00-04:00,0,6,4,1,0,347,2740,3087
2014-06-17 05:00:00-04:00,0,6,5,1,0,339,2765,3104
2014-06-17 06:00:00-04:00,0,6,6,1,0,316,4478,4794
2014-06-17 07:00:00-04:00,0,6,7,1,0,582,12177,12759
2014-06-17 08:00:00-04:00,0,6,8,1,0,1273,21066,22339
2014-06-17 09:00:00-04:00,0,6,9,1,0,1951,25242,27193
2014-06-17 10:00:00-04:00,0,6,10,1,0,1881,24065,25946
2014-06-17 11:00:00-04:00,0,6,11,1,0,1706,21868,23574
2014-06-17 12:00:00-04:00,0,6,12,1,0,1587,21912,23499
2014-06-17 13:00:00-04:00,0,6,13,1,0,1648,23088,24736
2014-06-17 14:00:00-04:00,0,6,14,1,0,1663,22614,24277
2014-06-17 15:00:00-04:00,0,6,15,1,0,1908,24466,26374
2014-06-17 16:00:00-04:00,0,6,16,1,0,2104,21974,24078
2014-06-17 17:00:00-04:00,0,6,17,1,0,2153,17085,19238
2014-06-17 18:00:00-04:00,0,6,18,1,0,2353,21351,23704
2014-06-17 19:00:00-04:00,0,6,19,1,0,2653,26991,29644
2014-06-17 20:00:00-04:00,0,6,20,1,0,2704,27501,30205
2014-06-17 21:00:00-04:00,0,6,21,1,0,2302,27380,29682
2014-06-17 22:00:00-04:00,0,6,22,1,0,2177,28275,30452
2014-06-17 23:00:00-04:00,0,6,23,1,0,2080,27339,29419
2014-06-18 00:00:00-04:00,0,6,0,2,0,1793,22240,24033
2014-06-18 01:00:00-04:00,0,6,1,2,0,1379,14523,15902
2014-06-18 02:00:00-04:00,0,6,2,2,0,876,8383,9259
2014-06-18 03:00:00-04:00,0,6,3,2,0,578,5159,5737
2014-06-18 04:00:00-04:00,0,6,4,2,0,398,3425,3823
2014-06-18 05:00:00-04:00,0,6,5,2,0,343,3116,3459
2014-06-18 06:00:00-04:00,0,6,6,2,0,348,4708,5056
2014-06-18 07:00:00-04:00,0,6,7,2,0,602,12602,13204
2014-06-18 08:00:00-04:00,0,6,8,2,0,1226,21728,22954
2014-06-18 09:00:00-04:00,0,6,9,2,0,2001,25130,27131
2014-06-18 10:00:00-04:00,0,6,10,2,0,1946,24377,26323
2014-06-18 11:00:00-04:00,0,6,11,2,0,1671,23051,24722
2014-06-18 12:00:00-04:00,0,6,12,2,0,1719,23444,25163
2014-06-18 13:00:00-04:00,0,6,13,2,0,1737,24190,25927
2014-06-18 14:00:00-04:00,0,6,14,2,0,1618,23092,24710
2014-06-18 15:00:00-04:00,0,6,15,2,0,1927,23630,25557
2014-06-18 16:00:00-04:00,0,6,16,2,0,2074,21516,23590
2014-06-18 17:00:00-04:00,0,6,17,2,0,2262,17758,20020
2014-06-18 18:00:00-04:00,0,6,18,2,0,2504,22209,24713
2014-06-18 19:00:00-04:00,0,6,19,2,0,2763,27768,30531
2014-06-18 20:00:00-04:00,0,6,20,2,0,2828,29968,32796
2014-06-18 21:00:00-04:00,0,6,21,2,0,2510,29050,31560
2014-06-18 22:00:00-04:00,0,6,22,2,0,2365,30030,32395
2014-06-18 23:00:00-04:00,0,6,23,2,0,2317,28782,31099
2014-06-19 00:00:00-04:00,0,6,0,3,0,2030,25028,27058
2014-06-19 01:00:00-04:00,0,6,1,3,0,1608,17274,18882
2014-06-19 02:00:00-04:00,0,6,2,3,0,1073,9808,10881
2014-06-19 03:00:00-04:00,0,6,3,3,0,663,5894,6557
2014-06-19 04:00:00-04:00,0,6,4,3,0,500,4012,4512
2014-06-19 05:00:00-04:00,0,6,5,3,0,474,3581,4055
2014-06-19 06:00:00-04:00,0,6,6,3,0,425,4934,5359
2014-06-19 07:00:00-04:00,0,6,7,3,0,694,12668,13362
2014-06-19 08:00:00-04:00,0,6,8,3,0,1404,22016,23420
2014-06-19 09:00:00-04:00,0,6,9,3,0,2224,26598,28822
2014-06-19 10:00:00-04:00,0,6,10,3,0,2066,25438,27504
2014-06-19 11:00:00-04:00,0,6,11,3,0,1797,22737,24534
2014-06-19 12:00:00-04:00,0,6,12,3,0,1857,23866,25723
2014-06-19 13:00:00-04:00,0,6,13,3,0,1741,24382,26123
2014-06-19 14:00:00-04:00,0,6,14,3,0,1750,23470,25220
2014-06-19 15:00:00-04:00,0,6,15,3,0,2103,24741,26844
2014-06-19 16:00:00-04:00,0,6,16,3,0,2123,20845,22968
2014-06-19 17:00:00-04:00,0,6,17,3,0,2224,16814,19038
2014-06-19 18:00:00-04:00,0,6,18,3,0,2595,20973,23568
2014-06-19 19:00:00-04:00,0,6,19,3,0,2812,27762,30574
2014-06-19 20:00:00-04:00,0,6,20,3,0,2772,30589,33361
2014-06-19 21:00:00-04:00,0,6,21,3,0,2750,31084,33834
2014-06-19 22:00:00-04:00,0,6,22,3,0,2857,30974,33831
2014-06-19 23:00:00-04:00,0,6,23,3,0,2591,29026,31617
2014-06-20 00:00:00-04:00,0,6,0,4,0,2357,27618,29975
2014-06-20 01:00:00-04:00,0,6,1,4,0,2023,22066,24089
2014-06-20 02:00:00-04:00,0,6,2,4,0,1522,14534,16056
2014-06-20 03:00:00-04:00,0,6,3,4,0,1026,9487,10513
2014-06-20 04:00:00-04:00,0,6,4,4,0,715,6227,6942
2014-06-20 05:00:00-04:00,0,6,5,4,0,624,4892,5516
2014-06-20 06:00:00-04:00,0,6,6,4,0,467,5554,6021
2014-06-20 07:00:00-04:00,0,6,7,4,0,645,12054,12699
2014-06-20 08:00:00-04:00,0,6,8,4,0,1213,19835,21048
2014-06-20 09:00:00-04:00,0,6,9,4,0,1984,24225,26209
2014-06-20 10:00:00-04:00,0,6,10,4,0,1962,23613,25575
2014-06-20 11:00:00-04:00,0,6,11,4,0,1722,21343,23065
2014-06-20 12:00:00-04:00,0,6,12,4,0,1721,21941,23662
2014-06-20 13:00:00-04:00,0,6,13,4,0,1591,22120,23711
2014-06-20 14:00:00-04:00,0,6,14,4,0,1573,21232,22805
2014-06-20 15:00:00-04:00,0,6,15,4,0,1917,22425,24342
2014-06-20 16:00:00-04:00,0,6,16,4,0,2216,20024,22240
2014-06-20 17:00:00-04:00,0,6,17,4,0,2630,16563,19193
2014-06-20 18:00:00-04:00,0,6,18,4,0,3032,21235,24267
2014-06-20 19:00:00-04:00,0,6,19,4,0,3388,27656,31044
2014-06-20 20:00:00-04:00,0,6,20,4,0,3490,30532,34022
2014-06-20 21:00:00-04:00,0,6,21,4,0,3343,28750,32093
2014-06-20 22:00:00-04:00,0,6,22,4,0,3460,28467,31927
2014-06-20 23:00:00-04:00,0,6,23,4,0,3598,29973,33571
2014-06-21 00:00:00-04:00,0,6,0,5,0,3749,30800,34549
2014-06-21 01:00:00-04:00,0,6,1,5,0,3610,28894,32504
2014-06-21 02:00:00-04:00,0,6,2,5,0,3108,25218,28326
2014-06-21 03:00:00-04:00,0,6,3,5,0,2749,20908,23657
2014-06-21 04:00:00-04:00,0,6,4,5,0,2120,15481,17601
2014-06-21 05:00:00-04:00,0,6,5,5,0,1623,9839,11462
2014-06-21 06:00:00-04:00,0,6,6,5,0,832,4870,5702
2014-06-21 07:00:00-04:00,0,6,7,5,0,574,5506,6080
2014-06-21 08:00:00-04:00,0,6,8,5,0,654,7514,8168
2014-06-21 09:00:00-04:00,0,6,9,5,0,922,11203,12125
2014-06-21 10:00:00-04:00,0,6,10,5,0,1234,15878,17112
2014-06-21 11:00:00-04:00,0,6,11,5,0,1503,18377,19880
2014-06-21 12:00:00-04:00,0,6,12,5,0,1687,20973,22660
2014-06-21 13:00:00-04:00,0,6,13,5,0,1823,21848,23671
2014-06-21 14:00:00-04:00,0,6,14,5,0,1888,22022,23910
2014-06-21 15:00:00-04:00,0,6,15,5,0,2184,21920,24104
2014-06-21 16:00:00-04:00,0,6,16,5,0,2492,20926,23418
2014-06-21 17:00:00-04:00,0,6,17,5,0,2610,18841,21451
2014-06-21 18:00:00-04:00,0,6,18,5,0,2954,22596,25550
2014-06-21 19:00:00-04:00,0,6,19,5,0,3219,25927,29146
2014-06-21 20:00:00-04:00,0,6,20,5,0,3412,27850,31262
2014-06-21 21:00:00-04:00,0,6,21,5,0,3365,24003,27368
2014-06-21 22:00:00-04:00,0,6,22,5,0,3707,24781,28488
2014-06-21 23:00:00-04:00,0,6,23,5,0,3850,27962,31812
2014-06-22 00:00:00-04:00,0,6,0,6,0,3947,30072,34019
2014-06-22 01:00:00-04:00,0,6,1,6,0,3784,28613,32397
2014-06-22 02:00:00-04:00,0,6,2,6,0,3443,25119,28562
2014-06-22 03:00:00-04:00,0,6,3,6,0,2990,21023,24013
2014-06-22 04:00:00-04:00,0,6,4,6,0,2467,15818,18285
2014-06-22 05:00:00-04:00,0,6,5,6,0,1834,10026,11860
2014-06-22 06:00:00-04:00,0,6,6,6,0,907,4965,5872
2014-06-22 07:00:00-04:00,0,6,7,6,0,612,4937,5549
2014-06-22 08:00:00-04:00,0,6,8,6,0,550,6055,6605
2014-06-22 09:00:00-04:00,0,6,9,6,0,700,8283,8983
2014-06-22 10:00:00-04:00,0,6,10,6,0,928,12446,13374
2014-06-22 11:00:00-04:00,0,6,11,6,0,1223,16658,17881
2014-06-22 12:00:00-04:00,0,6,12,6,0,1466,19840,21306
2014-06-22 13:00:00-04:00,0,6,13,6,0,1623,21026,22649
2014-06-22 14:00:00-04:00,0,6,14,6,0,1717,21745,23462
2014-06-22 15:00:00-04:00,0,6,15,6,0,1980,22127,24107
2014-06-22 16:00:00-04:00,0,6,16,6,0,2135,21283,23418
2014-06-22 17:00:00-04:00,0,6,17,6,0,2388,20588,22976
2014-06-22 18:00:00-04:00,0,6,18,6,0,2559,23754,26313
2014-06-22 19:00:00-04:00,0,6,19,6,0,2552,23135,25687
2014-06-22 20:00:00-04:00,0,6,20,6,0,2285,19456,21741
2014-06-22 21:00:00-04:00,0,6,21,6,0,2515,23749,26264
2014-06-22 22:00:00-04:00,0,6,22,6,0,2489,22225,24714
2014-06-22 23:00:00-04:00,0,6,23,6,0,2271,20789,23060
2014-06-23 00:00:00-04:00,0,6,0,0,0,2023,17097,19120
2014-06-23 01:00:00-04:00,0,6,1,0,0,1484,10590,12074
2014-06-23 02:00:00-04:00,0,6,2,0,0,1032,6550,7582
2014-06-23 03:00:00-04:00,0,6,3,0,0,661,4312,4973
2014-06-23 04:00:00-04:00,0,6,4,0,0,506,2822,3328
2014-06-23 05:00:00-04:00,0,6,5,0,0,493,3139,3632
2014-06-23 06:00:00-04:00,0,6,6,0,0,400,4924,5324
2014-06-23 07:00:00-04:00,0,6,7,0,0,577,12009,12586
2014-06-23 08:00:00-04:00,0,6,8,0,0,1200,18821,20021
2014-06-23 09:00:00-04:00,0,6,9,0,0,1846,22671,24517
2014-06-23 10:00:00-04:00,0,6,10,0,0,1801,21820,23621
2014-06-23 11:00:00-04:00,0,6,11,0,0,1609,19324,20933
2014-06-23 12:00:00-04:00,0,6,12,0,0,1468,19072,20540
2014-06-23 13:00:00-04:00,0,6,13,0,0,1443,19963,21406
2014-06-23 14:00:00-04:00,0,6,14,0,0,1438,20218,21656
2014-06-23 15:00:00-04:00,0,6,15,0,0,1634,21295,22929
2014-06-23 16:00:00-04:00,0,6,16,0,0,1882,20844,22726
2014-06-23 17:00:00-04:00,0,6,17,0,0,2014,18147,20161
2014-06-23 18:00:00-04:00,0,6,18,0,0,2112,21972,24084
2014-06-23 19:00:00-04:00,0,6,19,0,0,2328,26699,29027
2014-06-23 20:00:00-04:00,0,6,20,0,0,2353,27295,29648
2014-06-23 21:00:00-04:00,0,6,21,0,0,2132,25098,27230
2014-06-23 22:00:00-04:00,0,6,22,0,0,1982,25066,27048
2014-06-23 23:00:00-04:00,0,6,23,0,0,1734,22837,24571
2014-06-24 00:00:00-04:00,0,6,0,1,0,1468,17717,19185
2014-06-24 01:00:00-04:00,0,6,1,1,0,1186,11362,12548
2014-06-24 02:00:00-04:00,0,6,2,1,0,758,6655,7413
2014-06-24 03:00:00-04:00,0,6,3,1,0,487,4057,4544
2014-06-24 04:00:00-04:00,0,6,4,1,0,389,2688,3077
2014-06-24 05:00:00-04:00,0,6,5,1,0,363,2650,3013
2014-06-24 06:00:00-04:00,0,6,6,1,0,331,4570,4901
2014-06-24 07:00:00-04:00,0,6,7,1,0,549,11872,12421
2014-06-24 08:00:00-04:00,0,6,8,1,0,1112,19849,20961
2014-06-24 09:00:00-04:00,0,6,9,1,0,1895,24245,26140
2014-06-24 10:00:00-04:00,0,6,10,1,0,1848,23186,25034
2014-06-24 11:00:00-04:00,0,6,11,1,0,1711,20383,22094
2014-06-24 12:00:00-04:00,0,6,12,1,0,1697,20970,22667
2014-06-24 13:00:00-04:00,0,6,13,1,0,1540,21613,23153
2014-06-24 14:00:00-04:00,0,6,14,1,0,1520,21539,23059
2014-06-24 15:00:00-04:00,0,6,15,1,0,1754,22710,24464
2014-06-24 16:00:00-04:00,0,6,16,1,0,1921,21003,22924
2014-06-24 17:00:00-04:00,0,6,17,1,0,2065,17300,19365
2014-06-24 18:00:00-04:00,0,6,18,1,0,2180,21897,24077
2014-06-24 19:00:00-04:00,0,6,19,1,0,2441,27623,30064
2014-06-24 20:00:00-04:00,0,6,20,1,0,2409,29215,31624
2014-06-24 21:00:00-04:00,0,6,21,1,0,2212,28252,30464
2014-06-24 22:00:00-04:00,0,6,22,1,0,2255,28453,30708
2014-06-24 23:00:00-04:00,0,6,23,1,0,1994,27021,29015
2014-06-25 00:00:00-04:00,0,6,0,2,0,1716,22765,24481
2014-06-25 01:00:00-04:00,0,6,1,2,0,1458,14737,16195
2014-06-25 02:00:00-04:00,0,6,2,2,0,891,8649,9540
2014-06-25 03:00:00-04:00,0,6,3,2,0,571,5167,5738
2014-06-25 04:00:00-04:00,0,6,4,2,0,401,3469,3870
2014-06-25 05:00:00-04:00,0,6,5,2,0,423,3213,3636
2014-06-25 06:00:00-04:00,0,6,6,2,0,324,4663,4987
2014-06-25 07:00:00-04:00,0,6,7,2,0,599,12477,13076
2014-06-25 08:00:00-04:00,0,6,8,2,0,1174,21214,22388
2014-06-25 09:00:00-04:00,0,6,9,2,0,1995,25962,27957
2014-06-25 10:00:00-04:00,0,6,10,2,0,2010,24905,26915
2014-06-25 11:00:00-04:00,0,6,11,2,0,1774,22516,24290
2014-06-25 12:00:00-04:00,0,6,12,2,0,1744,22763,24507
2014-06-25 13:00:00-04:00,0,6,13,2,0,1621,23140,24761
2014-06-25 14:00:00-04:00,0,6,14,2,0,1682,23050,24732
2014-06-25 15:00:00-04:00,0,6,15,2,0,1887,23039,24926
2014-06-25 16:00:00-04:00,0,6,16,2,0,2192,20652,22844
2014-06-25 17:00:00-04:00,0,6,17,2,0,2344,16746,19090
2014-06-25 18:00:00-04:00,0,6,18,2,0,2583,21153,23736
2014-06-25 19:00:00-04:00,0,6,19,2,0,2949,27860,30809
2014-06-25 20:00:00-04:00,0,6,20,2,0,3163,32042,35205
2014-06-25 21:00:00-04:00,0,6,21,2,0,2605,28503,31108
2014-06-25 22:00:00-04:00,0,6,22,2,0,2508,29061,31569
2014-06-25 23:00:00-04:00,0,6,23,2,0,2209,27825,30034
2014-06-26 00:00:00-04:00,0,6,0,3,0,1935,25283,27218
2014-06-26 01:00:00-04:00,0.03,6,1,3,0,1877,19407,21284
2014-06-26 02:00:00-04:00,0.03,6,2,3,0,1178,11331,12509
2014-06-26 03:00:00-04:00,0.01,6,3,3,0,723,7018,7741
2014-06-26 04:00:00-04:00,0,6,4,3,0,509,3897,4406
2014-06-26 05:00:00-04:00,0,6,5,3,0,458,3526,3984
2014-06-26 06:00:00-04:00,0,6,6,3,0,390,5045,5435
2014-06-26 07:00:00-04:00,0,6,7,3,0,623,12579,13202
2014-06-26 08:00:00-04:00,0,6,8,3,0,1228,21054,22282
2014-06-26 09:00:00-04:00,0,6,9,3,0,2030,25692,27722
2014-06-26 10:00:00-04:00,0,6,10,3,0,2027,24504,26531
2014-06-26 11:00:00-04:00,0,6,11,3,0,1866,22905,24771
2014-06-26 12:00:00-04:00,0,6,12,3,0,1886,24592,26478
2014-06-26 13:00:00-04:00,0,6,13,3,0,1889,24061,25950
2014-06-26 14:00:00-04:00,0,6,14,3,0,1715,22492,24207
2014-06-26 15:00:00-04:00,0,6,15,3,0,2001,24145,26146
2014-06-26 16:00:00-04:00,0,6,16,3,0,2246,20686,22932
2014-06-26 17:00:00-04:00,0,6,17,3,0,2408,16404,18812
2014-06-26 18:00:00-04:00,0,6,18,3,0,2622,21210,23832
2014-06-26 19:00:00-04:00,0,6,19,3,0,2968,27968,30936
2014-06-26 20:00:00-04:00,0,6,20,3,0,2979,30692,33671
2014-06-26 21:00:00-04:00,0,6,21,3,0,2622,29720,32342
2014-06-26 22:00:00-04:00,0,6,22,3,0,2720,30455,33175
2014-06-26 23:00:00-04:00,0,6,23,3,0,2475,29523,31998
2014-06-27 00:00:00-04:00,0,6,0,4,0,2360,27978,30338
2014-06-27 01:00:00-04:00,0,6,1,4,0,2083,22808,24891
2014-06-27 02:00:00-04:00,0,6,2,4,0,1455,15279,16734
2014-06-27 03:00:00-04:00,0,6,3,4,0,958,9968,10926
2014-06-27 04:00:00-04:00,0,6,4,4,0,662,6703,7365
2014-06-27 05:00:00-04:00,0,6,5,4,0,560,5069,5629
2014-06-27 06:00:00-04:00,0,6,6,4,0,475,5443,5918
2014-06-27 07:00:00-04:00,0,6,7,4,0,609,11776,12385
2014-06-27 08:00:00-04:00,0,6,8,4,0,1072,18951,20023
2014-06-27 09:00:00-04:00,0,6,9,4,0,1765,23810,25575
2014-06-27 10:00:00-04:00,0,6,10,4,0,2008,23238,25246
2014-06-27 11:00:00-04:00,0,6,11,4,0,1692,21112,22804
2014-06-27 12:00:00-04:00,0,6,12,4,0,1712,21195,22907
2014-06-27 13:00:00-04:00,0,6,13,4,0,1652,21038,22690
2014-06-27 14:00:00-04:00,0,6,14,4,0,1612,20532,22144
2014-06-27 15:00:00-04:00,0,6,15,4,0,1807,21465,23272
2014-06-27 16:00:00-04:00,0,6,16,4,0,2135,18890,21025
2014-06-27 17:00:00-04:00,0,6,17,4,0,2562,15545,18107
2014-06-27 18:00:00-04:00,0,6,18,4,0,2815,20331,23146
2014-06-27 19:00:00-04:00,0,6,19,4,0,3312,26347,29659
2014-06-27 20:00:00-04:00,0,6,20,4,0,3500,29474,32974
2014-06-27 21:00:00-04:00,0,6,21,4,0,3241,27122,30363
2014-06-27 22:00:00-04:00,0,6,22,4,0,3380,27685,31065
2014-06-27 23:00:00-04:00,0,6,23,4,0,3488,29534,33022
2014-06-28 00:00:00-04:00,0,6,0,5,0,3624,30843,34467
2014-06-28 01:00:00-04:00,0,6,1,5,0,3534,28526,32060
2014-06-28 02:00:00-04:00,0,6,2,5,0,3141,24989,28130
2014-06-28 03:00:00-04:00,0,6,3,5,0,2504,21438,23942
2014-06-28 04:00:00-04:00,0,6,4,5,0,1985,15865,17850
2014-06-28 05:00:00-04:00,0,6,5,5,0,1532,10035,11567
2014-06-28 06:00:00-04:00,0,6,6,5,0,810,5070,5880
2014-06-28 07:00:00-04:00,0,6,7,5,0,568,5683,6251
2014-06-28 08:00:00-04:00,0,6,8,5,0,658,8088,8746
2014-06-28 09:00:00-04:00,0,6,9,5,0,950,11167,12117
2014-06-28 10:00:00-04:00,0,6,10,5,0,1299,15105,16404
2014-06-28 11:00:00-04:00,0,6,11,5,0,1585,18530,20115
2014-06-28 12:00:00-04:00,0,6,12,5,0,1766,21674,23440
2014-06-28 13:00:00-04:00,0,6,13,5,0,1833,22081,23914
2014-06-28 14:00:00-04:00,0,6,14,5,0,2006,21595,23601
2014-06-28 15:00:00-04:00,0,6,15,5,0,2136,20911,23047
2014-06-28 16:00:00-04:00,0,6,16,5,0,2857,22963,25820
2014-06-28 17:00:00-04:00,0,6,17,5,0,2986,19605,22591
2014-06-28 18:00:00-04:00,0,6,18,5,0,3075,21777,24852
2014-06-28 19:00:00-04:00,0,6,19,5,0,3400,24897,28297
2014-06-28 20:00:00-04:00,0,6,20,5,0,3632,26859,30491
2014-06-28 21:00:00-04:00,0,6,21,5,0,3470,23152,26622
2014-06-28 22:00:00-04:00,0,6,22,5,0,3616,24574,28190
2014-06-28 23:00:00-04:00,0,6,23,5,0,3679,27586,31265
2014-06-29 00:00:00-04:00,0,6,0,6,0,3687,29845,33532
2014-06-29 01:00:00-04:00,0,6,1,6,0,3801,28504,32305
2014-06-29 02:00:00-04:00,0,6,2,6,0,3488,25416,28904
2014-06-29 03:00:00-04:00,0,6,3,6,0,2687,20424,23111
2014-06-29 04:00:00-04:00,0,6,4,6,0,1798,15059,16857
2014-06-29 05:00:00-04:00,0,6,5,6,0,1649,10594,12243
2014-06-29 06:00:00-04:00,0,6,6,6,0,942,5383,6325
2014-06-29 07:00:00-04:00,0,6,7,6,0,582,5134,5716
2014-06-29 08:00:00-04:00,0,6,8,6,0,498,6337,6835
2014-06-29 09:00:00-04:00,0,6,9,6,0,656,9393,10049
2014-06-29 10:00:00-04:00,0,6,10,6,0,1000,13302,14302
2014-06-29 11:00:00-04:00,0,6,11,6,0,1376,17043,18419
2014-06-29 12:00:00-04:00,0,6,12,6,0,1708,19908,21616
2014-06-29 13:00:00-04:00,0,6,13,6,0,1745,19560,21305
2014-06-29 14:00:00-04:00,0,6,14,6,0,1736,18608,20344
2014-06-29 15:00:00-04:00,0,6,15,6,0,2267,19469,21736
2014-06-29 16:00:00-04:00,0,6,16,6,0,2548,18021,20569
2014-06-29 17:00:00-04:00,0,6,17,6,0,2561,16277,18838
2014-06-29 18:00:00-04:00,0,6,18,6,0,2494,17724,20218
2014-06-29 19:00:00-04:00,0,6,19,6,0,2430,19511,21941
2014-06-29 20:00:00-04:00,0,6,20,6,0,2526,21571,24097
2014-06-29 21:00:00-04:00,0,6,21,6,0,1791,18362,20153
2014-06-29 22:00:00-04:00,0,6,22,6,0,1865,20262,22127
2014-06-29 23:00:00-04:00,0,6,23,6,0,1992,19365,21357
2014-06-30 00:00:00-04:00,0,6,0,0,0,1988,17469,19457
2014-06-30 01:00:00-04:00,0,6,1,0,0,1694,12017,13711
2014-06-30 02:00:00-04:00,0,6,2,0,0,1192,7643,8835
2014-06-30 03:00:00-04:00,0,6,3,0,0,686,4929,5615
2014-06-30 04:00:00-04:00,0,6,4,0,0,435,3609,4044
2014-06-30 05:00:00-04:00,0,6,5,0,0,523,3607,4130
2014-06-30 06:00:00-04:00,0,6,6,0,0,500,4918,5418
2014-06-30 07:00:00-04:00,0,6,7,0,0,625,11424,12049
2014-06-30 08:00:00-04:00,0,6,8,0,0,1003,18048,19051
2014-06-30 09:00:00-04:00,0,6,9,0,0,1738,21930,23668
2014-06-30 10:00:00-04:00,0,6,10,0,0,1792,22201,23993
2014-06-30 11:00:00-04:00,0,6,11,0,0,1553,19366,20919
2014-06-30 12:00:00-04:00,0,6,12,0,0,1501,19183,20684
2014-06-30 13:00:00-04:00,0,6,13,0,0,1495,20045,21540
2014-06-30 14:00:00-04:00,0,6,14,0,0,1495,19845,21340
2014-06-30 15:00:00-04:00,0,6,15,0,0,1737,20845,22582
2014-06-30 16:00:00-04:00,0,6,16,0,0,1905,19956,21861
2014-06-30 17:00:00-04:00,0,6,17,0,0,1999,17605,19604
2014-06-30 18:00:00-04:00,0,6,18,0,0,2120,20814,22934
2014-06-30 19:00:00-04:00,0,6,19,0,0,2365,25995,28360
2014-06-30 20:00:00-04:00,0,6,20,0,0,2244,27288,29532
2014-06-30 21:00:00-04:00,0,6,21,0,0,1698,22985,24683
2014-06-30 22:00:00-04:00,0,6,22,0,0,1610,24925,26535
2014-06-30 23:00:00-04:00,0,6,23,0,0,1601,22761,24362
2014-07-01 00:00:00-04:00,0,7,0,1,0,1503,17562,19065
2014-07-01 01:00:00-04:00,0,7,1,1,0,1273,11259,12532
2014-07-01 02:00:00-04:00,0,7,2,1,0,903,6480,7383
2014-07-01 03:00:00-04:00,0,7,3,1,0,533,4183,4716
2014-07-01 04:00:00-04:00,0,7,4,1,0,311,2705,3016
2014-07-01 05:00:00-04:00,0,7,5,1,0,359,2650,3009
2014-07-01 06:00:00-04:00,0,7,6,1,0,430,4275,4705
2014-07-01 07:00:00-04:00,0,7,7,1,0,639,11181,11820
2014-07-01 08:00:00-04:00,0,7,8,1,0,1096,18749,19845
2014-07-01 09:00:00-04:00,0,7,9,1,0,1841,23584,25425
2014-07-01 10:00:00-04:00,0,7,10,1,0,1969,24382,26351
2014-07-01 11:00:00-04:00,0,7,11,1,0,1845,22363,24208
2014-07-01 12:00:00-04:00,0,7,12,1,0,1762,21399,23161
2014-07-01 13:00:00-04:00,0,7,13,1,0,1796,22456,24252
2014-07-01 14:00:00-04:00,0,7,14,1,0,1741,22425,24166
2014-07-01 15:00:00-04:00,0,7,15,1,0,1999,23756,25755
2014-07-01 16:00:00-04:00,0,7,16,1,0,2307,22236,24543
2014-07-01 17:00:00-04:00,0,7,17,1,0,2409,18414,20823
2014-07-01 18:00:00-04:00,0,7,18,1,0,2320,21865,24185
2014-07-01 19:00:00-04:00,0,7,19,1,0,2668,29814,32482
2014-07-01 20:00:00-04:00,0,7,20,1,0,2523,30320,32843
2014-07-01 21:00:00-04:00,0,7,21,1,0,1940,25821,27761
2014-07-01 22:00:00-04:00,0,7,22,1,0,1894,27968,29862
2014-07-01 23:00:00-04:00,0,7,23,1,0,1943,26277,28220
2014-07-02 00:00:00-04:00,0,7,0,2,0,1721,21181,22902
2014-07-02 01:00:00-04:00,0,7,1,2,0,1451,13730,15181
2014-07-02 02:00:00-04:00,0,7,2,2,0,1085,8117,9202
2014-07-02 03:00:00-04:00,0,7,3,2,0,588,5052,5640
2014-07-02 04:00:00-04:00,0,7,4,2,0,332,3415,3747
2014-07-02 05:00:00-04:00,0,7,5,2,0,395,3072,3467
2014-07-02 06:00:00-04:00,0,7,6,2,0,431,4587,5018
2014-07-02 07:00:00-04:00,0,7,7,2,0,672,11409,12081
2014-07-02 08:00:00-04:00,0,7,8,2,0,1162,19211,20373
2014-07-02 09:00:00-04:00,0,7,9,2,0,1934,24394,26328
2014-07-02 10:00:00-04:00,0,7,10,2,0,1825,23714,25539
2014-07-02 11:00:00-04:00,0,7,11,2,0,1810,21266,23076
2014-07-02 12:00:00-04:00,0,7,12,2,0,1757,21539,23296
2014-07-02 13:00:00-04:00,0,7,13,2,0,1785,22903,24688
2014-07-02 14:00:00-04:00,0,7,14,2,0,1894,22758,24652
2014-07-02 15:00:00-04:00,0,7,15,2,0,1975,22297,24272
2014-07-02 16:00:00-04:00,0,7,16,2,0,2249,20651,22900
2014-07-02 17:00:00-04:00,0,7,17,2,0,2429,16943,19372
2014-07-02 18:00:00-04:00,0.17,7,18,2,0,3013,23354,26367
2014-07-02 19:00:00-04:00,0.08,7,19,2,0,3814,28380,32194
2014-07-02 20:00:00-04:00,0.29,7,20,2,0,3473,30014,33487
2014-07-02 21:00:00-04:00,0.03,7,21,2,0,2430,23862,26292
2014-07-02 22:00:00-04:00,0.06,7,22,2,0,2183,25586,27769
2014-07-02 23:00:00-04:00,0,7,23,2,0,2093,24070,26163
2014-07-03 00:00:00-04:00,0,7,0,3,0,1744,19099,20843
2014-07-03 01:00:00-04:00,0,7,1,3,0,1494,13531,15025
2014-07-03 02:00:00-04:00,0,7,2,3,0,1009,8996,10005
2014-07-03 03:00:00-04:00,0,7,3,3,0,632,6110,6742
2014-07-03 04:00:00-04:00,0,7,4,3,0,365,3804,4169
2014-07-03 05:00:00-04:00,0.02,7,5,3,0,406,3677,4083
2014-07-03 06:00:00-04:00,0,7,6,3,0,435,4739,5174
2014-07-03 07:00:00-04:00,0,7,7,3,0,659,10509,11168
2014-07-03 08:00:00-04:00,0,7,8,3,0,1084,16863,17947
2014-07-03 09:00:00-04:00,0,7,9,3,0,1810,21850,23660
2014-07-03 10:00:00-04:00,0,7,10,3,0,2045,21666,23711
2014-07-03 11:00:00-04:00,0,7,11,3,0,1944,19395,21339
2014-07-03 12:00:00-04:00,0,7,12,3,0,1869,19426,21295
2014-07-03 13:00:00-04:00,0,7,13,3,0,2016,21521,23537
2014-07-03 14:00:00-04:00,0,7,14,3,0,2051,22681,24732
2014-07-03 15:00:00-04:00,0,7,15,3,0,2365,22583,24948
2014-07-03 16:00:00-04:00,0,7,16,3,0,2725,20519,23244
2014-07-03 17:00:00-04:00,0,7,17,3,0,2947,16728,19675
2014-07-03 18:00:00-04:00,0,7,18,3,0,3058,21204,24262
2014-07-03 19:00:00-04:00,0.02,7,19,3,0,3227,25080,28307
2014-07-03 20:00:00-04:00,0.42,7,20,3,0,3574,29463,33037
2014-07-03 21:00:00-04:00,0.27,7,21,3,0,2880,25691,28571
2014-07-03 22:00:00-04:00,0,7,22,3,0,2659,24050,26709
2014-07-03 23:00:00-04:00,0,7,23,3,0,2398,19084,21482
2014-07-04 00:00:00-04:00,0,7,0,4,1,2445,18290,20735
2014-07-04 01:00:00-04:00,0,7,1,4,1,2172,16936,19108
2014-07-04 02:00:00-04:00,0,7,2,4,1,1831,13735,15566
2014-07-04 03:00:00-04:00,0,7,3,4,1,1263,10784,12047
2014-07-04 04:00:00-04:00,0,7,4,4,1,791,7960,8751
2014-07-04 05:00:00-04:00,0,7,5,4,1,781,5887,6668
2014-07-04 06:00:00-04:00,0,7,6,4,1,635,3903,4538
2014-07-04 07:00:00-04:00,0,7,7,4,1,528,4810,5338
2014-07-04 08:00:00-04:00,0,7,8,4,1,553,5833,6386
2014-07-04 09:00:00-04:00,0,7,9,4,1,633,6605,7238
2014-07-04 10:00:00-04:00,0,7,10,4,1,858,8833,9691
2014-07-04 11:00:00-04:00,0,7,11,4,1,1043,10602,11645
2014-07-04 12:00:00-04:00,0.02,7,12,4,1,1332,13870,15202
2014-07-04 13:00:00-04:00,0.02,7,13,4,1,1572,15458,17030
2014-07-04 14:00:00-04:00,0,7,14,4,1,1681,16806,18487
2014-07-04 15:00:00-04:00,0.12,7,15,4,1,2174,20443,22617
2014-07-04 16:00:00-04:00,0,7,16,4,1,2927,18267,21194
2014-07-04 17:00:00-04:00,0,7,17,4,1,2723,15629,18352
2014-07-04 18:00:00-04:00,0,7,18,4,1,2080,13228,15308
2014-07-04 19:00:00-04:00,0,7,19,4,1,2817,16755,19572
2014-07-04 20:00:00-04:00,0,7,20,4,1,2689,15988,18677
2014-07-04 21:00:00-04:00,0,7,21,4,1,2190,15408,17598
2014-07-04 22:00:00-04:00,0,7,22,4,1,2241,15228,17469
2014-07-04 23:00:00-04:00,0,7,23,4,1,2824,17306,20130
2014-07-05 00:00:00-04:00,0,7,0,5,0,3253,19378,22631
2014-07-05 01:00:00-04:00,0,7,1,5,0,3382,18453,21835
2014-07-05 02:00:00-04:00,0,7,2,5,0,3153,14965,18118
2014-07-05 03:00:00-04:00,0,7,3,5,0,2402,11222,13624
2014-07-05 04:00:00-04:00,0,7,4,5,0,1566,8517,10083
2014-07-05 05:00:00-04:00,0,7,5,5,0,1355,6094,7449
2014-07-05 06:00:00-04:00,0,7,6,5,0,722,3241,3963
2014-07-05 07:00:00-04:00,0,7,7,5,0,531,3525,4056
2014-07-05 08:00:00-04:00,0,7,8,5,0,560,4867,5427
2014-07-05 09:00:00-04:00,0,7,9,5,0,758,6433,7191
2014-07-05 10:00:00-04:00,0,7,10,5,0,985,9577,10562
2014-07-05 11:00:00-04:00,0,7,11,5,0,1250,12223,13473
2014-07-05 12:00:00-04:00,0,7,12,5,0,1555,13861,15416
2014-07-05 13:00:00-04:00,0,7,13,5,0,1573,14291,15864
2014-07-05 14:00:00-04:00,0,7,14,5,0,1720,14735,16455
2014-07-05 15:00:00-04:00,0,7,15,5,0,2032,15220,17252
2014-07-05 16:00:00-04:00,0,7,16,5,0,2304,15448,17752
2014-07-05 17:00:00-04:00,0,7,17,5,0,2467,15013,17480
2014-07-05 18:00:00-04:00,0,7,18,5,0,2432,15789,18221
2014-07-05 19:00:00-04:00,0,7,19,5,0,2712,17023,19735
2014-07-05 20:00:00-04:00,0,7,20,5,0,2758,18919,21677
2014-07-05 21:00:00-04:00,0,7,21,5,0,2321,15662,17983
2014-07-05 22:00:00-04:00,0,7,22,5,0,2557,16772,19329
2014-07-05 23:00:00-04:00,0,7,23,5,0,2836,18211,21047
2014-07-06 00:00:00-04:00,0,7,0,6,0,2996,18243,21239
2014-07-06 01:00:00-04:00,0,7,1,6,0,3153,16416,19569
2014-07-06 02:00:00-04:00,0,7,2,6,0,2757,14004,16761
2014-07-06 03:00:00-04:00,0,7,3,6,0,2133,11406,13539
2014-07-06 04:00:00-04:00,0,7,4,6,0,1501,9336,10837
2014-07-06 05:00:00-04:00,0,7,5,6,0,1348,6865,8213
2014-07-06 06:00:00-04:00,0,7,6,6,0,744,3356,4100
2014-07-06 07:00:00-04:00,0,7,7,6,0,529,3361,3890
2014-07-06 08:00:00-04:00,0,7,8,6,0,469,4495,4964
2014-07-06 09:00:00-04:00,0,7,9,6,0,569,5834,6403
2014-07-06 10:00:00-04:00,0,7,10,6,0,836,8587,9423
2014-07-06 11:00:00-04:00,0,7,11,6,0,1109,11740,12849
2014-07-06 12:00:00-04:00,0,7,12,6,0,1359,13916,15275
2014-07-06 13:00:00-04:00,0,7,13,6,0,1539,15491,17030
2014-07-06 14:00:00-04:00,0,7,14,6,0,1661,16531,18192
2014-07-06 15:00:00-04:00,0,7,15,6,0,2049,17801,19850
2014-07-06 16:00:00-04:00,0,7,16,6,0,2197,16863,19060
2014-07-06 17:00:00-04:00,0,7,17,6,0,2323,16178,18501
2014-07-06 18:00:00-04:00,0,7,18,6,0,2413,18167,20580
2014-07-06 19:00:00-04:00,0,7,19,6,0,2341,18970,21311
2014-07-06 20:00:00-04:00,0,7,20,6,0,2219,18599,20818
2014-07-06 21:00:00-04:00,0,7,21,6,0,1725,16533,18258
2014-07-06 22:00:00-04:00,0,7,22,6,0,1844,18515,20359
2014-07-06 23:00:00-04:00,0,7,23,6,0,1854,16378,18232
2014-07-07 00:00:00-04:00,0,7,0,0,0,1731,14202,15933
2014-07-07 01:00:00-04:00,0,7,1,0,0,1450,9362,10812
2014-07-07 02:00:00-04:00,0,7,2,0,0,942,5196,6138
2014-07-07 03:00:00-04:00,0,7,3,0,0,601,3377,3978
2014-07-07 04:00:00-04:00,0,7,4,0,0,393,2340,2733
2014-07-07 05:00:00-04:00,0,7,5,0,0,456,2713,3169
2014-07-07 06:00:00-04:00,0,7,6,0,0,462,4276,4738
2014-07-07 07:00:00-04:00,0,7,7,0,0,618,10713,11331
2014-07-07 08:00:00-04:00,0,7,8,0,0,1090,17442,18532
2014-07-07 09:00:00-04:00,0,7,9,0,0,1834,22080,23914
2014-07-07 10:00:00-04:00,0,7,10,0,0,1908,20965,22873
2014-07-07 11:00:00-04:00,0,7,11,0,0,1639,17272,18911
2014-07-07 12:00:00-04:00,0,7,12,0,0,1470,17295,18765
2014-07-07 13:00:00-04:00,0,7,13,0,0,1471,18187,19658
2014-07-07 14:00:00-04:00,0,7,14,0,0,1526,18849,20375
2014-07-07 15:00:00-04:00,0,7,15,0,0,1712,19621,21333
2014-07-07 16:00:00-04:00,0,7,16,0,0,1854,19289,21143
2014-07-07 17:00:00-04:00,0,7,17,0,0,2105,17945,20050
2014-07-07 18:00:00-04:00,0,7,18,0,0,2179,21247,23426
2014-07-07 19:00:00-04:00,0,7,19,0,0,2311,25591,27902
2014-07-07 20:00:00-04:00,0,7,20,0,0,2053,24875,26928
2014-07-07 21:00:00-04:00,0,7,21,0,0,1580,21650,23230
2014-07-07 22:00:00-04:00,0,7,22,0,0,1552,22654,24206
2014-07-07 23:00:00-04:00,0,7,23,0,0,1544,19988,21532
2014-07-08 00:00:00-04:00,0,7,0,1,0,1413,15524,16937
2014-07-08 01:00:00-04:00,0.16,7,1,1,0,1220,10237,11457
2014-07-08 02:00:00-04:00,0.02,7,2,1,0,1019,7259,8278
2014-07-08 03:00:00-04:00,0,7,3,1,0,503,3596,4099
2014-07-08 04:00:00-04:00,0,7,4,1,0,280,2514,2794
2014-07-08 05:00:00-04:00,0,7,5,1,0,336,2534,2870
2014-07-08 06:00:00-04:00,0,7,6,1,0,329,4220,4549
2014-07-08 07:00:00-04:00,0,7,7,1,0,577,11310,11887
2014-07-08 08:00:00-04:00,0,7,8,1,0,1015,18886,19901
2014-07-08 09:00:00-04:00,0,7,9,1,0,1748,23888,25636
2014-07-08 10:00:00-04:00,0,7,10,1,0,1808,23930,25738
2014-07-08 11:00:00-04:00,0,7,11,1,0,1614,20436,22050
2014-07-08 12:00:00-04:00,0,7,12,1,0,1547,20276,21823
2014-07-08 13:00:00-04:00,0,7,13,1,0,1670,21568,23238
2014-07-08 14:00:00-04:00,0,7,14,1,0,1685,21715,23400
2014-07-08 15:00:00-04:00,0,7,15,1,0,1854,22401,24255
2014-07-08 16:00:00-04:00,0,7,16,1,0,2052,21935,23987
2014-07-08 17:00:00-04:00,0,7,17,1,0,2061,18650,20711
2014-07-08 18:00:00-04:00,0,7,18,1,0,2147,22871,25018
2014-07-08 19:00:00-04:00,0,7,19,1,0,2493,28919,31412
2014-07-08 20:00:00-04:00,0,7,20,1,0,2321,29594,31915
2014-07-08 21:00:00-04:00,0,7,21,1,0,1858,25059,26917
2014-07-08 22:00:00-04:00,0,7,22,1,0,1775,26523,28298
2014-07-08 23:00:00-04:00,0,7,23,1,0,2193,27275,29468
2014-07-09 00:00:00-04:00,0,7,0,2,0,1702,19260,20962
2014-07-09 01:00:00-04:00,0,7,1,2,0,1411,12649,14060
2014-07-09 02:00:00-04:00,0,7,2,2,0,899,7996,8895
2014-07-09 03:00:00-04:00,0,7,3,2,0,529,4862,5391
2014-07-09 04:00:00-04:00,0,7,4,2,0,332,3084,3416
2014-07-09 05:00:00-04:00,0,7,5,2,0,360,2857,3217
2014-07-09 06:00:00-04:00,0,7,6,2,0,383,4182,4565
2014-07-09 07:00:00-04:00,0,7,7,2,0,581,11234,11815
2014-07-09 08:00:00-04:00,0,7,8,2,0,1095,19432,20527
2014-07-09 09:00:00-04:00,0,7,9,2,0,1862,24363,26225
2014-07-09 10:00:00-04:00,0,7,10,2,0,1872,24093,25965
2014-07-09 11:00:00-04:00,0,7,11,2,0,1642,21011,22653
2014-07-09 12:00:00-04:00,0,7,12,2,0,1564,20693,22257
2014-07-09 13:00:00-04:00,0,7,13,2,0,1625,21823,23448
2014-07-09 14:00:00-04:00,0,7,14,2,0,1615,21757,23372
2014-07-09 15:00:00-04:00,0,7,15,2,0,1761,22028,23789
2014-07-09 16:00:00-04:00,0,7,16,2,0,2091,21184,23275
2014-07-09 17:00:00-04:00,0,7,17,2,0,2057,18330,20387
2014-07-09 18:00:00-04:00,0,7,18,2,0,2244,21957,24201
2014-07-09 19:00:00-04:00,0,7,19,2,0,2405,27893,30298
2014-07-09 20:00:00-04:00,0,7,20,2,0,2453,30864,33317
2014-07-09 21:00:00-04:00,0,7,21,2,0,1963,26983,28946
2014-07-09 22:00:00-04:00,0,7,22,2,0,1975,28105,30080
2014-07-09 23:00:00-04:00,0,7,23,2,0,1979,27539,29518
2014-07-10 00:00:00-04:00,0,7,0,3,0,1847,23660,25507
2014-07-10 01:00:00-04:00,0,7,1,3,0,1604,15422,17026
2014-07-10 02:00:00-04:00,0,7,2,3,0,1194,9155,10349
2014-07-10 03:00:00-04:00,0,7,3,3,0,655,5594,6249
2014-07-10 04:00:00-04:00,0,7,4,3,0,360,3759,4119
2014-07-10 05:00:00-04:00,0,7,5,3,0,398,3259,3657
2014-07-10 06:00:00-04:00,0,7,6,3,0,372,4477,4849
2014-07-10 07:00:00-04:00,0,7,7,3,0,587,11436,12023
2014-07-10 08:00:00-04:00,0,7,8,3,0,1167,19719,20886
2014-07-10 09:00:00-04:00,0,7,9,3,0,1866,24899,26765
2014-07-10 10:00:00-04:00,0,7,10,3,0,1920,23962,25882
2014-07-10 11:00:00-04:00,0,7,11,3,0,1714,20631,22345
2014-07-10 12:00:00-04:00,0,7,12,3,0,1563,20591,22154
2014-07-10 13:00:00-04:00,0,7,13,3,0,1612,21491,23103
2014-07-10 14:00:00-04:00,0,7,14,3,0,1637,21112,22749
2014-07-10 15:00:00-04:00,0,7,15,3,0,1878,21829,23707
2014-07-10 16:00:00-04:00,0,7,16,3,0,2016,20410,22426
2014-07-10 17:00:00-04:00,0,7,17,3,0,2266,16961,19227
2014-07-10 18:00:00-04:00,0,7,18,3,0,2503,20939,23442
2014-07-10 19:00:00-04:00,0,7,19,3,0,2653,27362,30015
2014-07-10 20:00:00-04:00,0,7,20,3,0,2515,30724,33239
2014-07-10 21:00:00-04:00,0,7,21,3,0,2034,27325,29359
2014-07-10 22:00:00-04:00,0,7,22,3,0,2156,29414,31570
2014-07-10 23:00:00-04:00,0,7,23,3,0,2259,29128,31387
2014-07-11 00:00:00-04:00,0,7,0,4,0,2181,26404,28585
2014-07-11 01:00:00-04:00,0,7,1,4,0,2063,20913,22976
2014-07-11 02:00:00-04:00,0,7,2,4,0,1596,13816,15412
2014-07-11 03:00:00-04:00,0,7,3,4,0,1120,9170,10290
2014-07-11 04:00:00-04:00,0,7,4,4,0,681,5908,6589
2014-07-11 05:00:00-04:00,0,7,5,4,0,585,4478,5063
2014-07-11 06:00:00-04:00,0,7,6,4,0,465,4882,5347
2014-07-11 07:00:00-04:00,0,7,7,4,0,596,11138,11734
2014-07-11 08:00:00-04:00,0,7,8,4,0,1084,18239,19323
2014-07-11 09:00:00-04:00,0,7,9,4,0,1676,23193,24869
2014-07-11 10:00:00-04:00,0,7,10,4,0,1840,23457,25297
2014-07-11 11:00:00-04:00,0,7,11,4,0,1687,19938,21625
2014-07-11 12:00:00-04:00,0,7,12,4,0,1584,20037,21621
2014-07-11 13:00:00-04:00,0,7,13,4,0,1575,20868,22443
2014-07-11 14:00:00-04:00,0,7,14,4,0,1446,20720,22166
2014-07-11 15:00:00-04:00,0,7,15,4,0,1814,21731,23545
2014-07-11 16:00:00-04:00,0,7,16,4,0,2272,20172,22444
2014-07-11 17:00:00-04:00,0,7,17,4,0,2596,17061,19657
2014-07-11 18:00:00-04:00,0,7,18,4,0,2808,21518,24326
2014-07-11 19:00:00-04:00,0,7,19,4,0,3204,26686,29890
2014-07-11 20:00:00-04:00,0,7,20,4,0,3123,28133,31256
2014-07-11 21:00:00-04:00,0,7,21,4,0,2534,24339,26873
2014-07-11 22:00:00-04:00,0,7,22,4,0,2638,25720,28358
2014-07-11 23:00:00-04:00,0,7,23,4,0,3033,27387,30420
2014-07-12 00:00:00-04:00,0,7,0,5,0,3419,29093,32512
2014-07-12 01:00:00-04:00,0,7,1,5,0,3560,27990,31550
2014-07-12 02:00:00-04:00,0,7,2,5,0,3385,25121,28506
2014-07-12 03:00:00-04:00,0,7,3,5,0,2635,19769,22404
2014-07-12 04:00:00-04:00,0,7,4,5,0,1669,14499,16168
2014-07-12 05:00:00-04:00,0,7,5,5,0,1464,9547,11011
2014-07-12 06:00:00-04:00,0,7,6,5,0,882,4723,5605
2014-07-12 07:00:00-04:00,0,7,7,5,0,560,5025,5585
2014-07-12 08:00:00-04:00,0,7,8,5,0,618,7522,8140
2014-07-12 09:00:00-04:00,0,7,9,5,0,935,9989,10924
2014-07-12 10:00:00-04:00,0,7,10,5,0,1303,14245,15548
2014-07-12 11:00:00-04:00,0,7,11,5,0,1491,16900,18391
2014-07-12 12:00:00-04:00,0,7,12,5,0,1676,18885,20561
2014-07-12 13:00:00-04:00,0,7,13,5,0,1892,20378,22270
2014-07-12 14:00:00-04:00,0,7,14,5,0,2045,21070,23115
2014-07-12 15:00:00-04:00,0,7,15,5,0,2324,20791,23115
2014-07-12 16:00:00-04:00,0,7,16,5,0,2668,21236,23904
2014-07-12 17:00:00-04:00,0,7,17,5,0,2870,20082,22952
2014-07-12 18:00:00-04:00,0,7,18,5,0,2916,22413,25329
2014-07-12 19:00:00-04:00,0,7,19,5,0,3259,24699,27958
2014-07-12 20:00:00-04:00,0,7,20,5,0,3341,24714,28055
2014-07-12 21:00:00-04:00,0,7,21,5,0,2778,21862,24640
2014-07-12 22:00:00-04:00,0,7,22,5,0,3040,22841,25881
2014-07-12 23:00:00-04:00,0,7,23,5,0,3360,25049,28409
2014-07-13 00:00:00-04:00,0,7,0,6,0,3775,27740,31515
2014-07-13 01:00:00-04:00,0,7,1,6,0,3870,27694,31564
2014-07-13 02:00:00-04:00,0,7,2,6,0,3715,25146,28861
2014-07-13 03:00:00-04:00,0,7,3,6,0,3005,20305,23310
2014-07-13 04:00:00-04:00,0,7,4,6,0,1990,15511,17501
2014-07-13 05:00:00-04:00,0,7,5,6,0,1691,10178,11869
2014-07-13 06:00:00-04:00,0,7,6,6,0,883,4633,5516
2014-07-13 07:00:00-04:00,0,7,7,6,0,550,4249,4799
2014-07-13 08:00:00-04:00,0,7,8,6,0,487,5092,5579
2014-07-13 09:00:00-04:00,0,7,9,6,0,612,7135,7747
2014-07-13 10:00:00-04:00,0.01,7,10,6,0,939,11031,11970
2014-07-13 11:00:00-04:00,0,7,11,6,0,1320,17124,18444
2014-07-13 12:00:00-04:00,0,7,12,6,0,1493,18249,19742
2014-07-13 13:00:00-04:00,0,7,13,6,0,1686,20495,22181
2014-07-13 14:00:00-04:00,0,7,14,6,0,1978,22375,24353
2014-07-13 15:00:00-04:00,0,7,15,6,0,2414,25955,28369
2014-07-13 16:00:00-04:00,0,7,16,6,0,2282,22730,25012
2014-07-13 17:00:00-04:00,0,7,17,6,0,2128,17607,19735
2014-07-13 18:00:00-04:00,0,7,18,6,0,2187,19740,21927
2014-07-13 19:00:00-04:00,0,7,19,6,0,2473,23713,26186
2014-07-13 20:00:00-04:00,0,7,20,6,0,2394,20750,23144
2014-07-13 21:00:00-04:00,0,7,21,6,0,1848,18379,20227
2014-07-13 22:00:00-04:00,0,7,22,6,0,2063,19774,21837
2014-07-13 23:00:00-04:00,0,7,23,6,0,1975,17076,19051
2014-07-14 00:00:00-04:00,0.16,7,0,0,0,2143,15542,17685
2014-07-14 01:00:00-04:00,0.24,7,1,0,0,2119,12677,14796
2014-07-14 02:00:00-04:00,0,7,2,0,0,1298,7503,8801
2014-07-14 03:00:00-04:00,0,7,3,0,0,614,3774,4388
2014-07-14 04:00:00-04:00,0,7,4,0,0,383,2380,2763
2014-07-14 05:00:00-04:00,0,7,5,0,0,447,2784,3231
2014-07-14 06:00:00-04:00,0,7,6,0,0,451,4795,5246
2014-07-14 07:00:00-04:00,0,7,7,0,0,664,11463,12127
2014-07-14 08:00:00-04:00,0,7,8,0,0,1096,18551,19647
2014-07-14 09:00:00-04:00,0,7,9,0,0,1808,22727,24535
2014-07-14 10:00:00-04:00,0,7,10,0,0,1758,22104,23862
2014-07-14 11:00:00-04:00,0,7,11,0,0,1618,19124,20742
2014-07-14 12:00:00-04:00,0,7,12,0,0,1458,18375,19833
2014-07-14 13:00:00-04:00,0,7,13,0,0,1466,19546,21012
2014-07-14 14:00:00-04:00,0,7,14,0,0,1489,19145,20634
2014-07-14 15:00:00-04:00,0,7,15,0,0,1608,19839,21447
2014-07-14 16:00:00-04:00,0,7,16,0,0,1849,19456,21305
2014-07-14 17:00:00-04:00,0,7,17,0,0,1909,17987,19896
2014-07-14 18:00:00-04:00,0,7,18,0,0,2173,22558,24731
2014-07-14 19:00:00-04:00,0.02,7,19,0,0,2695,28890,31585
2014-07-14 20:00:00-04:00,0.06,7,20,0,0,2384,27517,29901
2014-07-14 21:00:00-04:00,0.08,7,21,0,0,2135,26804,28939
2014-07-14 22:00:00-04:00,0.14,7,22,0,0,2222,27194,29416
2014-07-14 23:00:00-04:00,0.06,7,23,0,0,1940,23872,25812
2014-07-15 00:00:00-04:00,0.21,7,0,1,0,1624,17338,18962
2014-07-15 01:00:00-04:00,0,7,1,1,0,1131,10877,12008
2014-07-15 02:00:00-04:00,0,7,2,1,0,726,6630,7356
2014-07-15 03:00:00-04:00,0,7,3,1,0,414,4006,4420
2014-07-15 04:00:00-04:00,0,7,4,1,0,294,2491,2785
2014-07-15 05:00:00-04:00,0,7,5,1,0,330,2469,2799
2014-07-15 06:00:00-04:00,0,7,6,1,0,374,4316,4690
2014-07-15 07:00:00-04:00,0,7,7,1,0,593,11873,12466
2014-07-15 08:00:00-04:00,0,7,8,1,0,1090,20223,21313
2014-07-15 09:00:00-04:00,0,7,9,1,0,1818,24892,26710
2014-07-15 10:00:00-04:00,0,7,10,1,0,1903,23876,25779
2014-07-15 11:00:00-04:00,0,7,11,1,0,1606,21304,22910
2014-07-15 12:00:00-04:00,0,7,12,1,0,1603,20982,22585
2014-07-15 13:00:00-04:00,0,7,13,1,0,1655,22094,23749
2014-07-15 14:00:00-04:00,0.33,7,14,1,0,1687,21929,23616
2014-07-15 15:00:00-04:00,0.22,7,15,1,0,2622,25752,28374
2014-07-15 16:00:00-04:00,0.01,7,16,1,0,2256,19327,21583
2014-07-15 17:00:00-04:00,0,7,17,1,0,2055,15239,17294
2014-07-15 18:00:00-04:00,0.01,7,18,1,0,2166,20289,22455
2014-07-15 19:00:00-04:00,0.17,7,19,1,0,3073,29155,32228
2014-07-15 20:00:00-04:00,0.14,7,20,1,0,3360,31277,34637
2014-07-15 21:00:00-04:00,0.05,7,21,1,0,2349,26842,29191
2014-07-15 22:00:00-04:00,0,7,22,1,0,2038,27117,29155
2014-07-15 23:00:00-04:00,0,7,23,1,0,1711,23999,25710
2014-07-16 00:00:00-04:00,0,7,0,2,0,1462,19657,21119
2014-07-16 01:00:00-04:00,0,7,1,2,0,1237,12434,13671
2014-07-16 02:00:00-04:00,0,7,2,2,0,836,7949,8785
2014-07-16 03:00:00-04:00,0,7,3,2,0,490,4929,5419
2014-07-16 04:00:00-04:00,0,7,4,2,0,363,3166,3529
2014-07-16 05:00:00-04:00,0,7,5,2,0,346,2970,3316
2014-07-16 06:00:00-04:00,0,7,6,2,0,351,4387,4738
2014-07-16 07:00:00-04:00,0,7,7,2,0,643,12364,13007
2014-07-16 08:00:00-04:00,0,7,8,2,0,1150,20990,22140
2014-07-16 09:00:00-04:00,0,7,9,2,0,1884,25452,27336
2014-07-16 10:00:00-04:00,0,7,10,2,0,1964,24200,26164
2014-07-16 11:00:00-04:00,0,7,11,2,0,1660,21590,23250
2014-07-16 12:00:00-04:00,0,7,12,2,0,1602,21017,22619
2014-07-16 13:00:00-04:00,0,7,13,2,0,1563,21722,23285
2014-07-16 14:00:00-04:00,0,7,14,2,0,1525,20763,22288
2014-07-16 15:00:00-04:00,0,7,15,2,0,1668,21252,22920
2014-07-16 16:00:00-04:00,0,7,16,2,0,1939,20152,22091
2014-07-16 17:00:00-04:00,0,7,17,2,0,2034,16727,18761
2014-07-16 18:00:00-04:00,0,7,18,2,0,2349,20974,23323
2014-07-16 19:00:00-04:00,0,7,19,2,0,2494,27462,29956
2014-07-16 20:00:00-04:00,0,7,20,2,0,2532,30319,32851
2014-07-16 21:00:00-04:00,0,7,21,2,0,1970,27103,29073
2014-07-16 22:00:00-04:00,0,7,22,2,0,2025,29094,31119
2014-07-16 23:00:00-04:00,0,7,23,2,0,2028,27837,29865
2014-07-17 00:00:00-04:00,0,7,0,3,0,1845,24339,26184
2014-07-17 01:00:00-04:00,0,7,1,3,0,1730,17374,19104
2014-07-17 02:00:00-04:00,0,7,2,3,0,1262,10373,11635
2014-07-17 03:00:00-04:00,0,7,3,3,0,759,6185,6944
2014-07-17 04:00:00-04:00,0,7,4,3,0,524,4079,4603
2014-07-17 05:00:00-04:00,0,7,5,3,0,502,3606,4108
2014-07-17 06:00:00-04:00,0,7,6,3,0,450,4872,5322
2014-07-17 07:00:00-04:00,0,7,7,3,0,653,12238,12891
2014-07-17 08:00:00-04:00,0,7,8,3,0,1092,20061,21153
2014-07-17 09:00:00-04:00,0,7,9,3,0,1741,24562,26303
2014-07-17 10:00:00-04:00,0,7,10,3,0,1895,23511,25406
2014-07-17 11:00:00-04:00,0,7,11,3,0,1723,21167,22890
2014-07-17 12:00:00-04:00,0,7,12,3,0,1565,20900,22465
2014-07-17 13:00:00-04:00,0,7,13,3,0,1575,22253,23828
2014-07-17 14:00:00-04:00,0,7,14,3,0,1627,21616,23243
2014-07-17 15:00:00-04:00,0,7,15,3,0,1891,22816,24707
2014-07-17 16:00:00-04:00,0,7,16,3,0,2010,19647,21657
2014-07-17 17:00:00-04:00,0,7,17,3,0,2205,15228,17433
2014-07-17 18:00:00-04:00,0,7,18,3,0,2409,18946,21355
2014-07-17 19:00:00-04:00,0,7,19,3,0,2767,26221,28988
2014-07-17 20:00:00-04:00,0,7,20,3,0,2551,29065,31616
2014-07-17 21:00:00-04:00,0,7,21,3,0,2064,26250,28314
2014-07-17 22:00:00-04:00,0,7,22,3,0,2183,29949,32132
2014-07-17 23:00:00-04:00,0,7,23,3,0,2273,29135,31408
2014-07-18 00:00:00-04:00,0,7,0,4,0,2327,27069,29396
2014-07-18 01:00:00-04:00,0,7,1,4,0,2014,21784,23798
2014-07-18 02:00:00-04:00,0,7,2,4,0,1479,15062,16541
2014-07-18 03:00:00-04:00,0,7,3,4,0,1031,9589,10620
2014-07-18 04:00:00-04:00,0,7,4,4,0,651,6382,7033
2014-07-18 05:00:00-04:00,0,7,5,4,0,524,4955,5479
2014-07-18 06:00:00-04:00,0,7,6,4,0,515,5350,5865
2014-07-18 07:00:00-04:00,0,7,7,4,0,652,11643,12295
2014-07-18 08:00:00-04:00,0,7,8,4,0,1117,18642,19759
2014-07-18 09:00:00-04:00,0,7,9,4,0,1738,22871,24609
2014-07-18 10:00:00-04:00,0,7,10,4,0,1828,22541,24369
2014-07-18 11:00:00-04:00,0,7,11,4,0,1700,19785,21485
2014-07-18 12:00:00-04:00,0,7,12,4,0,1555,19854,21409
2014-07-18 13:00:00-04:00,0,7,13,4,0,1545,20632,22177
2014-07-18 14:00:00-04:00,0,7,14,4,0,1604,20112,21716
2014-07-18 15:00:00-04:00,0,7,15,4,0,1939,21136,23075
2014-07-18 16:00:00-04:00,0,7,16,4,0,2428,19002,21430
2014-07-18 17:00:00-04:00,0,7,17,4,0,2639,15392,18031
2014-07-18 18:00:00-04:00,0,7,18,4,0,2792,20024,22816
2014-07-18 19:00:00-04:00,0,7,19,4,0,3092,26558,29650
2014-07-18 20:00:00-04:00,0,7,20,4,0,3164,28902,32066
2014-07-18 21:00:00-04:00,0,7,21,4,0,2586,25977,28563
2014-07-18 22:00:00-04:00,0,7,22,4,0,2897,27131,30028
2014-07-18 23:00:00-04:00,0,7,23,4,0,3171,28035,31206
2014-07-19 00:00:00-04:00,0,7,0,5,0,3534,28888,32422
2014-07-19 01:00:00-04:00,0,7,1,5,0,3587,28250,31837
2014-07-19 02:00:00-04:00,0,7,2,5,0,3190,24099,27289
2014-07-19 03:00:00-04:00,0,7,3,5,0,2557,19620,22177
2014-07-19 04:00:00-04:00,0,7,4,5,0,1825,14776,16601
2014-07-19 05:00:00-04:00,0,7,5,5,0,1500,9822,11322
2014-07-19 06:00:00-04:00,0,7,6,5,0,867,4885,5752
2014-07-19 07:00:00-04:00,0,7,7,5,0,647,5226,5873
2014-07-19 08:00:00-04:00,0,7,8,5,0,686,7395,8081
2014-07-19 09:00:00-04:00,0,7,9,5,0,904,9940,10844
2014-07-19 10:00:00-04:00,0,7,10,5,0,1201,14167,15368
2014-07-19 11:00:00-04:00,0,7,11,5,0,1342,16425,17767
2014-07-19 12:00:00-04:00,0,7,12,5,0,1679,19613,21292
2014-07-19 13:00:00-04:00,0,7,13,5,0,1786,20336,22122
2014-07-19 14:00:00-04:00,0,7,14,5,0,1969,20863,22832
2014-07-19 15:00:00-04:00,0,7,15,5,0,2284,19771,22055
2014-07-19 16:00:00-04:00,0,7,16,5,0,2477,19821,22298
2014-07-19 17:00:00-04:00,0,7,17,5,0,2668,18907,21575
2014-07-19 18:00:00-04:00,0,7,18,5,0,2804,21429,24233
2014-07-19 19:00:00-04:00,0,7,19,5,0,3051,23685,26736
2014-07-19 20:00:00-04:00,0,7,20,5,0,3085,25487,28572
2014-07-19 21:00:00-04:00,0,7,21,5,0,2634,22543,25177
2014-07-19 22:00:00-04:00,0,7,22,5,0,2998,24334,27332
2014-07-19 23:00:00-04:00,0,7,23,5,0,3383,25793,29176
2014-07-20 00:00:00-04:00,0,7,0,6,0,3619,28035,31654
2014-07-20 01:00:00-04:00,0,7,1,6,0,3689,26959,30648
2014-07-20 02:00:00-04:00,0,7,2,6,0,3441,24268,27709
2014-07-20 03:00:00-04:00,0,7,3,6,0,2894,19908,22802
2014-07-20 04:00:00-04:00,0,7,4,6,0,2127,15477,17604
2014-07-20 05:00:00-04:00,0,7,5,6,0,1744,10546,12290
2014-07-20 06:00:00-04:00,0,7,6,6,0,931,4900,5831
2014-07-20 07:00:00-04:00,0,7,7,6,0,599,4350,4949
2014-07-20 08:00:00-04:00,0,7,8,6,0,521,5626,6147
2014-07-20 09:00:00-04:00,0,7,9,6,0,590,7794,8384
2014-07-20 10:00:00-04:00,0,7,10,6,0,918,11348,12266
2014-07-20 11:00:00-04:00,0,7,11,6,0,1151,14943,16094
2014-07-20 12:00:00-04:00,0,7,12,6,0,1496,17953,19449
2014-07-20 13:00:00-04:00,0,7,13,6,0,1682,19499,21181
2014-07-20 14:00:00-04:00,0,7,14,6,0,1870,20064,21934
2014-07-20 15:00:00-04:00,0,7,15,6,0,2103,20731,22834
2014-07-20 16:00:00-04:00,0,7,16,6,0,2255,19646,21901
2014-07-20 17:00:00-04:00,0,7,17,6,0,2402,18994,21396
2014-07-20 18:00:00-04:00,0,7,18,6,0,2414,20564,22978
2014-07-20 19:00:00-04:00,0,7,19,6,0,2468,21923,24391
2014-07-20 20:00:00-04:00,0,7,20,6,0,2281,21029,23310
2014-07-20 21:00:00-04:00,0,7,21,6,0,1774,18821,20595
2014-07-20 22:00:00-04:00,0,7,22,6,0,2017,20017,22034
2014-07-20 23:00:00-04:00,0,7,23,6,0,2056,18294,20350
2014-07-21 00:00:00-04:00,0,7,0,0,0,1980,15049,17029
2014-07-21 01:00:00-04:00,0,7,1,0,0,1573,9664,11237
2014-07-21 02:00:00-04:00,0,7,2,0,0,1023,5823,6846
2014-07-21 03:00:00-04:00,0,7,3,0,0,685,3649,4334
2014-07-21 04:00:00-04:00,0,7,4,0,0,432,2391,2823
2014-07-21 05:00:00-04:00,0,7,5,0,0,516,3002,3518
2014-07-21 06:00:00-04:00,0,7,6,0,0,452,4774,5226
2014-07-21 07:00:00-04:00,0,7,7,0,0,592,11354,11946
2014-07-21 08:00:00-04:00,0,7,8,0,0,1039,18195,19234
2014-07-21 09:00:00-04:00,0,7,9,0,0,1747,22317,24064
2014-07-21 10:00:00-04:00,0,7,10,0,0,1707,21898,23605
2014-07-21 11:00:00-04:00,0,7,11,0,0,1475,18580,20055
2014-07-21 12:00:00-04:00,0,7,12,0,0,1329,18396,19725
2014-07-21 13:00:00-04:00,0,7,13,0,0,1396,19285,20681
2014-07-21 14:00:00-04:00,0,7,14,0,0,1429,19467,20896
2014-07-21 15:00:00-04:00,0,7,15,0,0,1522,20209,21731
2014-07-21 16:00:00-04:00,0,7,16,0,0,1767,19631,21398
2014-07-21 17:00:00-04:00,0,7,17,0,0,1894,18169,20063
2014-07-21 18:00:00-04:00,0,7,18,0,0,2072,21658,23730
2014-07-21 19:00:00-04:00,0,7,19,0,0,2185,26862,29047
2014-07-21 20:00:00-04:00,0,7,20,0,0,1929,26266,28195
2014-07-21 21:00:00-04:00,0,7,21,0,0,1568,23408,24976
2014-07-21 22:00:00-04:00,0,7,22,0,0,1642,24002,25644
2014-07-21 23:00:00-04:00,0,7,23,0,0,1599,22963,24562
2014-07-22 00:00:00-04:00,0,7,0,1,0,1518,17147,18665
2014-07-22 01:00:00-04:00,0,7,1,1,0,1217,10967,12184
2014-07-22 02:00:00-04:00,0,7,2,1,0,861,6627,7488
2014-07-22 03:00:00-04:00,0,7,3,1,0,527,4069,4596
2014-07-22 04:00:00-04:00,0,7,4,1,0,329,2749,3078
2014-07-22 05:00:00-04:00,0,7,5,1,0,393,2632,3025
2014-07-22 06:00:00-04:00,0,7,6,1,0,359,4484,4843
2014-07-22 07:00:00-04:00,0,7,7,1,0,544,11524,12068
2014-07-22 08:00:00-04:00,0,7,8,1,0,1036,18988,20024
2014-07-22 09:00:00-04:00,0,7,9,1,0,1723,23788,25511
2014-07-22 10:00:00-04:00,0,7,10,1,0,1777,23676,25453
2014-07-22 11:00:00-04:00,0,7,11,1,0,1563,21166,22729
2014-07-22 12:00:00-04:00,0,7,12,1,0,1411,21114,22525
2014-07-22 13:00:00-04:00,0,7,13,1,0,1591,22993,24584
2014-07-22 14:00:00-04:00,0,7,14,1,0,1599,22584,24183
2014-07-22 15:00:00-04:00,0,7,15,1,0,1702,22692,24394
2014-07-22 16:00:00-04:00,0,7,16,1,0,1865,20801,22666
2014-07-22 17:00:00-04:00,0,7,17,1,0,2019,17989,20008
2014-07-22 18:00:00-04:00,0,7,18,1,0,2200,23357,25557
2014-07-22 19:00:00-04:00,0,7,19,1,0,2555,29786,32341
2014-07-22 20:00:00-04:00,0,7,20,1,0,2434,30307,32741
2014-07-22 21:00:00-04:00,0,7,21,1,0,1787,27008,28795
2014-07-22 22:00:00-04:00,0,7,22,1,0,1952,28683,30635
2014-07-22 23:00:00-04:00,0,7,23,1,0,1947,27234,29181
2014-07-23 00:00:00-04:00,0,7,0,2,0,1853,21908,23761
2014-07-23 01:00:00-04:00,0,7,1,2,0,1610,14065,15675
2014-07-23 02:00:00-04:00,0,7,2,2,0,1029,8335,9364
2014-07-23 03:00:00-04:00,0,7,3,2,0,582,5151,5733
2014-07-23 04:00:00-04:00,0,7,4,2,0,377,3405,3782
2014-07-23 05:00:00-04:00,0,7,5,2,0,377,3070,3447
2014-07-23 06:00:00-04:00,0,7,6,2,0,395,4528,4923
2014-07-23 07:00:00-04:00,0,7,7,2,0,608,12027,12635
2014-07-23 08:00:00-04:00,0,7,8,2,0,1059,19840,20899
2014-07-23 09:00:00-04:00,0,7,9,2,0,1778,24495,26273
2014-07-23 10:00:00-04:00,0,7,10,2,0,1847,24365,26212
2014-07-23 11:00:00-04:00,0,7,11,2,0,1573,22143,23716
2014-07-23 12:00:00-04:00,0,7,12,2,0,1546,22487,24033
2014-07-23 13:00:00-04:00,0,7,13,2,0,1562,23148,24710
2014-07-23 14:00:00-04:00,0,7,14,2,0,1553,23226,24779
2014-07-23 15:00:00-04:00,0,7,15,2,0,1857,23413,25270
2014-07-23 16:00:00-04:00,0,7,16,2,0,2029,21417,23446
2014-07-23 17:00:00-04:00,0,7,17,2,0,2187,17907,20094
2014-07-23 18:00:00-04:00,0,7,18,2,0,2408,22928,25336
2014-07-23 19:00:00-04:00,0,7,19,2,0,2682,29041,31723
2014-07-23 20:00:00-04:00,0,7,20,2,0,2524,30818,33342
2014-07-23 21:00:00-04:00,0.12,7,21,2,0,2311,28919,31230
2014-07-23 22:00:00-04:00,0,7,22,2,0,2435,29657,32092
2014-07-23 23:00:00-04:00,0,7,23,2,0,2371,28268,30639
2014-07-24 00:00:00-04:00,0,7,0,3,0,2195,24072,26267
2014-07-24 01:00:00-04:00,0,7,1,3,0,1679,16229,17908
2014-07-24 02:00:00-04:00,0,7,2,3,0,1040,9218,10258
2014-07-24 03:00:00-04:00,0,7,3,3,0,658,5717,6375
2014-07-24 04:00:00-04:00,0,7,4,3,0,424,3491,3915
2014-07-24 05:00:00-04:00,0,7,5,3,0,416,3228,3644
2014-07-24 06:00:00-04:00,0,7,6,3,0,412,4590,5002
2014-07-24 07:00:00-04:00,0,7,7,3,0,637,12256,12893
2014-07-24 08:00:00-04:00,0,7,8,3,0,1186,20336,21522
2014-07-24 09:00:00-04:00,0,7,9,3,0,1872,24762,26634
2014-07-24 10:00:00-04:00,0,7,10,3,0,1889,24468,26357
2014-07-24 11:00:00-04:00,0,7,11,3,0,1652,21495,23147
2014-07-24 12:00:00-04:00,0,7,12,3,0,1518,20975,22493
2014-07-24 13:00:00-04:00,0,7,13,3,0,1527,22048,23575
2014-07-24 14:00:00-04:00,0,7,14,3,0,1579,21358,22937
2014-07-24 15:00:00-04:00,0,7,15,3,0,1773,21825,23598
2014-07-24 16:00:00-04:00,0,7,16,3,0,2007,20202,22209
2014-07-24 17:00:00-04:00,0,7,17,3,0,2233,16785,19018
2014-07-24 18:00:00-04:00,0,7,18,3,0,2435,20780,23215
2014-07-24 19:00:00-04:00,0,7,19,3,0,2655,27253,29908
2014-07-24 20:00:00-04:00,0,7,20,3,0,2640,29972,32612
2014-07-24 21:00:00-04:00,0,7,21,3,0,2002,27306,29308
2014-07-24 22:00:00-04:00,0,7,22,3,0,2160,30057,32217
2014-07-24 23:00:00-04:00,0,7,23,3,0,2217,29642,31859
2014-07-25 00:00:00-04:00,0,7,0,4,0,2135,27705,29840
2014-07-25 01:00:00-04:00,0,7,1,4,0,1775,22169,23944
2014-07-25 02:00:00-04:00,0,7,2,4,0,1365,15081,16446
2014-07-25 03:00:00-04:00,0,7,3,4,0,918,9762,10680
2014-07-25 04:00:00-04:00,0,7,4,4,0,643,6571,7214
2014-07-25 05:00:00-04:00,0,7,5,4,0,565,4954,5519
2014-07-25 06:00:00-04:00,0,7,6,4,0,463,5422,5885
2014-07-25 07:00:00-04:00,0,7,7,4,0,604,11489,12093
2014-07-25 08:00:00-04:00,0,7,8,4,0,1054,18221,19275
2014-07-25 09:00:00-04:00,0,7,9,4,0,1667,22687,24354
2014-07-25 10:00:00-04:00,0,7,10,4,0,1782,22181,23963
2014-07-25 11:00:00-04:00,0,7,11,4,0,1583,19774,21357
2014-07-25 12:00:00-04:00,0,7,12,4,0,1600,19831,21431
2014-07-25 13:00:00-04:00,0,7,13,4,0,1510,20571,22081
2014-07-25 14:00:00-04:00,0,7,14,4,0,1519,19806,21325
2014-07-25 15:00:00-04:00,0,7,15,4,0,1778,20905,22683
2014-07-25 16:00:00-04:00,0,7,16,4,0,2101,19438,21539
2014-07-25 17:00:00-04:00,0,7,17,4,0,2524,16538,19062
2014-07-25 18:00:00-04:00,0,7,18,4,0,2795,20934,23729
2014-07-25 19:00:00-04:00,0,7,19,4,0,3136,26531,29667
2014-07-25 20:00:00-04:00,0,7,20,4,0,3097,28464,31561
2014-07-25 21:00:00-04:00,0,7,21,4,0,2636,25685,28321
2014-07-25 22:00:00-04:00,0,7,22,4,0,2783,27131,29914
2014-07-25 23:00:00-04:00,0,7,23,4,0,3084,28197,31281
2014-07-26 00:00:00-04:00,0,7,0,5,0,3503,29151,32654
2014-07-26 01:00:00-04:00,0,7,1,5,0,3463,28104,31567
2014-07-26 02:00:00-04:00,0,7,2,5,0,3153,24278,27431
2014-07-26 03:00:00-04:00,0,7,3,5,0,2584,19625,22209
2014-07-26 04:00:00-04:00,0,7,4,5,0,1865,14549,16414
2014-07-26 05:00:00-04:00,0,7,5,5,0,1571,9592,11163
2014-07-26 06:00:00-04:00,0,7,6,5,0,882,5098,5980
2014-07-26 07:00:00-04:00,0,7,7,5,0,637,5812,6449
2014-07-26 08:00:00-04:00,0,7,8,5,0,661,7597,8258
2014-07-26 09:00:00-04:00,0,7,9,5,0,902,10255,11157
2014-07-26 10:00:00-04:00,0,7,10,5,0,1215,14827,16042
2014-07-26 11:00:00-04:00,0,7,11,5,0,1375,17699,19074
2014-07-26 12:00:00-04:00,0,7,12,5,0,1589,20329,21918
2014-07-26 13:00:00-04:00,0,7,13,5,0,1779,20423,22202
2014-07-26 14:00:00-04:00,0,7,14,5,0,1738,20233,21971
2014-07-26 15:00:00-04:00,0,7,15,5,0,2159,19781,21940
2014-07-26 16:00:00-04:00,0,7,16,5,0,2409,20062,22471
2014-07-26 17:00:00-04:00,0,7,17,5,0,2964,19696,22660
2014-07-26 18:00:00-04:00,0,7,18,5,0,2937,21519,24456
2014-07-26 19:00:00-04:00,0,7,19,5,0,3172,23485,26657
2014-07-26 20:00:00-04:00,0,7,20,5,0,2909,24931,27840
2014-07-26 21:00:00-04:00,0,7,21,5,0,2756,22426,25182
2014-07-26 22:00:00-04:00,0,7,22,5,0,3077,24323,27400
2014-07-26 23:00:00-04:00,0,7,23,5,0,3487,25692,29179
2014-07-27 00:00:00-04:00,0,7,0,6,0,3776,28052,31828
2014-07-27 01:00:00-04:00,0,7,1,6,0,3882,27294,31176
2014-07-27 02:00:00-04:00,0,7,2,6,0,3552,24062,27614
2014-07-27 03:00:00-04:00,0,7,3,6,0,2939,20168,23107
2014-07-27 04:00:00-04:00,0,7,4,6,0,2153,15322,17475
2014-07-27 05:00:00-04:00,0,7,5,6,0,1770,10444,12214
2014-07-27 06:00:00-04:00,0,7,6,6,0,1019,5033,6052
2014-07-27 07:00:00-04:00,0,7,7,6,0,607,4466,5073
2014-07-27 08:00:00-04:00,0,7,8,6,0,548,5375,5923
2014-07-27 09:00:00-04:00,0,7,9,6,0,621,7527,8148
2014-07-27 10:00:00-04:00,0,7,10,6,0,894,11016,11910
2014-07-27 11:00:00-04:00,0,7,11,6,0,1175,14987,16162
2014-07-27 12:00:00-04:00,0,7,12,6,0,1489,17994,19483
2014-07-27 13:00:00-04:00,0,7,13,6,0,1762,19630,21392
2014-07-27 14:00:00-04:00,0,7,14,6,0,1812,20247,22059
2014-07-27 15:00:00-04:00,0,7,15,6,0,2108,20795,22903
2014-07-27 16:00:00-04:00,0,7,16,6,0,2271,20125,22396
2014-07-27 17:00:00-04:00,0,7,17,6,0,2541,20260,22801
2014-07-27 18:00:00-04:00,0,7,18,6,0,2494,21917,24411
2014-07-27 19:00:00-04:00,0,7,19,6,0,2466,22756,25222
2014-07-27 20:00:00-04:00,0,7,20,6,0,2316,21348,23664
2014-07-27 21:00:00-04:00,0,7,21,6,0,1827,19210,21037
2014-07-27 22:00:00-04:00,0,7,22,6,0,2025,19940,21965
2014-07-27 23:00:00-04:00,0,7,23,6,0,2042,18308,20350
2014-07-28 00:00:00-04:00,0,7,0,0,0,1940,15724,17664
2014-07-28 01:00:00-04:00,0.07,7,1,0,0,1555,10621,12176
2014-07-28 02:00:00-04:00,0.09,7,2,0,0,1089,7221,8310
2014-07-28 03:00:00-04:00,0.08,7,3,0,0,652,3767,4419
2014-07-28 04:00:00-04:00,0.02,7,4,0,0,512,2638,3150
2014-07-28 05:00:00-04:00,0,7,5,0,0,448,2800,3248
2014-07-28 06:00:00-04:00,0,7,6,0,0,361,4618,4979
2014-07-28 07:00:00-04:00,0,7,7,0,0,522,10307,10829
2014-07-28 08:00:00-04:00,0,7,8,0,0,959,14530,15489
2014-07-28 09:00:00-04:00,0,7,9,0,0,1420,17636,19056
2014-07-28 10:00:00-04:00,0,7,10,0,0,1503,18956,20459
2014-07-28 11:00:00-04:00,0,7,11,0,0,1358,17921,19279
2014-07-28 12:00:00-04:00,0,7,12,0,0,1219,17779,18998
2014-07-28 13:00:00-04:00,0,7,13,0,0,1168,18776,19944
2014-07-28 14:00:00-04:00,0,7,14,0,0,1221,18374,19595
2014-07-28 15:00:00-04:00,0,7,15,0,0,1317,19200,20517
2014-07-28 16:00:00-04:00,0,7,16,0,0,1460,18299,19759
2014-07-28 17:00:00-04:00,0,7,17,0,0,1547,16310,17857
2014-07-28 18:00:00-04:00,0,7,18,0,0,1722,18759,20481
2014-07-28 19:00:00-04:00,0,7,19,0,0,1795,23304,25099
2014-07-28 20:00:00-04:00,0,7,20,0,0,1733,24681,26414
2014-07-28 21:00:00-04:00,0,7,21,0,0,1594,22592,24186
2014-07-28 22:00:00-04:00,0,7,22,0,0,1510,21860,23370
2014-07-28 23:00:00-04:00,0,7,23,0,0,1361,20410,21771
2014-07-29 00:00:00-04:00,0,7,0,1,0,1196,17374,18570
2014-07-29 01:00:00-04:00,0,7,1,1,0,1045,11232,12277
2014-07-29 02:00:00-04:00,0,7,2,1,0,671,6649,7320
2014-07-29 03:00:00-04:00,0,7,3,1,0,416,4052,4468
2014-07-29 04:00:00-04:00,0,7,4,1,0,319,2623,2942
2014-07-29 05:00:00-04:00,0,7,5,1,0,349,2636,2985
2014-07-29 06:00:00-04:00,0,7,6,1,0,356,4365,4721
2014-07-29 07:00:00-04:00,0,7,7,1,0,506,11706,12212
2014-07-29 08:00:00-04:00,0,7,8,1,0,953,18836,19789
2014-07-29 09:00:00-04:00,0,7,9,1,0,1591,22103,23694
2014-07-29 10:00:00-04:00,0,7,10,1,0,1658,21770,23428
2014-07-29 11:00:00-04:00,0,7,11,1,0,1468,19710,21178
2014-07-29 12:00:00-04:00,0,7,12,1,0,1443,19518,20961
2014-07-29 13:00:00-04:00,0,7,13,1,0,1538,20295,21833
2014-07-29 14:00:00-04:00,0,7,14,1,0,1418,20077,21495
2014-07-29 15:00:00-04:00,0,7,15,1,0,1461,20449,21910
2014-07-29 16:00:00-04:00,0,7,16,1,0,1607,19828,21435
2014-07-29 17:00:00-04:00,0,7,17,1,0,1892,16952,18844
2014-07-29 18:00:00-04:00,0,7,18,1,0,2086,21025,23111
2014-07-29 19:00:00-04:00,0,7,19,1,0,2377,27030,29407
2014-07-29 20:00:00-04:00,0,7,20,1,0,2343,29110,31453
2014-07-29 21:00:00-04:00,0,7,21,1,0,2004,26923,28927
2014-07-29 22:00:00-04:00,0,7,22,1,0,1984,27621,29605
2014-07-29 23:00:00-04:00,0,7,23,1,0,1865,26026,27891
2014-07-30 00:00:00-04:00,0,7,0,2,0,1631,21912,23543
2014-07-30 01:00:00-04:00,0,7,1,2,0,1315,13946,15261
2014-07-30 02:00:00-04:00,0,7,2,2,0,900,8345,9245
2014-07-30 03:00:00-04:00,0,7,3,2,0,557,5176,5733
2014-07-30 04:00:00-04:00,0,7,4,2,0,406,3419,3825
2014-07-30 05:00:00-04:00,0,7,5,2,0,382,3166,3548
2014-07-30 06:00:00-04:00,0,7,6,2,0,364,4437,4801
2014-07-30 07:00:00-04:00,0,7,7,2,0,553,11896,12449
2014-07-30 08:00:00-04:00,0,7,8,2,0,1071,19812,20883
2014-07-30 09:00:00-04:00,0,7,9,2,0,1797,23639,25436
2014-07-30 10:00:00-04:00,0,7,10,2,0,1864,23299,25163
2014-07-30 11:00:00-04:00,0,7,11,2,0,1605,20367,21972
2014-07-30 12:00:00-04:00,0,7,12,2,0,1583,20224,21807
2014-07-30 13:00:00-04:00,0,7,13,2,0,1502,21042,22544
2014-07-30 14:00:00-04:00,0,7,14,2,0,1451,20691,22142
2014-07-30 15:00:00-04:00,0,7,15,2,0,1603,20984,22587
2014-07-30 16:00:00-04:00,0,7,16,2,0,1847,19313,21160
2014-07-30 17:00:00-04:00,0,7,17,2,0,2015,15743,17758
2014-07-30 18:00:00-04:00,0,7,18,2,0,2204,20356,22560
2014-07-30 19:00:00-04:00,0,7,19,2,0,2570,26200,28770
2014-07-30 20:00:00-04:00,0,7,20,2,0,2529,29221,31750
2014-07-30 21:00:00-04:00,0,7,21,2,0,2314,28357,30671
2014-07-30 22:00:00-04:00,0,7,22,2,0,2243,29106,31349
2014-07-30 23:00:00-04:00,0,7,23,2,0,2204,28140,30344
2014-07-31 00:00:00-04:00,0,7,0,3,0,2033,24611,26644
2014-07-31 01:00:00-04:00,0,7,1,3,0,1621,16333,17954
2014-07-31 02:00:00-04:00,0,7,2,3,0,1169,9837,11006
2014-07-31 03:00:00-04:00,0,7,3,3,0,685,6428,7113
2014-07-31 04:00:00-04:00,0,7,4,3,0,529,4218,4747
2014-07-31 05:00:00-04:00,0,7,5,3,0,465,3616,4081
2014-07-31 06:00:00-04:00,0,7,6,3,0,373,4709,5082
2014-07-31 07:00:00-04:00,0,7,7,3,0,564,12238,12802
2014-07-31 08:00:00-04:00,0,7,8,3,0,1125,19670,20795
2014-07-31 09:00:00-04:00,0,7,9,3,0,1868,24144,26012
2014-07-31 10:00:00-04:00,0,7,10,3,0,2008,22625,24633
2014-07-31 11:00:00-04:00,0,7,11,3,0,1660,20318,21978
2014-07-31 12:00:00-04:00,0,7,12,3,0,1487,20299,21786
2014-07-31 13:00:00-04:00,0,7,13,3,0,1585,21391,22976
2014-07-31 14:00:00-04:00,0,7,14,3,0,1613,21108,22721
2014-07-31 15:00:00-04:00,0,7,15,3,0,1804,21461,23265
2014-07-31 16:00:00-04:00,0,7,16,3,0,1997,19283,21280
2014-07-31 17:00:00-04:00,0,7,17,3,0,2199,15622,17821
2014-07-31 18:00:00-04:00,0,7,18,3,0,2503,19919,22422
2014-07-31 19:00:00-04:00,0,7,19,3,0,3014,26079,29093
2014-07-31 20:00:00-04:00,0,7,20,3,0,2987,29247,32234
2014-07-31 21:00:00-04:00,0,7,21,3,0,2686,28807,31493
2014-07-31 22:00:00-04:00,0,7,22,3,0,2583,29850,32433
2014-07-31 23:00:00-04:00,0,7,23,3,0,2597,28896,31493
2014-08-01 00:00:00-04:00,0,8,0,4,0,2421,27417,29838
2014-08-01 01:00:00-04:00,0,8,1,4,0,1972,21894,23866
2014-08-01 02:00:00-04:00,0,8,2,4,0,1578,14516,16094
2014-08-01 03:00:00-04:00,0,8,3,4,0,1075,9704,10779
2014-08-01 04:00:00-04:00,0,8,4,4,0,702,6335,7037
2014-08-01 05:00:00-04:00,0,8,5,4,0,633,4954,5587
2014-08-01 06:00:00-04:00,0,8,6,4,0,504,5216,5720
2014-08-01 07:00:00-04:00,0,8,7,4,0,654,11641,12295
2014-08-01 08:00:00-04:00,0,8,8,4,0,1169,18397,19566
2014-08-01 09:00:00-04:00,0,8,9,4,0,1925,22929,24854
2014-08-01 10:00:00-04:00,0,8,10,4,0,2042,22578,24620
2014-08-01 11:00:00-04:00,0,8,11,4,0,1830,20108,21938
2014-08-01 12:00:00-04:00,0,8,12,4,0,1831,19668,21499
2014-08-01 13:00:00-04:00,0,8,13,4,0,1704,20422,22126
2014-08-01 14:00:00-04:00,0,8,14,4,0,1754,20093,21847
2014-08-01 15:00:00-04:00,0,8,15,4,0,1936,20496,22432
2014-08-01 16:00:00-04:00,0,8,16,4,0,2415,19059,21474
2014-08-01 17:00:00-04:00,0,8,17,4,0,2732,14974,17706
2014-08-01 18:00:00-04:00,0,8,18,4,0,3073,19580,22653
2014-08-01 19:00:00-04:00,0,8,19,4,0,3367,25043,28410
2014-08-01 20:00:00-04:00,0,8,20,4,0,3411,27525,30936
2014-08-01 21:00:00-04:00,0,8,21,4,0,3275,26265,29540
2014-08-01 22:00:00-04:00,0,8,22,4,0,3248,26235,29483
2014-08-01 23:00:00-04:00,0,8,23,4,0,3471,27255,30726
2014-08-02 00:00:00-04:00,0,8,0,5,0,3715,28541,32256
2014-08-02 01:00:00-04:00,0,8,1,5,0,3649,26940,30589
2014-08-02 02:00:00-04:00,0,8,2,5,0,3302,23843,27145
2014-08-02 03:00:00-04:00,0.01,8,3,5,0,2702,20257,22959
2014-08-02 04:00:00-04:00,0.03,8,4,5,0,2238,15503,17741
2014-08-02 05:00:00-04:00,0.09,8,5,5,0,1724,9747,11471
2014-08-02 06:00:00-04:00,0.09,8,6,5,0,869,4798,5667
2014-08-02 07:00:00-04:00,0.12,8,7,5,0,649,5671,6320
2014-08-02 08:00:00-04:00,0.06,8,8,5,0,691,8007,8698
2014-08-02 09:00:00-04:00,0,8,9,5,0,955,10318,11273
2014-08-02 10:00:00-04:00,0,8,10,5,0,1249,13196,14445
2014-08-02 11:00:00-04:00,0,8,11,5,0,1447,15643,17090
2014-08-02 12:00:00-04:00,0,8,12,5,0,1663,18000,19663
2014-08-02 13:00:00-04:00,0,8,13,5,0,1758,19158,20916
2014-08-02 14:00:00-04:00,0,8,14,5,0,1990,20252,22242
2014-08-02 15:00:00-04:00,0,8,15,5,0,2156,19833,21989
2014-08-02 16:00:00-04:00,0,8,16,5,0,2413,20208,22621
2014-08-02 17:00:00-04:00,0,8,17,5,0,2680,19328,22008
2014-08-02 18:00:00-04:00,0,8,18,5,0,2851,21424,24275
2014-08-02 19:00:00-04:00,0,8,19,5,0,3291,23680,26971
2014-08-02 20:00:00-04:00,0,8,20,5,0,3475,25137,28612
2014-08-02 21:00:00-04:00,0,8,21,5,0,3454,23513,26967
2014-08-02 22:00:00-04:00,0,8,22,5,0,3607,23624,27231
2014-08-02 23:00:00-04:00,0,8,23,5,0,3787,24858,28645
2014-08-03 00:00:00-04:00,0,8,0,6,0,4090,27158,31248
2014-08-03 01:00:00-04:00,0,8,1,6,0,3932,26280,30212
2014-08-03 03:00:00-04:00,0,8,3,6,0,3708,24521,28229
2014-08-03 04:00:00-04:00,0.01,8,4,6,0,3246,20952,24198
2014-08-03 05:00:00-04:00,0.01,8,5,6,0,2604,15929,18533
2014-08-03 06:00:00-04:00,0,8,6,6,0,1955,10633,12588
2014-08-03 07:00:00-04:00,0.03,8,7,6,0,997,4992,5989
2014-08-03 08:00:00-04:00,0.01,8,8,6,0,594,4726,5320
2014-08-03 09:00:00-04:00,0,8,9,6,0,561,6293,6854
2014-08-03 10:00:00-04:00,0,8,10,6,0,650,8848,9498
2014-08-03 11:00:00-04:00,0,8,11,6,0,935,11307,12242
2014-08-03 12:00:00-04:00,0,8,12,6,0,1257,14826,16083
2014-08-03 13:00:00-04:00,0,8,13,6,0,1474,17701,19175
2014-08-03 14:00:00-04:00,0,8,14,6,0,1644,19613,21257
2014-08-03 15:00:00-04:00,0,8,15,6,0,1838,19569,21407
2014-08-03 16:00:00-04:00,0,8,16,6,0,2038,20693,22731
2014-08-03 17:00:00-04:00,0,8,17,6,0,2063,19722,21785
2014-08-03 18:00:00-04:00,0,8,18,6,0,2264,18654,20918
2014-08-03 19:00:00-04:00,0,8,19,6,0,2365,20180,22545
2014-08-03 20:00:00-04:00,0,8,20,6,0,2409,22088,24497
2014-08-03 21:00:00-04:00,0,8,21,6,0,2403,20437,22840
2014-08-03 22:00:00-04:00,0,8,22,6,0,2207,19153,21360
2014-08-03 23:00:00-04:00,0,8,23,6,0,2316,19256,21572
2014-08-04 00:00:00-04:00,0,8,0,0,0,2139,17544,19683
2014-08-04 01:00:00-04:00,0,8,1,0,0,1891,13848,15739
2014-08-04 02:00:00-04:00,0,8,2,0,0,1433,9183,10616
2014-08-04 03:00:00-04:00,0,8,3,0,0,908,5703,6611
2014-08-04 04:00:00-04:00,0,8,4,0,0,649,3642,4291
2014-08-04 05:00:00-04:00,0,8,5,0,0,467,2622,3089
2014-08-04 06:00:00-04:00,0,8,6,0,0,484,2732,3216
2014-08-04 07:00:00-04:00,0,8,7,0,0,404,4437,4841
2014-08-04 08:00:00-04:00,0,8,8,0,0,603,11096,11699
2014-08-04 09:00:00-04:00,0,8,9,0,0,1105,18119,19224
2014-08-04 10:00:00-04:00,0,8,10,0,0,1803,22155,23958
2014-08-04 11:00:00-04:00,0,8,11,0,0,1833,21789,23622
2014-08-04 12:00:00-04:00,0,8,12,0,0,1595,18522,20117
2014-08-04 13:00:00-04:00,0,8,13,0,0,1543,18701,20244
2014-08-04 14:00:00-04:00,0,8,14,0,0,1518,19151,20669
2014-08-04 15:00:00-04:00,0,8,15,0,0,1488,19146,20634
2014-08-04 16:00:00-04:00,0,8,16,0,0,1655,19901,21556
2014-08-04 17:00:00-04:00,0,8,17,0,0,1818,19561,21379
2014-08-04 18:00:00-04:00,0,8,18,0,0,1973,17590,19563
2014-08-04 19:00:00-04:00,0,8,19,0,0,2164,20706,22870
2014-08-04 20:00:00-04:00,0,8,20,0,0,2278,25274,27552
2014-08-04 21:00:00-04:00,0,8,21,0,0,2215,25523,27738
2014-08-04 22:00:00-04:00,0,8,22,0,0,1966,24925,26891
2014-08-04 23:00:00-04:00,0,8,23,0,0,1827,24021,25848
2014-08-05 00:00:00-04:00,0,8,0,1,0,1690,21698,23388
2014-08-05 01:00:00-04:00,0,8,1,1,0,1455,16674,18129
2014-08-05 02:00:00-04:00,0,8,2,1,0,1097,10681,11778
2014-08-05 03:00:00-04:00,0,8,3,1,0,782,6295,7077
2014-08-05 04:00:00-04:00,0,8,4,1,0,474,4091,4565
2014-08-05 05:00:00-04:00,0,8,5,1,0,371,2631,3002
2014-08-05 06:00:00-04:00,0,8,6,1,0,335,2606,2941
2014-08-05 07:00:00-04:00,0,8,7,1,0,347,4148,4495
2014-08-05 08:00:00-04:00,0,8,8,1,0,555,11431,11986
2014-08-05 09:00:00-04:00,0,8,9,1,0,1016,18941,19957
2014-08-05 10:00:00-04:00,0,8,10,1,0,1831,23573,25404
2014-08-05 11:00:00-04:00,0,8,11,1,0,1894,22902,24796
2014-08-05 12:00:00-04:00,0,8,12,1,0,1567,20452,22019
2014-08-05 13:00:00-04:00,0,8,13,1,0,1480,20023,21503
2014-08-05 14:00:00-04:00,0,8,14,1,0,1593,21316,22909
2014-08-05 15:00:00-04:00,0,8,15,1,0,1507,21356,22863
2014-08-05 16:00:00-04:00,0,8,16,1,0,1697,21776,23473
2014-08-05 17:00:00-04:00,0,8,17,1,0,1924,20047,21971
2014-08-05 18:00:00-04:00,0,8,18,1,0,2053,16491,18544
2014-08-05 19:00:00-04:00,0,8,19,1,0,2255,20441,22696
2014-08-05 20:00:00-04:00,0,8,20,1,0,2546,25812,28358
2014-08-05 21:00:00-04:00,0,8,21,1,0,2522,27411,29933
2014-08-05 22:00:00-04:00,0,8,22,1,0,2193,26594,28787
2014-08-05 23:00:00-04:00,0,8,23,1,0,2080,27480,29560
2014-08-06 00:00:00-04:00,0,8,0,2,0,2035,25183,27218
2014-08-06 01:00:00-04:00,0,8,1,2,0,1878,20562,22440
2014-08-06 02:00:00-04:00,0,8,2,2,0,1435,13763,15198
2014-08-06 03:00:00-04:00,0,8,3,2,0,887,8042,8929
2014-08-06 04:00:00-04:00,0,8,4,2,0,590,5088,5678
2014-08-06 05:00:00-04:00,0,8,5,2,0,416,3398,3814
2014-08-06 06:00:00-04:00,0,8,6,2,0,355,3156,3511
2014-08-06 07:00:00-04:00,0,8,7,2,0,324,4537,4861
2014-08-06 08:00:00-04:00,0,8,8,2,0,566,12023,12589
2014-08-06 09:00:00-04:00,0,8,9,2,0,1146,20380,21526
2014-08-06 10:00:00-04:00,0,8,10,2,0,1847,24117,25964
2014-08-06 11:00:00-04:00,0,8,11,2,0,1837,22846,24683
2014-08-06 12:00:00-04:00,0,8,12,2,0,1584,20409,21993
2014-08-06 13:00:00-04:00,0,8,13,2,0,1539,20109,21648
2014-08-06 14:00:00-04:00,0,8,14,2,0,1582,21335,22917
2014-08-06 15:00:00-04:00,0,8,15,2,0,1579,20858,22437
2014-08-06 16:00:00-04:00,0,8,16,2,0,1690,21086,22776
2014-08-06 17:00:00-04:00,0,8,17,2,0,1967,19825,21792
2014-08-06 18:00:00-04:00,0,8,18,2,0,2122,16538,18660
2014-08-06 19:00:00-04:00,0,8,19,2,0,2449,20759,23208
2014-08-06 20:00:00-04:00,0,8,20,2,0,2640,26596,29236
2014-08-06 21:00:00-04:00,0,8,21,2,0,2654,28461,31115
2014-08-06 22:00:00-04:00,0,8,22,2,0,2366,27772,30138
2014-08-06 23:00:00-04:00,0,8,23,2,0,2317,28509,30826
2014-08-07 00:00:00-04:00,0,8,0,3,0,2211,26808,29019
2014-08-07 01:00:00-04:00,0,8,1,3,0,2076,23093,25169
2014-08-07 02:00:00-04:00,0,8,2,3,0,1632,15767,17399
2014-08-07 03:00:00-04:00,0,8,3,3,0,1167,9637,10804
2014-08-07 04:00:00-04:00,0,8,4,3,0,691,6172,6863
2014-08-07 05:00:00-04:00,0,8,5,3,0,515,4053,4568
2014-08-07 06:00:00-04:00,0,8,6,3,0,442,3529,3971
2014-08-07 07:00:00-04:00,0,8,7,3,0,394,4713,5107
2014-08-07 08:00:00-04:00,0,8,8,3,0,592,11884,12476
2014-08-07 09:00:00-04:00,0,8,9,3,0,1074,19442,20516
2014-08-07 10:00:00-04:00,0,8,10,3,0,1912,23357,25269
2014-08-07 11:00:00-04:00,0,8,11,3,0,1875,22411,24286
2014-08-07 12:00:00-04:00,0,8,12,3,0,1655,20098,21753
2014-08-07 13:00:00-04:00,0,8,13,3,0,1601,20691,22292
2014-08-07 14:00:00-04:00,0,8,14,3,0,1591,21231,22822
2014-08-07 15:00:00-04:00,0,8,15,3,0,1569,20843,22412
2014-08-07 16:00:00-04:00,0,8,16,3,0,1781,21476,23257
2014-08-07 17:00:00-04:00,0,8,17,3,0,1958,19518,21476
2014-08-07 18:00:00-04:00,0,8,18,3,0,2214,15931,18145
2014-08-07 19:00:00-04:00,0,8,19,3,0,2582,19970,22552
2014-08-07 20:00:00-04:00,0,8,20,3,0,2828,26181,29009
2014-08-07 21:00:00-04:00,0,8,21,3,0,2914,28874,31788
2014-08-07 22:00:00-04:00,0,8,22,3,0,2571,28034,30605
2014-08-07 23:00:00-04:00,0,8,23,3,0,2619,28558,31177
2014-08-08 00:00:00-04:00,0,8,0,4,0,2592,28129,30721
2014-08-08 01:00:00-04:00,0,8,1,4,0,2387,26130,28517
2014-08-08 02:00:00-04:00,0,8,2,4,0,2014,20556,22570
2014-08-08 03:00:00-04:00,0,8,3,4,0,1517,14039,15556
2014-08-08 04:00:00-04:00,0,8,4,4,0,1028,9520,10548
2014-08-08 05:00:00-04:00,0,8,5,4,0,701,6439,7140
2014-08-08 06:00:00-04:00,0,8,6,4,0,555,4864,5419
2014-08-08 07:00:00-04:00,0,8,7,4,0,462,5314,5776
2014-08-08 08:00:00-04:00,0,8,8,4,0,604,11187,11791
2014-08-08 09:00:00-04:00,0,8,9,4,0,1091,17668,18759
2014-08-08 10:00:00-04:00,0,8,10,4,0,1788,21945,23733
2014-08-08 11:00:00-04:00,0,8,11,4,0,1946,21466,23412
2014-08-08 12:00:00-04:00,0,8,12,4,0,1707,19394,21101
2014-08-08 13:00:00-04:00,0,8,13,4,0,1603,19158,20761
2014-08-08 14:00:00-04:00,0,8,14,4,0,1605,20330,21935
2014-08-08 15:00:00-04:00,0,8,15,4,0,1578,20018,21596
2014-08-08 16:00:00-04:00,0,8,16,4,0,1787,20795,22582
2014-08-08 17:00:00-04:00,0,8,17,4,0,2179,19276,21455
2014-08-08 18:00:00-04:00,0,8,18,4,0,2426,15994,18420
2014-08-08 19:00:00-04:00,0,8,19,4,0,2887,20728,23615
2014-08-08 20:00:00-04:00,0,8,20,4,0,3195,25747,28942
2014-08-08 21:00:00-04:00,0,8,21,4,0,3323,27723,31046
2014-08-08 22:00:00-04:00,0,8,22,4,0,3153,25900,29053
2014-08-08 23:00:00-04:00,0,8,23,4,0,3063,25018,28081
2014-08-09 00:00:00-04:00,0,8,0,5,0,3283,25816,29099
2014-08-09 01:00:00-04:00,0,8,1,5,0,3556,26904,30460
2014-08-09 02:00:00-04:00,0,8,2,5,0,3448,25789,29237
2014-08-09 03:00:00-04:00,0,8,3,5,0,3157,21878,25035
2014-08-09 04:00:00-04:00,0,8,4,5,0,2796,18713,21509
2014-08-09 05:00:00-04:00,0,8,5,5,0,2209,14323,16532
2014-08-09 06:00:00-04:00,0,8,6,5,0,1635,9141,10776
2014-08-09 07:00:00-04:00,0,8,7,5,0,840,4558,5398
2014-08-09 08:00:00-04:00,0,8,8,5,0,604,5166,5770
2014-08-09 09:00:00-04:00,0,8,9,5,0,703,7023,7726
2014-08-09 10:00:00-04:00,0,8,10,5,0,913,9553,10466
2014-08-09 11:00:00-04:00,0,8,11,5,0,1274,13337,14611
2014-08-09 12:00:00-04:00,0,8,12,5,0,1448,16049,17497
2014-08-09 13:00:00-04:00,0,8,13,5,0,1600,18207,19807
2014-08-09 14:00:00-04:00,0,8,14,5,0,1770,19079,20849
2014-08-09 15:00:00-04:00,0,8,15,5,0,1878,19899,21777
2014-08-09 16:00:00-04:00,0,8,16,5,0,2145,19260,21405
2014-08-09 17:00:00-04:00,0,8,17,5,0,2613,19177,21790
2014-08-09 18:00:00-04:00,0,8,18,5,0,2745,18339,21084
2014-08-09 19:00:00-04:00,0,8,19,5,0,2763,20585,23348
2014-08-09 20:00:00-04:00,0,8,20,5,0,3238,22711,25949
2014-08-09 21:00:00-04:00,0,8,21,5,0,3440,23739,27179
2014-08-09 22:00:00-04:00,0,8,22,5,0,3414,21450,24864
2014-08-09 23:00:00-04:00,0,8,23,5,0,3610,22724,26334
2014-08-10 00:00:00-04:00,0,8,0,6,0,3781,23824,27605
2014-08-10 01:00:00-04:00,0,8,1,6,0,3971,25790,29761
2014-08-10 02:00:00-04:00,0,8,2,6,0,3880,24687,28567
2014-08-10 03:00:00-04:00,0,8,3,6,0,3596,21777,25373
2014-08-10 04:00:00-04:00,0,8,4,6,0,3077,18906,21983
2014-08-10 05:00:00-04:00,0,8,5,6,0,2506,14511,17017
2014-08-10 06:00:00-04:00,0,8,6,6,0,1875,9474,11349
2014-08-10 07:00:00-04:00,0,8,7,6,0,861,4606,5467
2014-08-10 08:00:00-04:00,0,8,8,6,0,583,4235,4818
2014-08-10 09:00:00-04:00,0,8,9,6,0,515,5447,5962
2014-08-10 10:00:00-04:00,0,8,10,6,0,664,7261,7925
2014-08-10 11:00:00-04:00,0,8,11,6,0,903,10731,11634
2014-08-10 12:00:00-04:00,0,8,12,6,0,1247,14498,15745
2014-08-10 13:00:00-04:00,0,8,13,6,0,1447,16920,18367
2014-08-10 14:00:00-04:00,0,8,14,6,0,1588,18379,19967
2014-08-10 15:00:00-04:00,0,8,15,6,0,1718,18831,20549
2014-08-10 16:00:00-04:00,0,8,16,6,0,1867,18907,20774
2014-08-10 17:00:00-04:00,0,8,17,6,0,2092,17917,20009
2014-08-10 18:00:00-04:00,0,8,18,6,0,2252,17539,19791
2014-08-10 19:00:00-04:00,0,8,19,6,0,2341,19216,21557
2014-08-10 20:00:00-04:00,0,8,20,6,0,2486,20479,22965
2014-08-10 21:00:00-04:00,0,8,21,6,0,2487,19411,21898
2014-08-10 22:00:00-04:00,0,8,22,6,0,2294,18703,20997
2014-08-10 23:00:00-04:00,0,8,23,6,0,2346,18372,20718
2014-08-11 00:00:00-04:00,0,8,0,0,0,2213,16810,19023
2014-08-11 01:00:00-04:00,0,8,1,0,0,1955,14507,16462
2014-08-11 02:00:00-04:00,0,8,2,0,0,1534,9892,11426
2014-08-11 03:00:00-04:00,0,8,3,0,0,1028,5786,6814
2014-08-11 04:00:00-04:00,0,8,4,0,0,726,3572,4298
2014-08-11 05:00:00-04:00,0,8,5,0,0,498,2578,3076
2014-08-11 06:00:00-04:00,0,8,6,0,0,526,2915,3441
2014-08-11 07:00:00-04:00,0,8,7,0,0,417,4511,4928
2014-08-11 08:00:00-04:00,0,8,8,0,0,611,10602,11213
2014-08-11 09:00:00-04:00,0,8,9,0,0,1125,17133,18258
2014-08-11 10:00:00-04:00,0,8,10,0,0,1797,20888,22685
2014-08-11 11:00:00-04:00,0,8,11,0,0,1811,20730,22541
2014-08-11 12:00:00-04:00,0,8,12,0,0,1527,17359,18886
2014-08-11 13:00:00-04:00,0,8,13,0,0,1382,17557,18939
2014-08-11 14:00:00-04:00,0,8,14,0,0,1413,18662,20075
2014-08-11 15:00:00-04:00,0,8,15,0,0,1416,18808,20224
2014-08-11 16:00:00-04:00,0,8,16,0,0,1519,19078,20597
2014-08-11 17:00:00-04:00,0,8,17,0,0,1694,18872,20566
2014-08-11 18:00:00-04:00,0,8,18,0,0,1762,17028,18790
2014-08-11 19:00:00-04:00,0,8,19,0,0,1978,20020,21998
2014-08-11 20:00:00-04:00,0,8,20,0,0,2175,24739,26914
2014-08-11 21:00:00-04:00,0,8,21,0,0,2205,24786,26991
2014-08-11 22:00:00-04:00,0,8,22,0,0,1999,23598,25597
2014-08-11 23:00:00-04:00,0,8,23,0,0,1759,22515,24274
2014-08-12 00:00:00-04:00,0,8,0,1,0,1558,20244,21802
2014-08-12 01:00:00-04:00,0,8,1,1,0,1389,15621,17010
2014-08-12 02:00:00-04:00,0,8,2,1,0,1124,10404,11528
2014-08-12 03:00:00-04:00,0,8,3,1,0,769,6360,7129
2014-08-12 04:00:00-04:00,0,8,4,1,0,531,4123,4654
2014-08-12 05:00:00-04:00,0,8,5,1,0,349,2761,3110
2014-08-12 06:00:00-04:00,0,8,6,1,0,355,2726,3081
2014-08-12 07:00:00-04:00,0,8,7,1,0,337,4217,4554
2014-08-12 08:00:00-04:00,0,8,8,1,0,582,10855,11437
2014-08-12 09:00:00-04:00,0,8,9,1,0,1060,18264,19324
2014-08-12 10:00:00-04:00,0,8,10,1,0,1815,23407,25222
2014-08-12 11:00:00-04:00,0,8,11,1,0,1952,22151,24103
2014-08-12 12:00:00-04:00,0,8,12,1,0,1542,19325,20867
2014-08-12 13:00:00-04:00,0,8,13,1,0,1436,19098,20534
2014-08-12 14:00:00-04:00,0,8,14,1,0,1431,20407,21838
2014-08-12 15:00:00-04:00,0,8,15,1,0,1461,20018,21479
2014-08-12 16:00:00-04:00,0,8,16,1,0,1726,22396,24122
2014-08-12 17:00:00-04:00,0,8,17,1,0,1902,20048,21950
2014-08-12 18:00:00-04:00,0,8,18,1,0,1993,15865,17858
2014-08-12 19:00:00-04:00,0,8,19,1,0,2170,19895,22065
2014-08-12 20:00:00-04:00,0,8,20,1,0,2674,26536,29210
2014-08-12 21:00:00-04:00,0.01,8,21,1,0,2917,30050,32967
2014-08-12 22:00:00-04:00,0,8,22,1,0,2197,24646,26843
2014-08-12 23:00:00-04:00,0.02,8,23,1,0,2172,26328,28500
2014-08-13 00:00:00-04:00,0.08,8,0,2,0,1957,24103,26060
2014-08-13 01:00:00-04:00,0.22,8,1,2,0,1763,19314,21077
2014-08-13 02:00:00-04:00,0.11,8,2,2,0,1533,13963,15496
2014-08-13 03:00:00-04:00,0.16,8,3,2,0,1084,8404,9488
2014-08-13 04:00:00-04:00,0.1,8,4,2,0,548,4875,5423
2014-08-13 05:00:00-04:00,0.02,8,5,2,0,404,2989,3393
2014-08-13 06:00:00-04:00,0.01,8,6,2,0,334,2743,3077
2014-08-13 07:00:00-04:00,0.03,8,7,2,0,324,4182,4506
2014-08-13 08:00:00-04:00,0.04,8,8,2,0,610,11802,12412
2014-08-13 09:00:00-04:00,0,8,9,2,0,1247,20696,21943
2014-08-13 10:00:00-04:00,0,8,10,2,0,2000,23543,25543
2014-08-13 11:00:00-04:00,0,8,11,2,0,2045,23432,25477
2014-08-13 12:00:00-04:00,0,8,12,2,0,1681,20142,21823
2014-08-13 13:00:00-04:00,0,8,13,2,0,1549,19048,20597
2014-08-13 14:00:00-04:00,0,8,14,2,0,1575,20411,21986
2014-08-13 15:00:00-04:00,0,8,15,2,0,1579,20343,21922
2014-08-13 16:00:00-04:00,0,8,16,2,0,1604,20508,22112
2014-08-13 17:00:00-04:00,0,8,17,2,0,1783,19559,21342
2014-08-13 18:00:00-04:00,0.11,8,18,2,0,2065,17173,19238
2014-08-13 19:00:00-04:00,0,8,19,2,0,2429,22006,24435
2014-08-13 20:00:00-04:00,0,8,20,2,0,2714,26703,29417
2014-08-13 21:00:00-04:00,0,8,21,2,0,2602,28746,31348
2014-08-13 22:00:00-04:00,0,8,22,2,0,2306,27025,29331
2014-08-13 23:00:00-04:00,0,8,23,2,0,2135,27116,29251
2014-08-14 00:00:00-04:00,0,8,0,3,0,2108,26603,28711
2014-08-14 01:00:00-04:00,0,8,1,3,0,1905,22379,24284
2014-08-14 02:00:00-04:00,0,8,2,3,0,1530,15157,16687
2014-08-14 03:00:00-04:00,0,8,3,3,0,1080,9438,10518
2014-08-14 04:00:00-04:00,0,8,4,3,0,703,6059,6762
2014-08-14 05:00:00-04:00,0,8,5,3,0,520,3927,4447
2014-08-14 06:00:00-04:00,0,8,6,3,0,439,3418,3857
2014-08-14 07:00:00-04:00,0,8,7,3,0,395,4471,4866
2014-08-14 08:00:00-04:00,0,8,8,3,0,576,10893,11469
2014-08-14 09:00:00-04:00,0,8,9,3,0,1142,18394,19536
2014-08-14 10:00:00-04:00,0,8,10,3,0,1837,23258,25095
2014-08-14 11:00:00-04:00,0,8,11,3,0,1880,22144,24024
2014-08-14 12:00:00-04:00,0,8,12,3,0,1633,19946,21579
2014-08-14 13:00:00-04:00,0,8,13,3,0,1550,19637,21187
2014-08-14 14:00:00-04:00,0,8,14,3,0,1537,20581,22118
2014-08-14 15:00:00-04:00,0,8,15,3,0,1555,20420,21975
2014-08-14 16:00:00-04:00,0,8,16,3,0,1699,21186,22885
2014-08-14 17:00:00-04:00,0,8,17,3,0,1897,19664,21561
2014-08-14 18:00:00-04:00,0,8,18,3,0,2096,16466,18562
2014-08-14 19:00:00-04:00,0,8,19,3,0,2435,20165,22600
2014-08-14 20:00:00-04:00,0,8,20,3,0,2657,25685,28342
2014-08-14 21:00:00-04:00,0,8,21,3,0,2682,28260,30942
2014-08-14 22:00:00-04:00,0,8,22,3,0,2540,28151,30691
2014-08-14 23:00:00-04:00,0,8,23,3,0,2550,28047,30597
2014-08-15 00:00:00-04:00,0,8,0,4,0,2594,28137,30731
2014-08-15 01:00:00-04:00,0,8,1,4,0,2352,25785,28137
2014-08-15 02:00:00-04:00,0,8,2,4,0,2054,20624,22678
2014-08-15 03:00:00-04:00,0,8,3,4,0,1556,13418,14974
2014-08-15 04:00:00-04:00,0,8,4,4,0,1084,9139,10223
2014-08-15 05:00:00-04:00,0,8,5,4,0,740,5970,6710
2014-08-15 06:00:00-04:00,0,8,6,4,0,653,4847,5500
2014-08-15 07:00:00-04:00,0,8,7,4,0,415,4859,5274
2014-08-15 08:00:00-04:00,0,8,8,4,0,658,10959,11617
2014-08-15 09:00:00-04:00,0,8,9,4,0,1099,16954,18053
2014-08-15 10:00:00-04:00,0,8,10,4,0,1773,21920,23693
2014-08-15 11:00:00-04:00,0,8,11,4,0,1924,21755,23679
2014-08-15 12:00:00-04:00,0,8,12,4,0,1738,18946,20684
2014-08-15 13:00:00-04:00,0,8,13,4,0,1637,19512,21149
2014-08-15 14:00:00-04:00,0,8,14,4,0,1626,20262,21888
2014-08-15 15:00:00-04:00,0,8,15,4,0,1556,19779,21335
2014-08-15 16:00:00-04:00,0,8,16,4,0,1747,20532,22279
2014-08-15 17:00:00-04:00,0,8,17,4,0,2140,19127,21267
2014-08-15 18:00:00-04:00,0,8,18,4,0,2510,16277,18787
2014-08-15 19:00:00-04:00,0,8,19,4,0,2942,21278,24220
2014-08-15 20:00:00-04:00,0,8,20,4,0,3369,26078,29447
2014-08-15 21:00:00-04:00,0,8,21,4,0,3368,27713,31081
2014-08-15 22:00:00-04:00,0,8,22,4,0,3198,26185,29383
2014-08-15 23:00:00-04:00,0,8,23,4,0,3095,25125,28220
2014-08-16 00:00:00-04:00,0,8,0,5,0,3295,26179,29474
2014-08-16 01:00:00-04:00,0,8,1,5,0,3523,26710,30233
2014-08-16 02:00:00-04:00,0,8,2,5,0,3457,24974,28431
2014-08-16 03:00:00-04:00,0,8,3,5,0,3088,21829,24917
2014-08-16 04:00:00-04:00,0,8,4,5,0,2774,18273,21047
2014-08-16 05:00:00-04:00,0,8,5,5,0,2232,13774,16006
2014-08-16 06:00:00-04:00,0,8,6,5,0,1632,9140,10772
2014-08-16 07:00:00-04:00,0,8,7,5,0,866,4673,5539
2014-08-16 08:00:00-04:00,0,8,8,5,0,674,5443,6117
2014-08-16 09:00:00-04:00,0,8,9,5,0,762,7597,8359
2014-08-16 10:00:00-04:00,0,8,10,5,0,1034,10466,11500
2014-08-16 11:00:00-04:00,0,8,11,5,0,1313,13936,15249
2014-08-16 12:00:00-04:00,0,8,12,5,0,1508,15691,17199
2014-08-16 13:00:00-04:00,0,8,13,5,0,1651,17416,19067
2014-08-16 14:00:00-04:00,0,8,14,5,0,1779,18446,20225
2014-08-16 15:00:00-04:00,0,8,15,5,0,2025,19527,21552
2014-08-16 16:00:00-04:00,0,8,16,5,0,2188,19273,21461
2014-08-16 17:00:00-04:00,0,8,17,5,0,2438,19299,21737
2014-08-16 18:00:00-04:00,0,8,18,5,0,2561,18286,20847
2014-08-16 19:00:00-04:00,0,8,19,5,0,2867,20675,23542
2014-08-16 20:00:00-04:00,0,8,20,5,0,3173,23304,26477
2014-08-16 21:00:00-04:00,0,8,21,5,0,3453,24087,27540
2014-08-16 22:00:00-04:00,0,8,22,5,0,3491,22093,25584
2014-08-16 23:00:00-04:00,0,8,23,5,0,3710,22271,25981
2014-08-17 00:00:00-04:00,0,8,0,6,0,3745,23844,27589
2014-08-17 01:00:00-04:00,0,8,1,6,0,4267,25036,29303
2014-08-17 02:00:00-04:00,0,8,2,6,0,3861,25031,28892
2014-08-17 03:00:00-04:00,0,8,3,6,0,3540,21902,25442
2014-08-17 04:00:00-04:00,0,8,4,6,0,3098,19049,22147
2014-08-17 05:00:00-04:00,0,8,5,6,0,2663,14664,17327
2014-08-17 06:00:00-04:00,0,8,6,6,0,2025,9551,11576
2014-08-17 07:00:00-04:00,0,8,7,6,0,1022,4584,5606
2014-08-17 08:00:00-04:00,0,8,8,6,0,703,4575,5278
2014-08-17 09:00:00-04:00,0.01,8,9,6,0,577,5549,6126
2014-08-17 10:00:00-04:00,0,8,10,6,0,726,8833,9559
2014-08-17 11:00:00-04:00,0,8,11,6,0,1015,11191,12206
2014-08-17 12:00:00-04:00,0,8,12,6,0,1211,14691,15902
2014-08-17 13:00:00-04:00,0,8,13,6,0,1455,17185,18640
2014-08-17 14:00:00-04:00,0,8,14,6,0,1614,18343,19957
2014-08-17 15:00:00-04:00,0,8,15,6,0,1782,19248,21030
2014-08-17 16:00:00-04:00,0,8,16,6,0,1995,19949,21944
2014-08-17 17:00:00-04:00,0,8,17,6,0,2090,18715,20805
2014-08-17 18:00:00-04:00,0,8,18,6,0,2273,18183,20456
2014-08-17 19:00:00-04:00,0,8,19,6,0,2242,19739,21981
2014-08-17 20:00:00-04:00,0,8,20,6,0,2389,20665,23054
2014-08-17 21:00:00-04:00,0,8,21,6,0,2368,19726,22094
2014-08-17 22:00:00-04:00,0,8,22,6,0,2298,18643,20941
2014-08-17 23:00:00-04:00,0,8,23,6,0,2267,18671,20938
2014-08-18 00:00:00-04:00,0,8,0,0,0,2195,17046,19241
2014-08-18 01:00:00-04:00,0,8,1,0,0,1826,14407,16233
2014-08-18 02:00:00-04:00,0,8,2,0,0,1481,10306,11787
2014-08-18 03:00:00-04:00,0,8,3,0,0,968,5923,6891
2014-08-18 04:00:00-04:00,0,8,4,0,0,666,4083,4749
2014-08-18 05:00:00-04:00,0,8,5,0,0,469,2618,3087
2014-08-18 06:00:00-04:00,0,8,6,0,0,500,2820,3320
2014-08-18 07:00:00-04:00,0,8,7,0,0,415,4359,4774
2014-08-18 08:00:00-04:00,0,8,8,0,0,617,10428,11045
2014-08-18 09:00:00-04:00,0,8,9,0,0,1079,16597,17676
2014-08-18 10:00:00-04:00,0,8,10,0,0,1701,21069,22770
2014-08-18 11:00:00-04:00,0,8,11,0,0,1826,20800,22626
2014-08-18 12:00:00-04:00,0,8,12,0,0,1580,17867,19447
2014-08-18 13:00:00-04:00,0,8,13,0,0,1454,17546,19000
2014-08-18 14:00:00-04:00,0,8,14,0,0,1423,18264,19687
2014-08-18 15:00:00-04:00,0,8,15,0,0,1423,18198,19621
2014-08-18 16:00:00-04:00,0,8,16,0,0,1664,19248,20912
2014-08-18 17:00:00-04:00,0,8,17,0,0,1731,18739,20470
2014-08-18 18:00:00-04:00,0,8,18,0,0,1849,17257,19106
2014-08-18 19:00:00-04:00,0,8,19,0,0,2088,20208,22296
2014-08-18 20:00:00-04:00,0,8,20,0,0,2260,24394,26654
2014-08-18 21:00:00-04:00,0,8,21,0,0,2288,24615,26903
2014-08-18 22:00:00-04:00,0,8,22,0,0,2005,23528,25533
2014-08-18 23:00:00-04:00,0,8,23,0,0,1776,22600,24376
2014-08-19 00:00:00-04:00,0,8,0,1,0,1651,20029,21680
2014-08-19 01:00:00-04:00,0,8,1,1,0,1422,15166,16588
2014-08-19 02:00:00-04:00,0,8,2,1,0,1088,10039,11127
2014-08-19 03:00:00-04:00,0,8,3,1,0,760,6288,7048
2014-08-19 04:00:00-04:00,0,8,4,1,0,439,4086,4525
2014-08-19 05:00:00-04:00,0,8,5,1,0,324,2669,2993
2014-08-19 06:00:00-04:00,0,8,6,1,0,327,2573,2900
2014-08-19 07:00:00-04:00,0,8,7,1,0,336,3910,4246
2014-08-19 08:00:00-04:00,0,8,8,1,0,537,10269,10806
2014-08-19 09:00:00-04:00,0,8,9,1,0,986,16929,17915
2014-08-19 10:00:00-04:00,0,8,10,1,0,1667,22116,23783
2014-08-19 11:00:00-04:00,0,8,11,1,0,1849,22029,23878
2014-08-19 12:00:00-04:00,0,8,12,1,0,1487,19415,20902
2014-08-19 13:00:00-04:00,0,8,13,1,0,1381,18859,20240
2014-08-19 14:00:00-04:00,0,8,14,1,0,1372,20328,21700
2014-08-19 15:00:00-04:00,0,8,15,1,0,1448,20091,21539
2014-08-19 16:00:00-04:00,0,8,16,1,0,1643,20975,22618
2014-08-19 17:00:00-04:00,0,8,17,1,0,1695,19789,21484
2014-08-19 18:00:00-04:00,0,8,18,1,0,1843,17109,18952
2014-08-19 19:00:00-04:00,0,8,19,1,0,2130,20797,22927
2014-08-19 20:00:00-04:00,0,8,20,1,0,2284,26026,28310
2014-08-19 21:00:00-04:00,0,8,21,1,0,2315,27142,29457
2014-08-19 22:00:00-04:00,0,8,22,1,0,2150,25901,28051
2014-08-19 23:00:00-04:00,0,8,23,1,0,1952,25476,27428
2014-08-20 00:00:00-04:00,0,8,0,2,0,2062,23922,25984
2014-08-20 01:00:00-04:00,0,8,1,2,0,1678,19259,20937
2014-08-20 02:00:00-04:00,0,8,2,2,0,1400,12491,13891
2014-08-20 03:00:00-04:00,0,8,3,2,0,926,7834,8760
2014-08-20 04:00:00-04:00,0,8,4,2,0,589,5025,5614
2014-08-20 05:00:00-04:00,0,8,5,2,0,457,3331,3788
2014-08-20 06:00:00-04:00,0,8,6,2,0,389,2997,3386
2014-08-20 07:00:00-04:00,0,8,7,2,0,353,4008,4361
2014-08-20 08:00:00-04:00,0,8,8,2,0,616,10190,10806
2014-08-20 09:00:00-04:00,0,8,9,2,0,1114,17699,18813
2014-08-20 10:00:00-04:00,0,8,10,2,0,1734,23118,24852
2014-08-20 11:00:00-04:00,0,8,11,2,0,1824,22546,24370
2014-08-20 12:00:00-04:00,0,8,12,2,0,1576,19835,21411
2014-08-20 13:00:00-04:00,0,8,13,2,0,1482,19775,21257
2014-08-20 14:00:00-04:00,0,8,14,2,0,1542,20734,22276
2014-08-20 15:00:00-04:00,0,8,15,2,0,1482,20659,22141
2014-08-20 16:00:00-04:00,0,8,16,2,0,1651,20858,22509
2014-08-20 17:00:00-04:00,0,8,17,2,0,1819,19132,20951
2014-08-20 18:00:00-04:00,0,8,18,2,0,1961,16437,18398
2014-08-20 19:00:00-04:00,0,8,19,2,0,2326,20508,22834
2014-08-20 20:00:00-04:00,0,8,20,2,0,2476,26814,29290
2014-08-20 21:00:00-04:00,0,8,21,2,0,2545,27819,30364
2014-08-20 22:00:00-04:00,0,8,22,2,0,2301,27070,29371
2014-08-20 23:00:00-04:00,0,8,23,2,0,2199,26581,28780
2014-08-21 00:00:00-04:00,0,8,0,3,0,2106,25791,27897
2014-08-21 01:00:00-04:00,0,8,1,3,0,1899,21137,23036
2014-08-21 02:00:00-04:00,0,8,2,3,0,1516,15045,16561
2014-08-21 03:00:00-04:00,0,8,3,3,0,948,9215,10163
2014-08-21 04:00:00-04:00,0,8,4,3,0,698,5856,6554
2014-08-21 05:00:00-04:00,0.07,8,5,3,0,511,4102,4613
2014-08-21 06:00:00-04:00,0,8,6,3,0,466,3552,4018
2014-08-21 07:00:00-04:00,0,8,7,3,0,382,4765,5147
2014-08-21 08:00:00-04:00,0,8,8,3,0,612,10561,11173
2014-08-21 09:00:00-04:00,0,8,9,3,0,1140,17757,18897
2014-08-21 10:00:00-04:00,0,8,10,3,0,1763,22888,24651
2014-08-21 11:00:00-04:00,0,8,11,3,0,1949,22328,24277
2014-08-21 12:00:00-04:00,0,8,12,3,0,1699,19347,21046
2014-08-21 13:00:00-04:00,0,8,13,3,0,1553,19319,20872
2014-08-21 14:00:00-04:00,0,8,14,3,0,1575,20385,21960
2014-08-21 15:00:00-04:00,0,8,15,3,0,1518,20414,21932
2014-08-21 16:00:00-04:00,0,8,16,3,0,1694,22019,23713
2014-08-21 17:00:00-04:00,0,8,17,3,0,1913,19583,21496
2014-08-21 18:00:00-04:00,0,8,18,3,0,2221,16337,18558
2014-08-21 19:00:00-04:00,0,8,19,3,0,2375,19571,21946
2014-08-21 20:00:00-04:00,0,8,20,3,0,2864,26350,29214
2014-08-21 21:00:00-04:00,0,8,21,3,0,2790,29237,32027
2014-08-21 22:00:00-04:00,0,8,22,3,0,2761,28469,31230
2014-08-21 23:00:00-04:00,0.08,8,23,3,0,2445,28097,30542
2014-08-22 00:00:00-04:00,1.08,8,0,4,0,2734,28825,31559
2014-08-22 01:00:00-04:00,0.04,8,1,4,0,3050,27598,30648
2014-08-22 02:00:00-04:00,0,8,2,4,0,2474,21284,23758
2014-08-22 03:00:00-04:00,0,8,3,4,0,1581,13763,15344
2014-08-22 04:00:00-04:00,0,8,4,4,0,950,8357,9307
2014-08-22 05:00:00-04:00,0,8,5,4,0,609,5234,5843
2014-08-22 06:00:00-04:00,0,8,6,4,0,502,4184,4686
2014-08-22 07:00:00-04:00,0,8,7,4,0,443,4357,4800
2014-08-22 08:00:00-04:00,0,8,8,4,0,619,10143,10762
2014-08-22 09:00:00-04:00,0,8,9,4,0,1044,15958,17002
2014-08-22 10:00:00-04:00,0,8,10,4,0,1795,20399,22194
2014-08-22 11:00:00-04:00,0,8,11,4,0,1885,20472,22357
2014-08-22 12:00:00-04:00,0,8,12,4,0,1632,18487,20119
2014-08-22 13:00:00-04:00,0,8,13,4,0,1600,18075,19675
2014-08-22 14:00:00-04:00,0,8,14,4,0,1532,19113,20645
2014-08-22 15:00:00-04:00,0,8,15,4,0,1439,19231,20670
2014-08-22 16:00:00-04:00,0.03,8,16,4,0,1704,20058,21762
2014-08-22 17:00:00-04:00,0.01,8,17,4,0,2136,18921,21057
2014-08-22 18:00:00-04:00,0,8,18,4,0,2937,16409,19346
2014-08-22 19:00:00-04:00,0,8,19,4,0,2968,19523,22491
2014-08-22 20:00:00-04:00,0,8,20,4,0,3054,23656,26710
2014-08-22 21:00:00-04:00,0,8,21,4,0,3273,25572,28845
2014-08-22 22:00:00-04:00,0,8,22,4,0,3184,23837,27021
2014-08-22 23:00:00-04:00,0,8,23,4,0,3016,22962,25978
2014-08-23 00:00:00-04:00,0,8,0,5,0,3252,24287,27539
2014-08-23 01:00:00-04:00,0,8,1,5,0,3578,25576,29154
2014-08-23 02:00:00-04:00,0,8,2,5,0,3319,24674,27993
2014-08-23 03:00:00-04:00,0,8,3,5,0,3011,20935,23946
2014-08-23 04:00:00-04:00,0,8,4,5,0,2540,17565,20105
2014-08-23 05:00:00-04:00,0,8,5,5,0,2025,13580,15605
2014-08-23 06:00:00-04:00,0,8,6,5,0,1637,8703,10340
2014-08-23 07:00:00-04:00,0,8,7,5,0,802,4391,5193
2014-08-23 08:00:00-04:00,0,8,8,5,0,619,5157,5776
2014-08-23 09:00:00-04:00,0,8,9,5,0,657,6827,7484
2014-08-23 10:00:00-04:00,0,8,10,5,0,892,9138,10030
2014-08-23 11:00:00-04:00,0,8,11,5,0,1189,12563,13752
2014-08-23 12:00:00-04:00,0,8,12,5,0,1396,15013,16409
2014-08-23 13:00:00-04:00,0,8,13,5,0,1548,17056,18604
2014-08-23 14:00:00-04:00,0,8,14,5,0,1621,18046,19667
2014-08-23 15:00:00-04:00,0,8,15,5,0,1691,18609,20300
2014-08-23 16:00:00-04:00,0,8,16,5,0,2089,17897,19986
2014-08-23 17:00:00-04:00,0,8,17,5,0,2362,18019,20381
2014-08-23 18:00:00-04:00,0,8,18,5,0,2754,17891,20645
2014-08-23 19:00:00-04:00,0,8,19,5,0,2726,19199,21925
2014-08-23 20:00:00-04:00,0,8,20,5,0,3154,21862,25016
2014-08-23 21:00:00-04:00,0,8,21,5,0,3312,22914,26226
2014-08-23 22:00:00-04:00,0,8,22,5,0,3628,23994,27622
2014-08-23 23:00:00-04:00,0,8,23,5,0,3448,21057,24505
2014-08-24 00:00:00-04:00,0,8,0,6,0,3469,22836,26305
2014-08-24 01:00:00-04:00,0,8,1,6,0,3773,24564,28337
2014-08-24 02:00:00-04:00,0,8,2,6,0,3725,24280,28005
2014-08-24 03:00:00-04:00,0,8,3,6,0,3538,21582,25120
2014-08-24 04:00:00-04:00,0,8,4,6,0,3078,18865,21943
2014-08-24 05:00:00-04:00,0,8,5,6,0,2437,14545,16982
2014-08-24 06:00:00-04:00,0,8,6,6,0,1892,9222,11114
2014-08-24 07:00:00-04:00,0,8,7,6,0,937,4173,5110
2014-08-24 08:00:00-04:00,0,8,8,6,0,569,4196,4765
2014-08-24 09:00:00-04:00,0,8,9,6,0,559,5424,5983
2014-08-24 10:00:00-04:00,0,8,10,6,0,658,7277,7935
2014-08-24 11:00:00-04:00,0,8,11,6,0,937,10525,11462
2014-08-24 12:00:00-04:00,0,8,12,6,0,1133,13900,15033
2014-08-24 13:00:00-04:00,0,8,13,6,0,1394,16718,18112
2014-08-24 14:00:00-04:00,0,8,14,6,0,1580,17778,19358
2014-08-24 15:00:00-04:00,0,8,15,6,0,1683,18251,19934
2014-08-24 16:00:00-04:00,0,8,16,6,0,1953,18628,20581
2014-08-24 17:00:00-04:00,0,8,17,6,0,2029,17674,19703
2014-08-24 18:00:00-04:00,0,8,18,6,0,2196,17140,19336
2014-08-24 19:00:00-04:00,0,8,19,6,0,2219,18811,21030
2014-08-24 20:00:00-04:00,0,8,20,6,0,2399,19465,21864
2014-08-24 21:00:00-04:00,0,8,21,6,0,2361,19044,21405
2014-08-24 22:00:00-04:00,0,8,22,6,0,2508,18516,21024
2014-08-24 23:00:00-04:00,0,8,23,6,0,2233,17510,19743
2014-08-25 00:00:00-04:00,0,8,0,0,0,2098,16417,18515
2014-08-25 01:00:00-04:00,0,8,1,0,0,1935,14295,16230
2014-08-25 02:00:00-04:00,0,8,2,0,0,1509,9402,10911
2014-08-25 03:00:00-04:00,0,8,3,0,0,973,5289,6262
2014-08-25 04:00:00-04:00,0,8,4,0,0,676,3564,4240
2014-08-25 05:00:00-04:00,0,8,5,0,0,563,2595,3158
2014-08-25 06:00:00-04:00,0,8,6,0,0,523,2715,3238
2014-08-25 07:00:00-04:00,0,8,7,0,0,413,4015,4428
2014-08-25 08:00:00-04:00,0,8,8,0,0,644,9756,10400
2014-08-25 09:00:00-04:00,0,8,9,0,0,1092,15591,16683
2014-08-25 10:00:00-04:00,0,8,10,0,0,1767,19659,21426
2014-08-25 11:00:00-04:00,0,8,11,0,0,1796,19406,21202
2014-08-25 12:00:00-04:00,0,8,12,0,0,1509,16694,18203
2014-08-25 13:00:00-04:00,0,8,13,0,0,1390,16403,17793
2014-08-25 14:00:00-04:00,0,8,14,0,0,1372,17287,18659
2014-08-25 15:00:00-04:00,0,8,15,0,0,1404,17958,19362
2014-08-25 16:00:00-04:00,0,8,16,0,0,1600,18564,20164
2014-08-25 17:00:00-04:00,0,8,17,0,0,1689,17974,19663
2014-08-25 18:00:00-04:00,0,8,18,0,0,1898,17019,18917
2014-08-25 19:00:00-04:00,0,8,19,0,0,1948,20421,22369
2014-08-25 20:00:00-04:00,0,8,20,0,0,2233,23659,25892
2014-08-25 21:00:00-04:00,0,8,21,0,0,2256,23536,25792
2014-08-25 22:00:00-04:00,0,8,22,0,0,2124,22494,24618
2014-08-25 23:00:00-04:00,0,8,23,0,0,1747,20688,22435
2014-08-26 00:00:00-04:00,0,8,0,1,0,1593,18604,20197
2014-08-26 01:00:00-04:00,0,8,1,1,0,1425,14705,16130
2014-08-26 02:00:00-04:00,0,8,2,1,0,1142,9890,11032
2014-08-26 03:00:00-04:00,0,8,3,1,0,756,5970,6726
2014-08-26 04:00:00-04:00,0,8,4,1,0,531,3734,4265
2014-08-26 05:00:00-04:00,0,8,5,1,0,364,2524,2888
2014-08-26 06:00:00-04:00,0,8,6,1,0,340,2453,2793
2014-08-26 07:00:00-04:00,0,8,7,1,0,308,3607,3915
2014-08-26 08:00:00-04:00,0,8,8,1,0,578,9828,10406
2014-08-26 09:00:00-04:00,0,8,9,1,0,1033,15989,17022
2014-08-26 10:00:00-04:00,0,8,10,1,0,1713,21214,22927
2014-08-26 11:00:00-04:00,0,8,11,1,0,1770,20901,22671
2014-08-26 12:00:00-04:00,0,8,12,1,0,1592,18745,20337
2014-08-26 13:00:00-04:00,0,8,13,1,0,1385,18489,19874
2014-08-26 14:00:00-04:00,0,8,14,1,0,1396,19540,20936
2014-08-26 15:00:00-04:00,0,8,15,1,0,1457,19873,21330
2014-08-26 16:00:00-04:00,0,8,16,1,0,1557,20083,21640
2014-08-26 17:00:00-04:00,0,8,17,1,0,1790,19154,20944
2014-08-26 18:00:00-04:00,0,8,18,1,0,1902,16503,18405
2014-08-26 19:00:00-04:00,0,8,19,1,0,2136,20172,22308
2014-08-26 20:00:00-04:00,0,8,20,1,0,2328,25443,27771
2014-08-26 21:00:00-04:00,0,8,21,1,0,2292,25591,27883
2014-08-26 22:00:00-04:00,0,8,22,1,0,2258,24869,27127
2014-08-26 23:00:00-04:00,0,8,23,1,0,2051,24120,26171
2014-08-27 00:00:00-04:00,0,8,0,2,0,1908,22045,23953
2014-08-27 01:00:00-04:00,0,8,1,2,0,1674,18529,20203
2014-08-27 02:00:00-04:00,0,8,2,2,0,1278,11901,13179
2014-08-27 03:00:00-04:00,0,8,3,2,0,824,7314,8138
2014-08-27 04:00:00-04:00,0,8,4,2,0,547,4740,5287
2014-08-27 05:00:00-04:00,0,8,5,2,0,387,3009,3396
2014-08-27 06:00:00-04:00,0,8,6,2,0,379,2752,3131
2014-08-27 07:00:00-04:00,0,8,7,2,0,329,3697,4026
2014-08-27 08:00:00-04:00,0,8,8,2,0,616,9873,10489
2014-08-27 09:00:00-04:00,0,8,9,2,0,1086,16764,17850
2014-08-27 10:00:00-04:00,0,8,10,2,0,1730,21841,23571
2014-08-27 11:00:00-04:00,0,8,11,2,0,1857,21722,23579
2014-08-27 12:00:00-04:00,0,8,12,2,0,1611,19131,20742
2014-08-27 13:00:00-04:00,0,8,13,2,0,1559,19580,21139
2014-08-27 14:00:00-04:00,0,8,14,2,0,1518,20391,21909
2014-08-27 15:00:00-04:00,0,8,15,2,0,1639,20420,22059
2014-08-27 16:00:00-04:00,0,8,16,2,0,1798,21317,23115
2014-08-27 17:00:00-04:00,0,8,17,2,0,1945,19679,21624
2014-08-27 18:00:00-04:00,0,8,18,2,0,2030,17259,19289
2014-08-27 19:00:00-04:00,0,8,19,2,0,2375,21208,23583
2014-08-27 20:00:00-04:00,0,8,20,2,0,2666,26181,28847
2014-08-27 21:00:00-04:00,0,8,21,2,0,2668,27852,30520
2014-08-27 22:00:00-04:00,0,8,22,2,0,2518,26967,29485
2014-08-27 23:00:00-04:00,0,8,23,2,0,2253,26027,28280
2014-08-28 00:00:00-04:00,0,8,0,3,0,2388,26172,28560
2014-08-28 01:00:00-04:00,0,8,1,3,0,1954,19813,21767
2014-08-28 02:00:00-04:00,0,8,2,3,0,1569,13889,15458
2014-08-28 03:00:00-04:00,0,8,3,3,0,1138,8842,9980
2014-08-28 04:00:00-04:00,0,8,4,3,0,681,5489,6170
2014-08-28 05:00:00-04:00,0,8,5,3,0,447,3522,3969
2014-08-28 06:00:00-04:00,0,8,6,3,0,457,3088,3545
2014-08-28 07:00:00-04:00,0,8,7,3,0,349,3932,4281
2014-08-28 08:00:00-04:00,0,8,8,3,0,600,9829,10429
2014-08-28 09:00:00-04:00,0,8,9,3,0,1107,16290,17397
2014-08-28 10:00:00-04:00,0,8,10,3,0,1845,21554,23399
2014-08-28 11:00:00-04:00,0,8,11,3,0,1890,21428,23318
2014-08-28 12:00:00-04:00,0,8,12,3,0,1691,19033,20724
2014-08-28 13:00:00-04:00,0,8,13,3,0,1608,18938,20546
2014-08-28 14:00:00-04:00,0,8,14,3,0,1532,19567,21099
2014-08-28 15:00:00-04:00,0,8,15,3,0,1606,19776,21382
2014-08-28 16:00:00-04:00,0,8,16,3,0,1686,20553,22239
2014-08-28 17:00:00-04:00,0,8,17,3,0,1937,19298,21235
2014-08-28 18:00:00-04:00,0,8,18,3,0,2152,16334,18486
2014-08-28 19:00:00-04:00,0,8,19,3,0,2411,20333,22744
2014-08-28 20:00:00-04:00,0,8,20,3,0,2827,25316,28143
2014-08-28 21:00:00-04:00,0,8,21,3,0,2763,26728,29491
2014-08-28 22:00:00-04:00,0,8,22,3,0,2788,26226,29014
2014-08-28 23:00:00-04:00,0,8,23,3,0,2674,25851,28525
2014-08-29 00:00:00-04:00,0,8,0,4,0,2593,25645,28238
2014-08-29 01:00:00-04:00,0,8,1,4,0,2294,23188,25482
2014-08-29 02:00:00-04:00,0,8,2,4,0,1944,17897,19841
2014-08-29 03:00:00-04:00,0,8,3,4,0,1448,12608,14056
2014-08-29 04:00:00-04:00,0,8,4,4,0,994,8766,9760
2014-08-29 05:00:00-04:00,0,8,5,4,0,641,5797,6438
2014-08-29 06:00:00-04:00,0,8,6,4,0,581,4566,5147
2014-08-29 07:00:00-04:00,0,8,7,4,0,413,4660,5073
2014-08-29 08:00:00-04:00,0,8,8,4,0,632,9581,10213
2014-08-29 09:00:00-04:00,0,8,9,4,0,1126,14588,15714
2014-08-29 10:00:00-04:00,0,8,10,4,0,1786,18715,20501
2014-08-29 11:00:00-04:00,0,8,11,4,0,1906,18949,20855
2014-08-29 12:00:00-04:00,0,8,12,4,0,1760,17480,19240
2014-08-29 13:00:00-04:00,0,8,13,4,0,1687,18341,20028
2014-08-29 14:00:00-04:00,0,8,14,4,0,1670,19365,21035
2014-08-29 15:00:00-04:00,0,8,15,4,0,1686,19861,21547
2014-08-29 16:00:00-04:00,0,8,16,4,0,1943,20736,22679
2014-08-29 17:00:00-04:00,0,8,17,4,0,2359,19727,22086
2014-08-29 18:00:00-04:00,0,8,18,4,0,2739,17173,19912
2014-08-29 19:00:00-04:00,0,8,19,4,0,2924,21090,24014
2014-08-29 20:00:00-04:00,0,8,20,4,0,3300,24339,27639
2014-08-29 21:00:00-04:00,0,8,21,4,0,3330,24759,28089
2014-08-29 22:00:00-04:00,0,8,22,4,0,3366,23123,26489
2014-08-29 23:00:00-04:00,0,8,23,4,0,3317,21883,25200
2014-08-30 00:00:00-04:00,0,8,0,5,0,3402,22908,26310
2014-08-30 01:00:00-04:00,0,8,1,5,0,3721,23584,27305
2014-08-30 02:00:00-04:00,0,8,2,5,0,3545,22215,25760
2014-08-30 03:00:00-04:00,0,8,3,5,0,3113,18184,21297
2014-08-30 04:00:00-04:00,0,8,4,5,0,2530,15196,17726
2014-08-30 05:00:00-04:00,0,8,5,5,0,2159,11711,13870
2014-08-30 06:00:00-04:00,0,8,6,5,0,1691,7992,9683
2014-08-30 07:00:00-04:00,0,8,7,5,0,802,4107,4909
2014-08-30 08:00:00-04:00,0,8,8,5,0,674,4896,5570
2014-08-30 09:00:00-04:00,0,8,9,5,0,680,6779,7459
2014-08-30 10:00:00-04:00,0,8,10,5,0,926,8791,9717
2014-08-30 11:00:00-04:00,0,8,11,5,0,1139,12509,13648
2014-08-30 12:00:00-04:00,0,8,12,5,0,1445,14747,16192
2014-08-30 13:00:00-04:00,0,8,13,5,0,1594,16768,18362
2014-08-30 14:00:00-04:00,0,8,14,5,0,1782,17711,19493
2014-08-30 15:00:00-04:00,0,8,15,5,0,1853,18407,20260
2014-08-30 16:00:00-04:00,0,8,16,5,0,2127,18354,20481
2014-08-30 17:00:00-04:00,0,8,17,5,0,2436,18562,20998
2014-08-30 18:00:00-04:00,0,8,18,5,0,2651,17577,20228
2014-08-30 19:00:00-04:00,0,8,19,5,0,2771,19489,22260
2014-08-30 20:00:00-04:00,0,8,20,5,0,3211,20698,23909
2014-08-30 21:00:00-04:00,0,8,21,5,0,3136,21487,24623
2014-08-30 22:00:00-04:00,0,8,22,5,0,3170,19171,22341
2014-08-30 23:00:00-04:00,0,8,23,5,0,3299,19251,22550
2014-08-31 00:00:00-04:00,0,8,0,6,0,3430,20434,23864
2014-08-31 01:00:00-04:00,0,8,1,6,0,3731,21292,25023
2014-08-31 02:00:00-04:00,0,8,2,6,0,3544,20523,24067
2014-08-31 03:00:00-04:00,0,8,3,6,0,3109,17546,20655
2014-08-31 04:00:00-04:00,0,8,4,6,0,2676,14655,17331
2014-08-31 05:00:00-04:00,0,8,5,6,0,2331,11360,13691
2014-08-31 06:00:00-04:00,0,8,6,6,0,1779,7928,9707
2014-08-31 07:00:00-04:00,0,8,7,6,0,948,3735,4683
2014-08-31 08:00:00-04:00,0,8,8,6,0,593,3471,4064
2014-08-31 09:00:00-04:00,0,8,9,6,0,575,4577,5152
2014-08-31 10:00:00-04:00,0,8,10,6,0,674,6245,6919
2014-08-31 11:00:00-04:00,0,8,11,6,0,899,9578,10477
2014-08-31 12:00:00-04:00,0,8,12,6,0,1206,13469,14675
2014-08-31 13:00:00-04:00,0,8,13,6,0,1471,16602,18073
2014-08-31 14:00:00-04:00,0,8,14,6,0,1660,18055,19715
2014-08-31 15:00:00-04:00,0,8,15,6,0,1806,19121,20927
2014-08-31 16:00:00-04:00,0.21,8,16,6,0,2038,19542,21580
2014-08-31 17:00:00-04:00,0.58,8,17,6,0,2357,18944,21301
2014-08-31 18:00:00-04:00,0,8,18,6,0,2858,19053,21911
2014-08-31 19:00:00-04:00,0,8,19,6,0,2746,18509,21255
2014-08-31 20:00:00-04:00,0,8,20,6,0,2647,19232,21879
2014-08-31 21:00:00-04:00,0,8,21,6,0,2444,18891,21335
2014-08-31 22:00:00-04:00,0,8,22,6,0,2554,18810,21364
2014-08-31 23:00:00-04:00,0,8,23,6,0,2426,17584,20010
2014-09-01 00:00:00-04:00,0,9,0,0,1,2565,17295,19860
2014-09-01 01:00:00-04:00,0,9,1,0,1,2501,17664,20165
2014-09-01 02:00:00-04:00,0,9,2,0,1,2182,15684,17866
2014-09-01 03:00:00-04:00,0,9,3,0,1,1803,11701,13504
2014-09-01 04:00:00-04:00,0,9,4,0,1,1429,9280,10709
2014-09-01 05:00:00-04:00,0,9,5,0,1,1100,7015,8115
2014-09-01 06:00:00-04:00,0,9,6,0,1,974,5141,6115
2014-09-01 07:00:00-04:00,0,9,7,0,1,514,3380,3894
2014-09-01 08:00:00-04:00,0,9,8,0,1,541,4120,4661
2014-09-01 09:00:00-04:00,0,9,9,0,1,533,5097,5630
2014-09-01 10:00:00-04:00,0,9,10,0,1,587,6437,7024
2014-09-01 11:00:00-04:00,0,9,11,0,1,785,9147,9932
2014-09-01 12:00:00-04:00,0,9,12,0,1,995,12189,13184
2014-09-01 13:00:00-04:00,0,9,13,0,1,1205,14804,16009
2014-09-01 14:00:00-04:00,0,9,14,0,1,1409,16690,18099
2014-09-01 15:00:00-04:00,0,9,15,0,1,1513,17547,19060
2014-09-01 16:00:00-04:00,0,9,16,0,1,1708,18686,20394
2014-09-01 17:00:00-04:00,0,9,17,0,1,1926,19220,21146
2014-09-01 18:00:00-04:00,0,9,18,0,1,2063,18137,20200
2014-09-01 19:00:00-04:00,0,9,19,0,1,2223,19850,22073
2014-09-01 20:00:00-04:00,0,9,20,0,1,2184,20121,22305
2014-09-01 21:00:00-04:00,0,9,21,0,1,2185,19991,22176
2014-09-01 22:00:00-04:00,0,9,22,0,1,2243,19198,21441
2014-09-01 23:00:00-04:00,0,9,23,0,1,2147,17710,19857
2014-09-02 00:00:00-04:00,0,9,0,1,0,2019,15839,17858
2014-09-02 01:00:00-04:00,0,9,1,1,0,1681,12173,13854
2014-09-02 02:00:00-04:00,0,9,2,1,0,1281,8071,9352
2014-09-02 03:00:00-04:00,0,9,3,1,0,795,4796,5591
2014-09-02 04:00:00-04:00,0,9,4,1,0,541,2779,3320
2014-09-02 05:00:00-04:00,0,9,5,1,0,389,2029,2418
2014-09-02 06:00:00-04:00,0,9,6,1,0,387,2313,2700
2014-09-02 07:00:00-04:00,0,9,7,1,0,364,4415,4779
2014-09-02 08:00:00-04:00,0,9,8,1,0,659,11997,12656
2014-09-02 09:00:00-04:00,0,9,9,1,0,1365,20623,21988
2014-09-02 10:00:00-04:00,0,9,10,1,0,1897,23335,25232
2014-09-02 11:00:00-04:00,0,9,11,1,0,1905,23283,25188
2014-09-02 12:00:00-04:00,0,9,12,1,0,1703,20684,22387
2014-09-02 13:00:00-04:00,0,9,13,1,0,1627,20232,21859
2014-09-02 14:00:00-04:00,0,9,14,1,0,1612,21413,23025
2014-09-02 15:00:00-04:00,0,9,15,1,0,1563,21910,23473
2014-09-02 16:00:00-04:00,0,9,16,1,0,1776,22003,23779
2014-09-02 17:00:00-04:00,0,9,17,1,0,1899,21415,23314
2014-09-02 18:00:00-04:00,0,9,18,1,0,2146,17869,20015
2014-09-02 19:00:00-04:00,0,9,19,1,0,2383,20862,23245
2014-09-02 20:00:00-04:00,0,9,20,1,0,2555,26614,29169
2014-09-02 21:00:00-04:00,0,9,21,1,0,2458,27093,29551
2014-09-02 22:00:00-04:00,0,9,22,1,0,2270,25205,27475
2014-09-02 23:00:00-04:00,0,9,23,1,0,1998,23533,25531
2014-09-03 00:00:00-04:00,0,9,0,2,0,1890,19979,21869
2014-09-03 01:00:00-04:00,0,9,1,2,0,1557,15880,17437
2014-09-03 02:00:00-04:00,0,9,2,2,0,1247,11121,12368
2014-09-03 03:00:00-04:00,0,9,3,2,0,788,6362,7150
2014-09-03 04:00:00-04:00,0,9,4,2,0,446,3809,4255
2014-09-03 05:00:00-04:00,0,9,5,2,0,325,2655,2980
2014-09-03 06:00:00-04:00,0,9,6,2,0,351,2511,2862
2014-09-03 07:00:00-04:00,0,9,7,2,0,365,4046,4411
2014-09-03 08:00:00-04:00,0,9,8,2,0,631,11911,12542
2014-09-03 09:00:00-04:00,0,9,9,2,0,1238,21187,22425
2014-09-03 10:00:00-04:00,0,9,10,2,0,2008,24844,26852
2014-09-03 11:00:00-04:00,0,9,11,2,0,1993,23622,25615
2014-09-03 12:00:00-04:00,0,9,12,2,0,1856,22108,23964
2014-09-03 13:00:00-04:00,0,9,13,2,0,1746,21787,23533
2014-09-03 14:00:00-04:00,0,9,14,2,0,1728,22000,23728
2014-09-03 15:00:00-04:00,0,9,15,2,0,1802,21986,23788
2014-09-03 16:00:00-04:00,0,9,16,2,0,1853,22667,24520
2014-09-03 17:00:00-04:00,0,9,17,2,0,2037,21393,23430
2014-09-03 18:00:00-04:00,0,9,18,2,0,2276,17901,20177
2014-09-03 19:00:00-04:00,0,9,19,2,0,2497,21644,24141
2014-09-03 20:00:00-04:00,0,9,20,2,0,2764,27408,30172
2014-09-03 21:00:00-04:00,0,9,21,2,0,2694,29301,31995
2014-09-03 22:00:00-04:00,0,9,22,2,0,2621,28444,31065
2014-09-03 23:00:00-04:00,0,9,23,2,0,2254,27335,29589
2014-09-04 00:00:00-04:00,0,9,0,3,0,2119,24976,27095
2014-09-04 01:00:00-04:00,0,9,1,3,0,1872,20022,21894
2014-09-04 02:00:00-04:00,0,9,2,3,0,1418,13854,15272
2014-09-04 03:00:00-04:00,0,9,3,3,0,1031,8889,9920
2014-09-04 04:00:00-04:00,0,9,4,3,0,620,5842,6462
2014-09-04 05:00:00-04:00,0,9,5,3,0,430,3402,3832
2014-09-04 06:00:00-04:00,0,9,6,3,0,376,3044,3420
2014-09-04 07:00:00-04:00,0,9,7,3,0,332,4293,4625
2014-09-04 08:00:00-04:00,0,9,8,3,0,696,11974,12670
2014-09-04 09:00:00-04:00,0,9,9,3,0,1664,22394,24058
2014-09-04 10:00:00-04:00,0,9,10,3,0,2215,24999,27214
2014-09-04 11:00:00-04:00,0,9,11,3,0,2171,23993,26164
2014-09-04 12:00:00-04:00,0,9,12,3,0,1916,22615,24531
2014-09-04 13:00:00-04:00,0,9,13,3,0,1827,22232,24059
2014-09-04 14:00:00-04:00,0,9,14,3,0,1763,23305,25068
2014-09-04 15:00:00-04:00,0,9,15,3,0,1668,22496,24164
2014-09-04 16:00:00-04:00,0,9,16,3,0,1993,24275,26268
2014-09-04 17:00:00-04:00,0,9,17,3,0,2174,21960,24134
2014-09-04 18:00:00-04:00,0,9,18,3,0,2354,17198,19552
2014-09-04 19:00:00-04:00,0,9,19,3,0,2516,21089,23605
2014-09-04 20:00:00-04:00,0,9,20,3,0,2917,27328,30245
2014-09-04 21:00:00-04:00,0,9,21,3,0,3055,30427,33482
2014-09-04 22:00:00-04:00,0,9,22,3,0,2866,30581,33447
2014-09-04 23:00:00-04:00,0,9,23,3,0,2474,29269,31743
2014-09-05 00:00:00-04:00,0,9,0,4,0,2512,28628,31140
2014-09-05 01:00:00-04:00,0,9,1,4,0,2420,25413,27833
2014-09-05 02:00:00-04:00,0,9,2,4,0,1893,20208,22101
2014-09-05 03:00:00-04:00,0,9,3,4,0,1205,12661,13866
2014-09-05 04:00:00-04:00,0,9,4,4,0,794,8453,9247
2014-09-05 05:00:00-04:00,0,9,5,4,0,546,5730,6276
2014-09-05 06:00:00-04:00,0,9,6,4,0,504,4520,5024
2014-09-05 07:00:00-04:00,0,9,7,4,0,386,4891,5277
2014-09-05 08:00:00-04:00,0,9,8,4,0,722,13167,13889
2014-09-05 09:00:00-04:00,0,9,9,4,0,1540,22303,23843
2014-09-05 10:00:00-04:00,0,9,10,4,0,2140,25097,27237
2014-09-05 11:00:00-04:00,0,9,11,4,0,2084,24037,26121
2014-09-05 12:00:00-04:00,0,9,12,4,0,1873,22757,24630
2014-09-05 13:00:00-04:00,0,9,13,4,0,1818,22717,24535
2014-09-05 14:00:00-04:00,0,9,14,4,0,1695,22669,24364
2014-09-05 15:00:00-04:00,0,9,15,4,0,1679,21715,23394
2014-09-05 16:00:00-04:00,0,9,16,4,0,2030,23525,25555
2014-09-05 17:00:00-04:00,0,9,17,4,0,2401,21330,23731
2014-09-05 18:00:00-04:00,0,9,18,4,0,2660,17319,19979
2014-09-05 19:00:00-04:00,0,9,19,4,0,3052,21981,25033
2014-09-05 20:00:00-04:00,0,9,20,4,0,3554,28570,32124
2014-09-05 21:00:00-04:00,0,9,21,4,0,3609,31614,35223
2014-09-05 22:00:00-04:00,0,9,22,4,0,3506,30832,34338
2014-09-05 23:00:00-04:00,0,9,23,4,0,3450,29864,33314
2014-09-06 00:00:00-04:00,0,9,0,5,0,3499,30552,34051
2014-09-06 01:00:00-04:00,0,9,1,5,0,3678,30202,33880
2014-09-06 02:00:00-04:00,0,9,2,5,0,3524,28063,31587
2014-09-06 03:00:00-04:00,0,9,3,5,0,3203,24179,27382
2014-09-06 04:00:00-04:00,0,9,4,5,0,2724,20545,23269
2014-09-06 05:00:00-04:00,0,9,5,5,0,2095,14962,17057
2014-09-06 06:00:00-04:00,0,9,6,5,0,1556,9397,10953
2014-09-06 07:00:00-04:00,0,9,7,5,0,765,4881,5646
2014-09-06 08:00:00-04:00,0,9,8,5,0,664,5506,6170
2014-09-06 09:00:00-04:00,0,9,9,5,0,733,8150,8883
2014-09-06 10:00:00-04:00,0,9,10,5,0,1051,12009,13060
2014-09-06 11:00:00-04:00,0,9,11,5,0,1418,17149,18567
2014-09-06 12:00:00-04:00,0,9,12,5,0,1670,20552,22222
2014-09-06 13:00:00-04:00,0,9,13,5,0,1922,22809,24731
2014-09-06 14:00:00-04:00,0,9,14,5,0,2037,23926,25963
2014-09-06 15:00:00-04:00,0.08,9,15,5,0,2183,24668,26851
2014-09-06 16:00:00-04:00,0,9,16,5,0,2487,24942,27429
2014-09-06 17:00:00-04:00,0,9,17,5,0,2800,25037,27837
2014-09-06 18:00:00-04:00,0,9,18,5,0,2857,20224,23081
2014-09-06 19:00:00-04:00,0,9,19,5,0,3013,23611,26624
2014-09-06 20:00:00-04:00,0,9,20,5,0,3487,27875,31362
2014-09-06 21:00:00-04:00,0,9,21,5,0,3535,28955,32490
2014-09-06 22:00:00-04:00,0,9,22,5,0,3662,26958,30620
2014-09-06 23:00:00-04:00,0.12,9,23,5,0,3407,26030,29437
2014-09-07 00:00:00-04:00,0.01,9,0,6,0,4271,30327,34598
2014-09-07 01:00:00-04:00,0,9,1,6,0,4475,32345,36820
2014-09-07 02:00:00-04:00,0,9,2,6,0,3651,28034,31685
2014-09-07 03:00:00-04:00,0,9,3,6,0,3465,25154,28619
2014-09-07 04:00:00-04:00,0,9,4,6,0,2928,21050,23978
2014-09-07 05:00:00-04:00,0,9,5,6,0,2309,16251,18560
2014-09-07 06:00:00-04:00,0,9,6,6,0,1827,10067,11894
2014-09-07 07:00:00-04:00,0,9,7,6,0,879,4763,5642
2014-09-07 08:00:00-04:00,0,9,8,6,0,650,4633,5283
2014-09-07 09:00:00-04:00,0,9,9,6,0,637,6357,6994
2014-09-07 10:00:00-04:00,0,9,10,6,0,769,9647,10416
2014-09-07 11:00:00-04:00,0,9,11,6,0,1106,13914,15020
2014-09-07 12:00:00-04:00,0,9,12,6,0,1359,19343,20702
2014-09-07 13:00:00-04:00,0,9,13,6,0,1615,22571,24186
2014-09-07 14:00:00-04:00,0,9,14,6,0,1946,24930,26876
2014-09-07 15:00:00-04:00,0,9,15,6,0,1988,23957,25945
2014-09-07 16:00:00-04:00,0,9,16,6,0,2134,23323,25457
2014-09-07 17:00:00-04:00,0,9,17,6,0,2329,22003,24332
2014-09-07 18:00:00-04:00,0,9,18,6,0,2487,21988,24475
2014-09-07 19:00:00-04:00,0,9,19,6,0,2534,22911,25445
2014-09-07 20:00:00-04:00,0,9,20,6,0,2691,24609,27300
2014-09-07 21:00:00-04:00,0,9,21,6,0,2573,23743,26316
2014-09-07 22:00:00-04:00,0,9,22,6,0,2498,22368,24866
2014-09-07 23:00:00-04:00,0,9,23,6,0,2318,20622,22940
2014-09-08 00:00:00-04:00,0,9,0,0,0,2193,18809,21002
2014-09-08 01:00:00-04:00,0,9,1,0,0,1763,14912,16675
2014-09-08 02:00:00-04:00,0,9,2,0,0,1307,10202,11509
2014-09-08 03:00:00-04:00,0,9,3,0,0,843,5909,6752
2014-09-08 04:00:00-04:00,0,9,4,0,0,548,4155,4703
2014-09-08 05:00:00-04:00,0,9,5,0,0,468,2923,3391
2014-09-08 06:00:00-04:00,0,9,6,0,0,461,3081,3542
2014-09-08 07:00:00-04:00,0,9,7,0,0,389,5001,5390
2014-09-08 08:00:00-04:00,0,9,8,0,0,681,12239,12920
2014-09-08 09:00:00-04:00,0,9,9,0,0,1562,20543,22105
2014-09-08 10:00:00-04:00,0,9,10,0,0,2090,23090,25180
2014-09-08 11:00:00-04:00,0,9,11,0,0,2005,22523,24528
2014-09-08 12:00:00-04:00,0,9,12,0,0,1766,20757,22523
2014-09-08 13:00:00-04:00,0,9,13,0,0,1628,20333,21961
2014-09-08 14:00:00-04:00,0,9,14,0,0,1597,21460,23057
2014-09-08 15:00:00-04:00,0,9,15,0,0,1572,21154,22726
2014-09-08 16:00:00-04:00,0,9,16,0,0,1841,22586,24427
2014-09-08 17:00:00-04:00,0,9,17,0,0,1897,22196,24093
2014-09-08 18:00:00-04:00,0,9,18,0,0,2106,19099,21205
2014-09-08 19:00:00-04:00,0,9,19,0,0,2416,23074,25490
2014-09-08 20:00:00-04:00,0,9,20,0,0,2428,28230,30658
2014-09-08 21:00:00-04:00,0,9,21,0,0,2426,28782,31208
2014-09-08 22:00:00-04:00,0,9,22,0,0,2143,27820,29963
2014-09-08 23:00:00-04:00,0,9,23,0,0,1819,25520,27339
2014-09-09 00:00:00-04:00,0,9,0,1,0,1675,23276,24951
2014-09-09 01:00:00-04:00,0,9,1,1,0,1390,16658,18048
2014-09-09 02:00:00-04:00,0,9,2,1,0,1061,11069,12130
2014-09-09 03:00:00-04:00,0,9,3,1,0,750,6791,7541
2014-09-09 04:00:00-04:00,0,9,4,1,0,465,4432,4897
2014-09-09 05:00:00-04:00,0,9,5,1,0,339,2985,3324
2014-09-09 06:00:00-04:00,0,9,6,1,0,366,2873,3239
2014-09-09 07:00:00-04:00,0,9,7,1,0,323,4427,4750
2014-09-09 08:00:00-04:00,0,9,8,1,0,626,12222,12848
2014-09-09 09:00:00-04:00,0,9,9,1,0,1506,22637,24143
2014-09-09 10:00:00-04:00,0,9,10,1,0,2052,24930,26982
2014-09-09 11:00:00-04:00,0,9,11,1,0,1948,23388,25336
2014-09-09 12:00:00-04:00,0,9,12,1,0,1722,21498,23220
2014-09-09 13:00:00-04:00,0,9,13,1,0,1550,21727,23277
2014-09-09 14:00:00-04:00,0,9,14,1,0,1576,22615,24191
2014-09-09 15:00:00-04:00,0,9,15,1,0,1559,22082,23641
2014-09-09 16:00:00-04:00,0,9,16,1,0,1950,24142,26092
2014-09-09 17:00:00-04:00,0,9,17,1,0,2234,21566,23800
2014-09-09 18:00:00-04:00,0,9,18,1,0,2136,16794,18930
2014-09-09 19:00:00-04:00,0,9,19,1,0,2325,22308,24633
2014-09-09 20:00:00-04:00,0,9,20,1,0,2692,27917,30609
2014-09-09 21:00:00-04:00,0,9,21,1,0,2553,29382,31935
2014-09-09 22:00:00-04:00,0,9,22,1,0,2270,29480,31750
2014-09-09 23:00:00-04:00,0,9,23,1,0,2037,28677,30714
2014-09-10 00:00:00-04:00,0,9,0,2,0,1985,26178,28163
2014-09-10 01:00:00-04:00,0,9,1,2,0,1715,20643,22358
2014-09-10 02:00:00-04:00,0,9,2,2,0,1246,13719,14965
2014-09-10 03:00:00-04:00,0,9,3,2,0,873,8490,9363
2014-09-10 04:00:00-04:00,0,9,4,2,0,522,5702,6224
2014-09-10 05:00:00-04:00,0,9,5,2,0,366,3818,4184
2014-09-10 06:00:00-04:00,0,9,6,2,0,353,3229,3582
2014-09-10 07:00:00-04:00,0,9,7,2,0,336,4732,5068
2014-09-10 08:00:00-04:00,0,9,8,2,0,654,12384,13038
2014-09-10 09:00:00-04:00,0,9,9,2,0,1478,22568,24046
2014-09-10 10:00:00-04:00,0,9,10,2,0,2130,25092,27222
2014-09-10 11:00:00-04:00,0,9,11,2,0,2153,23422,25575
2014-09-10 12:00:00-04:00,0,9,12,2,0,1847,21883,23730
2014-09-10 13:00:00-04:00,0,9,13,2,0,1685,22209,23894
2014-09-10 14:00:00-04:00,0,9,14,2,0,1700,22363,24063
2014-09-10 15:00:00-04:00,0,9,15,2,0,1647,22142,23789
2014-09-10 16:00:00-04:00,0,9,16,2,0,1930,23336,25266
2014-09-10 17:00:00-04:00,0,9,17,2,0,2039,21566,23605
2014-09-10 18:00:00-04:00,0,9,18,2,0,2259,17422,19681
2014-09-10 19:00:00-04:00,0,9,19,2,0,2454,22340,24794
2014-09-10 20:00:00-04:00,0,9,20,2,0,2750,28416,31166
2014-09-10 21:00:00-04:00,0,9,21,2,0,2699,30899,33598
2014-09-10 22:00:00-04:00,0,9,22,2,0,2396,30623,33019
2014-09-10 23:00:00-04:00,0,9,23,2,0,2264,29479,31743
2014-09-11 00:00:00-04:00,0,9,0,3,0,2147,27746,29893
2014-09-11 01:00:00-04:00,0,9,1,3,0,1863,23012,24875
2014-09-11 02:00:00-04:00,0,9,2,3,0,1418,15557,16975
2014-09-11 03:00:00-04:00,0,9,3,3,0,947,9432,10379
2014-09-11 04:00:00-04:00,0,9,4,3,0,580,6180,6760
2014-09-11 05:00:00-04:00,0,9,5,3,0,422,3903,4325
2014-09-11 06:00:00-04:00,0,9,6,3,0,385,3435,3820
2014-09-11 07:00:00-04:00,0,9,7,3,0,331,4737,5068
2014-09-11 08:00:00-04:00,0,9,8,3,0,621,12715,13336
2014-09-11 09:00:00-04:00,0,9,9,3,0,1481,23218,24699
2014-09-11 10:00:00-04:00,0,9,10,3,0,2144,26100,28244
2014-09-11 11:00:00-04:00,0,9,11,3,0,2064,24773,26837
2014-09-11 12:00:00-04:00,0,9,12,3,0,1894,22267,24161
2014-09-11 13:00:00-04:00,0,9,13,3,0,1760,21489,23249
2014-09-11 14:00:00-04:00,0,9,14,3,0,1681,22921,24602
2014-09-11 15:00:00-04:00,0,9,15,3,0,1720,22509,24229
2014-09-11 16:00:00-04:00,0,9,16,3,0,2053,23510,25563
2014-09-11 17:00:00-04:00,0,9,17,3,0,2264,21827,24091
2014-09-11 18:00:00-04:00,0,9,18,3,0,2423,17581,20004
2014-09-11 19:00:00-04:00,0,9,19,3,0,2717,22494,25211
2014-09-11 20:00:00-04:00,0,9,20,3,0,3053,28452,31505
2014-09-11 21:00:00-04:00,0,9,21,3,0,2852,31182,34034
2014-09-11 22:00:00-04:00,0,9,22,3,0,2802,30644,33446
2014-09-11 23:00:00-04:00,0,9,23,3,0,2574,29548,32122
2014-09-12 00:00:00-04:00,0,9,0,4,0,2497,28795,31292
2014-09-12 01:00:00-04:00,0,9,1,4,0,2214,25338,27552
2014-09-12 02:00:00-04:00,0,9,2,4,0,1821,18983,20804
2014-09-12 03:00:00-04:00,0,9,3,4,0,1280,12488,13768
2014-09-12 04:00:00-04:00,0,9,4,4,0,894,8577,9471
2014-09-12 05:00:00-04:00,0,9,5,4,0,615,5785,6400
2014-09-12 06:00:00-04:00,0,9,6,4,0,542,4687,5229
2014-09-12 07:00:00-04:00,0,9,7,4,0,396,4899,5295
2014-09-12 08:00:00-04:00,0,9,8,4,0,697,11989,12686
2014-09-12 09:00:00-04:00,0,9,9,4,0,1539,22305,23844
2014-09-12 10:00:00-04:00,0,9,10,4,0,2128,25147,27275
2014-09-12 11:00:00-04:00,0,9,11,4,0,2143,23684,25827
2014-09-12 12:00:00-04:00,0,9,12,4,0,1954,21614,23568
2014-09-12 13:00:00-04:00,0,9,13,4,0,1731,21537,23268
2014-09-12 14:00:00-04:00,0,9,14,4,0,1628,21773,23401
2014-09-12 15:00:00-04:00,0,9,15,4,0,1678,21386,23064
2014-09-12 16:00:00-04:00,0,9,16,4,0,2045,23038,25083
2014-09-12 17:00:00-04:00,0,9,17,4,0,2282,20369,22651
2014-09-12 18:00:00-04:00,0,9,18,4,0,2705,16422,19127
2014-09-12 19:00:00-04:00,0,9,19,4,0,3148,21608,24756
2014-09-12 20:00:00-04:00,0,9,20,4,0,3540,28341,31881
2014-09-12 21:00:00-04:00,0,9,21,4,0,3722,31201,34923
2014-09-12 22:00:00-04:00,0,9,22,4,0,3724,30517,34241
2014-09-12 23:00:00-04:00,0,9,23,4,0,3602,29343,32945
2014-09-13 00:00:00-04:00,0,9,0,5,0,3688,30494,34182
2014-09-13 01:00:00-04:00,0,9,1,5,0,3986,30742,34728
2014-09-13 02:00:00-04:00,0,9,2,5,0,3821,28728,32549
2014-09-13 03:00:00-04:00,0,9,3,5,0,3519,25476,28995
2014-09-13 04:00:00-04:00,0,9,4,5,0,2987,21474,24461
2014-09-13 05:00:00-04:00,0,9,5,5,0,2342,15977,18319
2014-09-13 06:00:00-04:00,0,9,6,5,0,1726,9940,11666
2014-09-13 07:00:00-04:00,0,9,7,5,0,814,5016,5830
2014-09-13 08:00:00-04:00,0,9,8,5,0,644,5559,6203
2014-09-13 09:00:00-04:00,0,9,9,5,0,837,8090,8927
2014-09-13 10:00:00-04:00,0,9,10,5,0,1174,12414,13588
2014-09-13 11:00:00-04:00,0,9,11,5,0,1579,17237,18816
2014-09-13 12:00:00-04:00,0,9,12,5,0,1748,20405,22153
2014-09-13 13:00:00-04:00,0,9,13,5,0,1887,22894,24781
2014-09-13 14:00:00-04:00,0,9,14,5,0,2199,24374,26573
2014-09-13 15:00:00-04:00,0.14,9,15,5,0,2260,24824,27084
2014-09-13 16:00:00-04:00,0.03,9,16,5,0,2660,25556,28216
2014-09-13 17:00:00-04:00,0.02,9,17,5,0,3675,28359,32034
2014-09-13 18:00:00-04:00,0,9,18,5,0,3370,21231,24601
2014-09-13 19:00:00-04:00,0,9,19,5,0,3175,23935,27110
2014-09-13 20:00:00-04:00,0,9,20,5,0,3836,29224,33060
2014-09-13 21:00:00-04:00,0,9,21,5,0,3973,30352,34325
2014-09-13 22:00:00-04:00,0,9,22,5,0,4088,29175,33263
2014-09-13 23:00:00-04:00,0,9,23,5,0,3857,25568,29425
2014-09-14 00:00:00-04:00,0,9,0,6,0,4024,27606,31630
2014-09-14 01:00:00-04:00,0,9,1,6,0,4056,30087,34143
2014-09-14 02:00:00-04:00,0,9,2,6,0,4132,29592,33724
2014-09-14 03:00:00-04:00,0,9,3,6,0,3754,26270,30024
2014-09-14 04:00:00-04:00,0,9,4,6,0,3232,22192,25424
2014-09-14 05:00:00-04:00,0,9,5,6,0,2538,16592,19130
2014-09-14 06:00:00-04:00,0,9,6,6,0,1816,10452,12268
2014-09-14 07:00:00-04:00,0,9,7,6,0,898,4801,5699
2014-09-14 08:00:00-04:00,0,9,8,6,0,684,5676,6360
2014-09-14 09:00:00-04:00,0,9,9,6,0,630,6709,7339
2014-09-14 10:00:00-04:00,0,9,10,6,0,857,10827,11684
2014-09-14 11:00:00-04:00,0,9,11,6,0,1150,14761,15911
2014-09-14 12:00:00-04:00,0,9,12,6,0,1501,19747,21248
2014-09-14 13:00:00-04:00,0,9,13,6,0,1782,22332,24114
2014-09-14 14:00:00-04:00,0,9,14,6,0,2021,24266,26287
2014-09-14 15:00:00-04:00,0,9,15,6,0,2118,23693,25811
2014-09-14 16:00:00-04:00,0,9,16,6,0,2231,23035,25266
2014-09-14 17:00:00-04:00,0,9,17,6,0,2386,22321,24707
2014-09-14 18:00:00-04:00,0,9,18,6,0,2625,21631,24256
2014-09-14 19:00:00-04:00,0,9,19,6,0,2608,23061,25669
2014-09-14 20:00:00-04:00,0,9,20,6,0,2837,24966,27803
2014-09-14 21:00:00-04:00,0,9,21,6,0,2686,23734,26420
2014-09-14 22:00:00-04:00,0,9,22,6,0,2713,21951,24664
2014-09-14 23:00:00-04:00,0,9,23,6,0,2387,20527,22914
2014-09-15 00:00:00-04:00,0,9,0,0,0,2273,17697,19970
2014-09-15 01:00:00-04:00,0,9,1,0,0,1873,14016,15889
2014-09-15 02:00:00-04:00,0,9,2,0,0,1427,8650,10077
2014-09-15 03:00:00-04:00,0,9,3,0,0,922,5177,6099
2014-09-15 04:00:00-04:00,0,9,4,0,0,605,3510,4115
2014-09-15 05:00:00-04:00,0,9,5,0,0,507,2422,2929
2014-09-15 06:00:00-04:00,0,9,6,0,0,506,2940,3446
2014-09-15 07:00:00-04:00,0,9,7,0,0,402,4945,5347
2014-09-15 08:00:00-04:00,0,9,8,0,0,676,12379,13055
2014-09-15 09:00:00-04:00,0,9,9,0,0,1489,20745,22234
2014-09-15 10:00:00-04:00,0,9,10,0,0,2091,23476,25567
2014-09-15 11:00:00-04:00,0,9,11,0,0,2076,22112,24188
2014-09-15 12:00:00-04:00,0,9,12,0,0,1742,20147,21889
2014-09-15 13:00:00-04:00,0,9,13,0,0,1587,19878,21465
2014-09-15 14:00:00-04:00,0,9,14,0,0,1568,20658,22226
2014-09-15 15:00:00-04:00,0,9,15,0,0,1483,20251,21734
2014-09-15 16:00:00-04:00,0,9,16,0,0,1776,21794,23570
2014-09-15 17:00:00-04:00,0,9,17,0,0,1841,21220,23061
2014-09-15 18:00:00-04:00,0,9,18,0,0,1994,19056,21050
2014-09-15 19:00:00-04:00,0,9,19,0,0,2172,23152,25324
2014-09-15 20:00:00-04:00,0,9,20,0,0,2584,28472,31056
2014-09-15 21:00:00-04:00,0,9,21,0,0,2497,29006,31503
2014-09-15 22:00:00-04:00,0,9,22,0,0,2233,28060,30293
2014-09-15 23:00:00-04:00,0,9,23,0,0,2009,26059,28068
2014-09-16 00:00:00-04:00,0,9,0,1,0,1828,21783,23611
2014-09-16 01:00:00-04:00,0,9,1,1,0,1439,16088,17527
2014-09-16 02:00:00-04:00,0,9,2,1,0,1113,10150,11263
2014-09-16 03:00:00-04:00,0,9,3,1,0,765,5937,6702
2014-09-16 04:00:00-04:00,0,9,4,1,0,465,3696,4161
2014-09-16 05:00:00-04:00,0,9,5,1,0,358,2470,2828
2014-09-16 06:00:00-04:00,0,9,6,1,0,367,2489,2856
2014-09-16 07:00:00-04:00,0.01,9,7,1,0,351,4171,4522
2014-09-16 08:00:00-04:00,0.08,9,8,1,0,620,11889,12509
2014-09-16 09:00:00-04:00,0.14,9,9,1,0,1654,23633,25287
2014-09-16 10:00:00-04:00,0.06,9,10,1,0,2538,27173,29711
2014-09-16 11:00:00-04:00,0.13,9,11,1,0,2385,25255,27640
2014-09-16 12:00:00-04:00,0,9,12,1,0,1947,22741,24688
2014-09-16 13:00:00-04:00,0,9,13,1,0,1814,21897,23711
2014-09-16 14:00:00-04:00,0,9,14,1,0,1648,20872,22520
2014-09-16 15:00:00-04:00,0,9,15,1,0,1630,20513,22143
2014-09-16 16:00:00-04:00,0,9,16,1,0,1799,22358,24157
2014-09-16 17:00:00-04:00,0,9,17,1,0,2030,21503,23533
2014-09-16 18:00:00-04:00,0,9,18,1,0,2222,17596,19818
2014-09-16 19:00:00-04:00,0,9,19,1,0,2507,22485,24992
2014-09-16 20:00:00-04:00,0,9,20,1,0,2616,28456,31072
2014-09-16 21:00:00-04:00,0,9,21,1,0,2637,30150,32787
2014-09-16 22:00:00-04:00,0,9,22,1,0,2443,29308,31751
2014-09-16 23:00:00-04:00,0,9,23,1,0,2113,28794,30907
2014-09-17 00:00:00-04:00,0,9,0,2,0,2015,25186,27201
2014-09-17 01:00:00-04:00,0,9,1,2,0,1654,18896,20550
2014-09-17 02:00:00-04:00,0,9,2,2,0,1213,11990,13203
2014-09-17 03:00:00-04:00,0,9,3,2,0,788,7148,7936
2014-09-17 04:00:00-04:00,0,9,4,2,0,481,4472,4953
2014-09-17 05:00:00-04:00,0,9,5,2,0,337,2979,3316
2014-09-17 06:00:00-04:00,0,9,6,2,0,324,2798,3122
2014-09-17 07:00:00-04:00,0,9,7,2,0,325,4411,4736
2014-09-17 08:00:00-04:00,0,9,8,2,0,610,12270,12880
2014-09-17 09:00:00-04:00,0,9,9,2,0,1502,22609,24111
2014-09-17 10:00:00-04:00,0,9,10,2,0,2151,25270,27421
2014-09-17 11:00:00-04:00,0,9,11,2,0,2030,22989,25019
2014-09-17 12:00:00-04:00,0,9,12,2,0,1749,21400,23149
2014-09-17 13:00:00-04:00,0,9,13,2,0,1627,21610,23237
2014-09-17 14:00:00-04:00,0,9,14,2,0,1627,21814,23441
2014-09-17 15:00:00-04:00,0,9,15,2,0,1597,21292,22889
2014-09-17 16:00:00-04:00,0,9,16,2,0,1848,22531,24379
2014-09-17 17:00:00-04:00,0,9,17,2,0,2045,20789,22834
2014-09-17 18:00:00-04:00,0,9,18,2,0,2219,16814,19033
2014-09-17 19:00:00-04:00,0,9,19,2,0,2566,21799,24365
2014-09-17 20:00:00-04:00,0,9,20,2,0,2746,28115,30861
2014-09-17 21:00:00-04:00,0,9,21,2,0,2797,30694,33491
2014-09-17 22:00:00-04:00,0,9,22,2,0,2598,28924,31522
2014-09-17 23:00:00-04:00,0,9,23,2,0,2403,28764,31167
2014-09-18 00:00:00-04:00,0,9,0,3,0,2179,27152,29331
2014-09-18 01:00:00-04:00,0,9,1,3,0,1840,22582,24422
2014-09-18 02:00:00-04:00,0,9,2,3,0,1402,14478,15880
2014-09-18 03:00:00-04:00,0,9,3,3,0,959,8688,9647
2014-09-18 04:00:00-04:00,0,9,4,3,0,561,5568,6129
2014-09-18 05:00:00-04:00,0,9,5,3,0,392,3435,3827
2014-09-18 06:00:00-04:00,0,9,6,3,0,360,3187,3547
2014-09-18 07:00:00-04:00,0,9,7,3,0,317,4580,4897
2014-09-18 08:00:00-04:00,0,9,8,3,0,675,12759,13434
2014-09-18 09:00:00-04:00,0,9,9,3,0,1602,22992,24594
2014-09-18 10:00:00-04:00,0,9,10,3,0,2161,25408,27569
2014-09-18 11:00:00-04:00,0,9,11,3,0,2102,23643,25745
2014-09-18 12:00:00-04:00,0,9,12,3,0,1747,21817,23564
2014-09-18 13:00:00-04:00,0,9,13,3,0,1636,21666,23302
2014-09-18 14:00:00-04:00,0,9,14,3,0,1685,21992,23677
2014-09-18 15:00:00-04:00,0,9,15,3,0,1609,21749,23358
2014-09-18 16:00:00-04:00,0,9,16,3,0,1987,22587,24574
2014-09-18 17:00:00-04:00,0,9,17,3,0,2330,20149,22479
2014-09-18 18:00:00-04:00,0,9,18,3,0,2529,15777,18306
2014-09-18 19:00:00-04:00,0,9,19,3,0,2929,21262,24191
2014-09-18 20:00:00-04:00,0,9,20,3,0,3051,26575,29626
2014-09-18 21:00:00-04:00,0,9,21,3,0,3046,29107,32153
2014-09-18 22:00:00-04:00,0,9,22,3,0,3069,30293,33362
2014-09-18 23:00:00-04:00,0,9,23,3,0,2670,30259,32929
2014-09-19 00:00:00-04:00,0,9,0,4,0,2707,29771,32478
2014-09-19 01:00:00-04:00,0,9,1,4,0,2421,26616,29037
2014-09-19 02:00:00-04:00,0,9,2,4,0,1847,20567,22414
2014-09-19 03:00:00-04:00,0,9,3,4,0,1399,13397,14796
2014-09-19 04:00:00-04:00,0,9,4,4,0,920,8957,9877
2014-09-19 05:00:00-04:00,0,9,5,4,0,611,6044,6655
2014-09-19 06:00:00-04:00,0,9,6,4,0,568,4788,5356
2014-09-19 07:00:00-04:00,0,9,7,4,0,428,5219,5647
2014-09-19 08:00:00-04:00,0,9,8,4,0,725,12528,13253
2014-09-19 09:00:00-04:00,0,9,9,4,0,1514,21924,23438
2014-09-19 10:00:00-04:00,0,9,10,4,0,2123,24387,26510
2014-09-19 11:00:00-04:00,0,9,11,4,0,2090,22829,24919
2014-09-19 12:00:00-04:00,0,9,12,4,0,1885,21769,23654
2014-09-19 13:00:00-04:00,0,9,13,4,0,1774,21630,23404
2014-09-19 14:00:00-04:00,0,9,14,4,0,1716,21794,23510
2014-09-19 15:00:00-04:00,0,9,15,4,0,1729,20679,22408
2014-09-19 16:00:00-04:00,0,9,16,4,0,2049,21943,23992
2014-09-19 17:00:00-04:00,0,9,17,4,0,2391,20218,22609
2014-09-19 18:00:00-04:00,0,9,18,4,0,2714,16243,18957
2014-09-19 19:00:00-04:00,0,9,19,4,0,2949,21591,24540
2014-09-19 20:00:00-04:00,0,9,20,4,0,3562,28579,32141
2014-09-19 21:00:00-04:00,0,9,21,4,0,3814,31368,35182
2014-09-19 22:00:00-04:00,0,9,22,4,0,3743,30701,34444
2014-09-19 23:00:00-04:00,0,9,23,4,0,3700,30095,33795
2014-09-20 00:00:00-04:00,0,9,0,5,0,3887,31062,34949
2014-09-20 01:00:00-04:00,0,9,1,5,0,4033,30522,34555
2014-09-20 02:00:00-04:00,0,9,2,5,0,3621,27455,31076
2014-09-20 03:00:00-04:00,0,9,3,5,0,3129,24097,27226
2014-09-20 04:00:00-04:00,0,9,4,5,0,2770,20607,23377
2014-09-20 05:00:00-04:00,0,9,5,5,0,2350,15420,17770
2014-09-20 06:00:00-04:00,0,9,6,5,0,1602,9725,11327
2014-09-20 07:00:00-04:00,0,9,7,5,0,819,4783,5602
2014-09-20 08:00:00-04:00,0,9,8,5,0,699,5344,6043
2014-09-20 09:00:00-04:00,0,9,9,5,0,792,8135,8927
2014-09-20 10:00:00-04:00,0,9,10,5,0,1172,12676,13848
2014-09-20 11:00:00-04:00,0,9,11,5,0,1466,16940,18406
2014-09-20 12:00:00-04:00,0,9,12,5,0,1729,20277,22006
2014-09-20 13:00:00-04:00,0,9,13,5,0,1833,22541,24374
2014-09-20 14:00:00-04:00,0,9,14,5,0,2036,23374,25410
2014-09-20 15:00:00-04:00,0,9,15,5,0,2216,24108,26324
2014-09-20 16:00:00-04:00,0,9,16,5,0,2425,23477,25902
2014-09-20 17:00:00-04:00,0,9,17,5,0,2786,23472,26258
2014-09-20 18:00:00-04:00,0,9,18,5,0,2925,19829,22754
2014-09-20 19:00:00-04:00,0,9,19,5,0,3161,22469,25630
2014-09-20 20:00:00-04:00,0,9,20,5,0,3427,27186,30613
2014-09-20 21:00:00-04:00,0,9,21,5,0,3785,28898,32683
2014-09-20 22:00:00-04:00,0,9,22,5,0,3833,27471,31304
2014-09-20 23:00:00-04:00,0,9,23,5,0,3788,26862,30650
2014-09-21 00:00:00-04:00,0,9,0,6,0,3985,28356,32341
2014-09-21 01:00:00-04:00,0.05,9,1,6,0,3940,29074,33014
2014-09-21 02:00:00-04:00,0.09,9,2,6,0,3973,28788,32761
2014-09-21 03:00:00-04:00,0.07,9,3,6,0,3958,26088,30046
2014-09-21 04:00:00-04:00,0,9,4,6,0,3456,22276,25732
2014-09-21 05:00:00-04:00,0,9,5,6,0,2619,17049,19668
2014-09-21 06:00:00-04:00,0,9,6,6,0,1976,10653,12629
2014-09-21 07:00:00-04:00,0,9,7,6,0,929,4871,5800
2014-09-21 08:00:00-04:00,0,9,8,6,0,662,5376,6038
2014-09-21 09:00:00-04:00,0,9,9,6,0,629,6646,7275
2014-09-21 10:00:00-04:00,0,9,10,6,0,784,10053,10837
2014-09-21 11:00:00-04:00,0,9,11,6,0,1127,14654,15781
2014-09-21 12:00:00-04:00,0,9,12,6,0,1409,18733,20142
2014-09-21 13:00:00-04:00,0,9,13,6,0,1691,20641,22332
2014-09-21 14:00:00-04:00,0,9,14,6,0,1823,21014,22837
2014-09-21 15:00:00-04:00,0,9,15,6,0,1887,19489,21376
2014-09-21 16:00:00-04:00,0,9,16,6,0,2035,17741,19776
2014-09-21 17:00:00-04:00,0,9,17,6,0,2226,16477,18703
2014-09-21 18:00:00-04:00,0,9,18,6,0,2474,14646,17120
2014-09-21 19:00:00-04:00,0,9,19,6,0,2613,16693,19306
2014-09-21 20:00:00-04:00,0,9,20,6,0,2688,19488,22176
2014-09-21 21:00:00-04:00,0,9,21,6,0,2671,20724,23395
2014-09-21 22:00:00-04:00,0,9,22,6,0,2535,20428,22963
2014-09-21 23:00:00-04:00,0,9,23,6,0,2397,18834,21231
2014-09-22 00:00:00-04:00,0,9,0,0,0,2166,17650,19816
2014-09-22 01:00:00-04:00,0,9,1,0,0,1855,13941,15796
2014-09-22 02:00:00-04:00,0,9,2,0,0,1393,9206,10599
2014-09-22 03:00:00-04:00,0,9,3,0,0,889,5000,5889
2014-09-22 04:00:00-04:00,0,9,4,0,0,572,3471,4043
2014-09-22 05:00:00-04:00,0,9,5,0,0,443,2334,2777
2014-09-22 06:00:00-04:00,0,9,6,0,0,530,2928,3458
2014-09-22 07:00:00-04:00,0,9,7,0,0,422,4922,5344
2014-09-22 08:00:00-04:00,0,9,8,0,0,629,12334,12963
2014-09-22 09:00:00-04:00,0,9,9,0,0,1468,19555,21023
2014-09-22 10:00:00-04:00,0,9,10,0,0,2045,21145,23190
2014-09-22 11:00:00-04:00,0,9,11,0,0,1962,20103,22065
2014-09-22 12:00:00-04:00,0,9,12,0,0,1701,18109,19810
2014-09-22 13:00:00-04:00,0,9,13,0,0,1538,18200,19738
2014-09-22 14:00:00-04:00,0,9,14,0,0,1470,18697,20167
2014-09-22 15:00:00-04:00,0,9,15,0,0,1510,18389,19899
2014-09-22 16:00:00-04:00,0,9,16,0,0,1770,19465,21235
2014-09-22 17:00:00-04:00,0,9,17,0,0,1880,18546,20426
2014-09-22 18:00:00-04:00,0,9,18,0,0,1979,16256,18235
2014-09-22 19:00:00-04:00,0,9,19,0,0,2296,20566,22862
2014-09-22 20:00:00-04:00,0,9,20,0,0,2552,25134,27686
2014-09-22 21:00:00-04:00,0,9,21,0,0,2549,26719,29268
2014-09-22 22:00:00-04:00,0,9,22,0,0,2256,27024,29280
2014-09-22 23:00:00-04:00,0,9,23,0,0,2063,25684,27747
2014-09-23 00:00:00-04:00,0,9,0,1,0,1816,22708,24524
2014-09-23 01:00:00-04:00,0,9,1,1,0,1442,17161,18603
2014-09-23 02:00:00-04:00,0,9,2,1,0,1088,12006,13094
2014-09-23 03:00:00-04:00,0,9,3,1,0,742,7026,7768
2014-09-23 04:00:00-04:00,0,9,4,1,0,452,3814,4266
2014-09-23 05:00:00-04:00,0,9,5,1,0,333,2452,2785
2014-09-23 06:00:00-04:00,0,9,6,1,0,338,2612,2950
2014-09-23 07:00:00-04:00,0,9,7,1,0,337,4486,4823
2014-09-23 08:00:00-04:00,0,9,8,1,0,620,12696,13316
2014-09-23 09:00:00-04:00,0,9,9,1,0,1456,21106,22562
2014-09-23 10:00:00-04:00,0,9,10,1,0,2120,22388,24508
2014-09-23 11:00:00-04:00,0,9,11,1,0,2065,20447,22512
2014-09-23 12:00:00-04:00,0,9,12,1,0,1669,18771,20440
2014-09-23 13:00:00-04:00,0,9,13,1,0,1658,17984,19642
2014-09-23 14:00:00-04:00,0,9,14,1,0,1603,18538,20141
2014-09-23 15:00:00-04:00,0,9,15,1,0,1615,17689,19304
2014-09-23 16:00:00-04:00,0,9,16,1,0,1737,18093,19830
2014-09-23 17:00:00-04:00,0,9,17,1,0,2006,16943,18949
2014-09-23 18:00:00-04:00,0,9,18,1,0,2135,13726,15861
2014-09-23 19:00:00-04:00,0,9,19,1,0,2378,17837,20215
2014-09-23 20:00:00-04:00,0,9,20,1,0,2713,23294,26007
2014-09-23 21:00:00-04:00,0,9,21,1,0,2757,27030,29787
2014-09-23 22:00:00-04:00,0,9,22,1,0,2463,28283,30746
2014-09-23 23:00:00-04:00,0,9,23,1,0,2259,28006,30265
2014-09-24 00:00:00-04:00,0,9,0,2,0,2122,25522,27644
2014-09-24 01:00:00-04:00,0,9,1,2,0,1875,20374,22249
2014-09-24 02:00:00-04:00,0,9,2,2,0,1282,13085,14367
2014-09-24 03:00:00-04:00,0,9,3,2,0,824,7593,8417
2014-09-24 04:00:00-04:00,0,9,4,2,0,575,4871,5446
2014-09-24 05:00:00-04:00,0,9,5,2,0,363,3301,3664
2014-09-24 06:00:00-04:00,0,9,6,2,0,372,2946,3318
2014-09-24 07:00:00-04:00,0,9,7,2,0,328,4484,4812
2014-09-24 08:00:00-04:00,0,9,8,2,0,622,12342,12964
2014-09-24 09:00:00-04:00,0,9,9,2,0,1461,21380,22841
2014-09-24 10:00:00-04:00,0,9,10,2,0,1987,22546,24533
2014-09-24 11:00:00-04:00,0,9,11,2,0,2131,20932,23063
2014-09-24 12:00:00-04:00,0,9,12,2,0,1801,19018,20819
2014-09-24 13:00:00-04:00,0,9,13,2,0,1670,19129,20799
2014-09-24 14:00:00-04:00,0,9,14,2,0,1603,19928,21531
2014-09-24 15:00:00-04:00,0,9,15,2,0,1636,19452,21088
2014-09-24 16:00:00-04:00,0,9,16,2,0,1872,20655,22527
2014-09-24 17:00:00-04:00,0,9,17,2,0,2115,18976,21091
2014-09-24 18:00:00-04:00,0,9,18,2,0,2344,15620,17964
2014-09-24 19:00:00-04:00,0,9,19,2,0,2662,20585,23247
2014-09-24 20:00:00-04:00,0,9,20,2,0,2905,25199,28104
2014-09-24 21:00:00-04:00,0,9,21,2,0,2854,26328,29182
2014-09-24 22:00:00-04:00,0,9,22,2,0,2498,25433,27931
2014-09-24 23:00:00-04:00,0,9,23,2,0,2266,26859,29125
2014-09-25 00:00:00-04:00,0,9,0,3,0,2219,25569,27788
2014-09-25 01:00:00-04:00,0,9,1,3,0,2021,20539,22560
2014-09-25 02:00:00-04:00,0,9,2,3,0,1497,13356,14853
2014-09-25 03:00:00-04:00,0,9,3,3,0,1060,7967,9027
2014-09-25 04:00:00-04:00,0,9,4,3,0,645,5329,5974
2014-09-25 05:00:00-04:00,0,9,5,3,0,472,3484,3956
2014-09-25 06:00:00-04:00,0,9,6,3,0,414,3196,3610
2014-09-25 07:00:00-04:00,0.02,9,7,3,0,347,4314,4661
2014-09-25 08:00:00-04:00,0.06,9,8,3,0,571,11481,12052
2014-09-25 09:00:00-04:00,0,9,9,3,0,1402,19800,21202
2014-09-25 10:00:00-04:00,0.02,9,10,3,0,2302,22869,25171
2014-09-25 11:00:00-04:00,0.06,9,11,3,0,2283,21754,24037
2014-09-25 12:00:00-04:00,0.01,9,12,3,0,2119,21519,23638
2014-09-25 13:00:00-04:00,0,9,13,3,0,1948,19554,21502
2014-09-25 14:00:00-04:00,0,9,14,3,0,1830,20318,22148
2014-09-25 15:00:00-04:00,0,9,15,3,0,1689,20254,21943
2014-09-25 16:00:00-04:00,0,9,16,3,0,1907,19407,21314
2014-09-25 17:00:00-04:00,0,9,17,3,0,2102,17815,19917
2014-09-25 18:00:00-04:00,0,9,18,3,0,2302,15528,17830
2014-09-25 19:00:00-04:00,0,9,19,3,0,2691,20999,23690
2014-09-25 20:00:00-04:00,0,9,20,3,0,2900,26087,28987
2014-09-25 21:00:00-04:00,0,9,21,3,0,2898,27674,30572
2014-09-25 22:00:00-04:00,0,9,22,3,0,2703,26429,29132
2014-09-25 23:00:00-04:00,0,9,23,3,0,2478,26076,28554
2014-09-26 00:00:00-04:00,0,9,0,4,0,2438,26490,28928
2014-09-26 01:00:00-04:00,0,9,1,4,0,2304,24740,27044
2014-09-26 02:00:00-04:00,0,9,2,4,0,1781,16994,18775
2014-09-26 03:00:00-04:00,0,9,3,4,0,1327,11085,12412
2014-09-26 04:00:00-04:00,0,9,4,4,0,915,7579,8494
2014-09-26 05:00:00-04:00,0,9,5,4,0,666,5225,5891
2014-09-26 06:00:00-04:00,0,9,6,4,0,567,4300,4867
2014-09-26 07:00:00-04:00,0,9,7,4,0,432,4599,5031
2014-09-26 08:00:00-04:00,0,9,8,4,0,575,11127,11702
2014-09-26 09:00:00-04:00,0,9,9,4,0,1173,18316,19489
2014-09-26 10:00:00-04:00,0,9,10,4,0,1860,21121,22981
2014-09-26 11:00:00-04:00,0,9,11,4,0,1974,20678,22652
2014-09-26 12:00:00-04:00,0,9,12,4,0,1779,19520,21299
2014-09-26 13:00:00-04:00,0,9,13,4,0,1703,18902,20605
2014-09-26 14:00:00-04:00,0,9,14,4,0,1647,19605,21252
2014-09-26 15:00:00-04:00,0,9,15,4,0,1638,19531,21169
2014-09-26 16:00:00-04:00,0,9,16,4,0,1973,20672,22645
2014-09-26 17:00:00-04:00,0,9,17,4,0,2284,18977,21261
2014-09-26 18:00:00-04:00,0,9,18,4,0,2666,16220,18886
2014-09-26 19:00:00-04:00,0,9,19,4,0,3240,21046,24286
2014-09-26 20:00:00-04:00,0,9,20,4,0,3508,27003,30511
2014-09-26 21:00:00-04:00,0,9,21,4,0,3614,29536,33150
2014-09-26 22:00:00-04:00,0,9,22,4,0,3485,28915,32400
2014-09-26 23:00:00-04:00,0,9,23,4,0,3478,28120,31598
2014-09-27 00:00:00-04:00,0,9,0,5,0,3657,29616,33273
2014-09-27 01:00:00-04:00,0,9,1,5,0,3786,29674,33460
2014-09-27 02:00:00-04:00,0,9,2,5,0,3618,27820,31438
2014-09-27 03:00:00-04:00,0,9,3,5,0,3257,24616,27873
2014-09-27 04:00:00-04:00,0,9,4,5,0,2883,20843,23726
2014-09-27 05:00:00-04:00,0,9,5,5,0,2316,15584,17900
2014-09-27 06:00:00-04:00,0,9,6,5,0,1746,9571,11317
2014-09-27 07:00:00-04:00,0,9,7,5,0,854,4673,5527
2014-09-27 08:00:00-04:00,0,9,8,5,0,708,5672,6380
2014-09-27 09:00:00-04:00,0,9,9,5,0,797,8800,9597
2014-09-27 10:00:00-04:00,0,9,10,5,0,1161,12492,13653
2014-09-27 11:00:00-04:00,0,9,11,5,0,1426,16398,17824
2014-09-27 12:00:00-04:00,0,9,12,5,0,1701,19443,21144
2014-09-27 13:00:00-04:00,0,9,13,5,0,1823,22132,23955
2014-09-27 14:00:00-04:00,0,9,14,5,0,2055,23150,25205
2014-09-27 15:00:00-04:00,0,9,15,5,0,2177,23385,25562
2014-09-27 16:00:00-04:00,0,9,16,5,0,2527,23006,25533
2014-09-27 17:00:00-04:00,0,9,17,5,0,2720,22181,24901
2014-09-27 18:00:00-04:00,0,9,18,5,0,2915,18895,21810
2014-09-27 19:00:00-04:00,0,9,19,5,0,3095,22161,25256
2014-09-27 20:00:00-04:00,0,9,20,5,0,3423,26723,30146
2014-09-27 21:00:00-04:00,0,9,21,5,0,3882,28192,32074
2014-09-27 22:00:00-04:00,0,9,22,5,0,3886,26253,30139
2014-09-27 23:00:00-04:00,0,9,23,5,0,3919,25466,29385
2014-09-28 00:00:00-04:00,0,9,0,6,0,4201,28706,32907
2014-09-28 01:00:00-04:00,0,9,1,6,0,4243,30759,35002
2014-09-28 02:00:00-04:00,0,9,2,6,0,4151,29621,33772
2014-09-28 03:00:00-04:00,0,9,3,6,0,3735,26486,30221
2014-09-28 04:00:00-04:00,0,9,4,6,0,3309,22171,25480
2014-09-28 05:00:00-04:00,0,9,5,6,0,2785,17014,19799
2014-09-28 06:00:00-04:00,0,9,6,6,0,2048,10930,12978
2014-09-28 07:00:00-04:00,0,9,7,6,0,1024,4844,5868
2014-09-28 08:00:00-04:00,0,9,8,6,0,706,5337,6043
2014-09-28 09:00:00-04:00,0,9,9,6,0,703,6902,7605
2014-09-28 10:00:00-04:00,0,9,10,6,0,809,9928,10737
2014-09-28 11:00:00-04:00,0,9,11,6,0,1091,13748,14839
2014-09-28 12:00:00-04:00,0,9,12,6,0,1365,18268,19633
2014-09-28 13:00:00-04:00,0,9,13,6,0,1631,21347,22978
2014-09-28 14:00:00-04:00,0,9,14,6,0,1848,23022,24870
2014-09-28 15:00:00-04:00,0,9,15,6,0,2019,23057,25076
2014-09-28 16:00:00-04:00,0,9,16,6,0,2270,22973,25243
2014-09-28 17:00:00-04:00,0,9,17,6,0,2408,21745,24153
2014-09-28 18:00:00-04:00,0,9,18,6,0,2659,19933,22592
2014-09-28 19:00:00-04:00,0,9,19,6,0,2589,21392,23981
2014-09-28 20:00:00-04:00,0,9,20,6,0,2788,23217,26005
2014-09-28 21:00:00-04:00,0,9,21,6,0,2846,22389,25235
2014-09-28 22:00:00-04:00,0,9,22,6,0,2577,20385,22962
2014-09-28 23:00:00-04:00,0,9,23,6,0,2463,18973,21436
2014-09-29 00:00:00-04:00,0,9,0,0,0,2210,16710,18920
2014-09-29 01:00:00-04:00,0,9,1,0,0,1850,13428,15278
2014-09-29 02:00:00-04:00,0,9,2,0,0,1388,8721,10109
2014-09-29 03:00:00-04:00,0,9,3,0,0,862,5087,5949
2014-09-29 04:00:00-04:00,0,9,4,0,0,605,3539,4144
2014-09-29 05:00:00-04:00,0,9,5,0,0,445,2457,2902
2014-09-29 06:00:00-04:00,0,9,6,0,0,488,2860,3348
2014-09-29 07:00:00-04:00,0,9,7,0,0,405,4707,5112
2014-09-29 08:00:00-04:00,0,9,8,0,0,690,12065,12755
2014-09-29 09:00:00-04:00,0,9,9,0,0,1518,19337,20855
2014-09-29 10:00:00-04:00,0,9,10,0,0,2227,20988,23215
2014-09-29 11:00:00-04:00,0,9,11,0,0,2017,18867,20884
2014-09-29 12:00:00-04:00,0,9,12,0,0,1905,18588,20493
2014-09-29 13:00:00-04:00,0,9,13,0,0,1632,19160,20792
2014-09-29 14:00:00-04:00,0,9,14,0,0,1586,19680,21266
2014-09-29 15:00:00-04:00,0,9,15,0,0,1569,19593,21162
2014-09-29 16:00:00-04:00,0,9,16,0,0,1740,21450,23190
2014-09-29 17:00:00-04:00,0,9,17,0,0,1979,20893,22872
2014-09-29 18:00:00-04:00,0,9,18,0,0,2152,18079,20231
2014-09-29 19:00:00-04:00,0,9,19,0,0,2614,23590,26204
2014-09-29 20:00:00-04:00,0,9,20,0,0,2560,27592,30152
2014-09-29 21:00:00-04:00,0,9,21,0,0,2307,27126,29433
2014-09-29 22:00:00-04:00,0,9,22,0,0,2089,25470,27559
2014-09-29 23:00:00-04:00,0,9,23,0,0,1767,23859,25626
2014-09-30 00:00:00-04:00,0,9,0,1,0,1693,21335,23028
2014-09-30 01:00:00-04:00,0,9,1,1,0,1466,15275,16741
2014-09-30 02:00:00-04:00,0,9,2,1,0,1100,9983,11083
2014-09-30 03:00:00-04:00,0,9,3,1,0,691,5686,6377
2014-09-30 04:00:00-04:00,0,9,4,1,0,499,3668,4167
2014-09-30 05:00:00-04:00,0,9,5,1,0,337,2371,2708
2014-09-30 06:00:00-04:00,0,9,6,1,0,355,2603,2958
2014-09-30 07:00:00-04:00,0,9,7,1,0,305,4293,4598
2014-09-30 08:00:00-04:00,0,9,8,1,0,605,11801,12406
2014-09-30 09:00:00-04:00,0,9,9,1,0,1569,21499,23068
2014-09-30 10:00:00-04:00,0,9,10,1,0,2196,24738,26934
2014-09-30 11:00:00-04:00,0,9,11,1,0,2125,23060,25185
2014-09-30 12:00:00-04:00,0,9,12,1,0,1846,20478,22324
2014-09-30 13:00:00-04:00,0,9,13,1,0,1617,20508,22125
2014-09-30 14:00:00-04:00,0,9,14,1,0,1572,20846,22418
2014-09-30 15:00:00-04:00,0,9,15,1,0,1598,20580,22178
2014-09-30 16:00:00-04:00,0,9,16,1,0,1815,22274,24089
2014-09-30 17:00:00-04:00,0,9,17,1,0,2051,20919,22970
2014-09-30 18:00:00-04:00,0,9,18,1,0,2133,17452,19585
2014-09-30 19:00:00-04:00,0,9,19,1,0,2535,22526,25061
2014-09-30 20:00:00-04:00,0,9,20,1,0,2795,28190,30985
2014-09-30 21:00:00-04:00,0,9,21,1,0,2650,29525,32175
2014-09-30 22:00:00-04:00,0,9,22,1,0,2312,28678,30990
2014-09-30 23:00:00-04:00,0.01,9,23,1,0,2144,28347,30491
2014-10-01 00:00:00-04:00,0.03,10,0,2,0,1973,25475,27448
2014-10-01 01:00:00-04:00,0,10,1,2,0,1904,19917,21821
2014-10-01 02:00:00-04:00,0,10,2,2,0,1408,13026,14434
2014-10-01 03:00:00-04:00,0,10,3,2,0,845,7364,8209
2014-10-01 04:00:00-04:00,0,10,4,2,0,554,4490,5044
2014-10-01 05:00:00-04:00,0,10,5,2,0,388,3188,3576
2014-10-01 06:00:00-04:00,0,10,6,2,0,356,2758,3114
2014-10-01 07:00:00-04:00,0,10,7,2,0,353,4441,4794
2014-10-01 08:00:00-04:00,0,10,8,2,0,620,12227,12847
2014-10-01 09:00:00-04:00,0,10,9,2,0,1522,22863,24385
2014-10-01 10:00:00-04:00,0,10,10,2,0,2359,26168,28527
2014-10-01 11:00:00-04:00,0,10,11,2,0,2331,24327,26658
2014-10-01 12:00:00-04:00,0,10,12,2,0,1927,21351,23278
2014-10-01 13:00:00-04:00,0,10,13,2,0,1875,22050,23925
2014-10-01 14:00:00-04:00,0,10,14,2,0,1792,22427,24219
2014-10-01 15:00:00-04:00,0,10,15,2,0,1814,21191,23005
2014-10-01 16:00:00-04:00,0,10,16,2,0,2029,22590,24619
2014-10-01 17:00:00-04:00,0,10,17,2,0,2317,21405,23722
2014-10-01 18:00:00-04:00,0,10,18,2,0,2455,17521,19976
2014-10-01 19:00:00-04:00,0,10,19,2,0,2731,22174,24905
2014-10-01 20:00:00-04:00,0,10,20,2,0,2931,28001,30932
2014-10-01 21:00:00-04:00,0,10,21,2,0,3013,30399,33412
2014-10-01 22:00:00-04:00,0,10,22,2,0,2545,29683,32228
2014-10-01 23:00:00-04:00,0,10,23,2,0,2320,29069,31389
2014-10-02 00:00:00-04:00,0,10,0,3,0,2152,27207,29359
2014-10-02 01:00:00-04:00,0,10,1,3,0,1995,22090,24085
2014-10-02 02:00:00-04:00,0,10,2,3,0,1488,14178,15666
2014-10-02 03:00:00-04:00,0,10,3,3,0,1043,8423,9466
2014-10-02 04:00:00-04:00,0,10,4,3,0,657,5432,6089
2014-10-02 05:00:00-04:00,0,10,5,3,0,431,3643,4074
2014-10-02 06:00:00-04:00,0,10,6,3,0,425,3120,3545
2014-10-02 07:00:00-04:00,0,10,7,3,0,341,4399,4740
2014-10-02 08:00:00-04:00,0,10,8,3,0,648,12274,12922
2014-10-02 09:00:00-04:00,0,10,9,3,0,1598,22468,24066
2014-10-02 10:00:00-04:00,0,10,10,3,0,2211,25543,27754
2014-10-02 11:00:00-04:00,0,10,11,3,0,2101,24121,26222
2014-10-02 12:00:00-04:00,0,10,12,3,0,1877,21796,23673
2014-10-02 13:00:00-04:00,0,10,13,3,0,1662,21441,23103
2014-10-02 14:00:00-04:00,0,10,14,3,0,1720,22150,23870
2014-10-02 15:00:00-04:00,0,10,15,3,0,1729,21586,23315
2014-10-02 16:00:00-04:00,0,10,16,3,0,2000,23078,25078
2014-10-02 17:00:00-04:00,0,10,17,3,0,2248,21423,23671
2014-10-02 18:00:00-04:00,0,10,18,3,0,2554,16879,19433
2014-10-02 19:00:00-04:00,0,10,19,3,0,2999,22151,25150
2014-10-02 20:00:00-04:00,0,10,20,3,0,3228,27291,30519
2014-10-02 21:00:00-04:00,0,10,21,3,0,3218,30065,33283
2014-10-02 22:00:00-04:00,0,10,22,3,0,2916,30446,33362
2014-10-02 23:00:00-04:00,0,10,23,3,0,2707,30392,33099
2014-10-03 00:00:00-04:00,0,10,0,4,0,2620,28887,31507
2014-10-03 01:00:00-04:00,0,10,1,4,0,2544,26115,28659
2014-10-03 02:00:00-04:00,0,10,2,4,0,2088,19657,21745
2014-10-03 03:00:00-04:00,0,10,3,4,0,1499,13052,14551
2014-10-03 04:00:00-04:00,0,10,4,4,0,960,8614,9574
2014-10-03 05:00:00-04:00,0,10,5,4,0,689,5742,6431
2014-10-03 06:00:00-04:00,0,10,6,4,0,606,4504,5110
2014-10-03 07:00:00-04:00,0,10,7,4,0,427,4887,5314
2014-10-03 08:00:00-04:00,0,10,8,4,0,654,11860,12514
2014-10-03 09:00:00-04:00,0,10,9,4,0,1487,21188,22675
2014-10-03 10:00:00-04:00,0,10,10,4,0,2119,24405,26524
2014-10-03 11:00:00-04:00,0,10,11,4,0,2184,23636,25820
2014-10-03 12:00:00-04:00,0,10,12,4,0,1923,21057,22980
2014-10-03 13:00:00-04:00,0,10,13,4,0,1831,21382,23213
2014-10-03 14:00:00-04:00,0,10,14,4,0,1741,21817,23558
2014-10-03 15:00:00-04:00,0,10,15,4,0,1735,21403,23138
2014-10-03 16:00:00-04:00,0,10,16,4,0,2112,23419,25531
2014-10-03 17:00:00-04:00,0,10,17,4,0,2536,21294,23830
2014-10-03 18:00:00-04:00,0,10,18,4,0,2822,17903,20725
2014-10-03 19:00:00-04:00,0,10,19,4,0,3339,24027,27366
2014-10-03 20:00:00-04:00,0,10,20,4,0,3666,29395,33061
2014-10-03 21:00:00-04:00,0,10,21,4,0,3851,31204,35055
2014-10-03 22:00:00-04:00,0,10,22,4,0,3638,29651,33289
2014-10-03 23:00:00-04:00,0,10,23,4,0,3595,28629,32224
2014-10-04 00:00:00-04:00,0,10,0,5,0,3448,29044,32492
2014-10-04 01:00:00-04:00,0,10,1,5,0,3565,27527,31092
2014-10-04 02:00:00-04:00,0,10,2,5,0,3413,25737,29150
2014-10-04 03:00:00-04:00,0,10,3,5,0,3117,22161,25278
2014-10-04 04:00:00-04:00,0.01,10,4,5,0,2540,18577,21117
2014-10-04 05:00:00-04:00,0,10,5,5,0,2138,14550,16688
2014-10-04 06:00:00-04:00,0.02,10,6,5,0,1542,8782,10324
2014-10-04 07:00:00-04:00,0.04,10,7,5,0,749,4231,4980
2014-10-04 08:00:00-04:00,0.02,10,8,5,0,529,4865,5394
2014-10-04 09:00:00-04:00,0.1,10,9,5,0,743,6814,7557
2014-10-04 10:00:00-04:00,0.53,10,10,5,0,1040,10374,11414
2014-10-04 11:00:00-04:00,0.19,10,11,5,0,1417,16092,17509
2014-10-04 12:00:00-04:00,0.1,10,12,5,0,1751,20576,22327
2014-10-04 13:00:00-04:00,0.03,10,13,5,0,1783,21173,22956
2014-10-04 14:00:00-04:00,0.01,10,14,5,0,1783,21055,22838
2014-10-04 15:00:00-04:00,0,10,15,5,0,1870,21069,22939
2014-10-04 16:00:00-04:00,0,10,16,5,0,1886,20693,22579
2014-10-04 17:00:00-04:00,0,10,17,5,0,2022,20738,22760
2014-10-04 18:00:00-04:00,0,10,18,5,0,2244,19746,21990
2014-10-04 19:00:00-04:00,0,10,19,5,0,2369,23467,25836
2014-10-04 20:00:00-04:00,0,10,20,5,0,2791,26540,29331
2014-10-04 21:00:00-04:00,0,10,21,5,0,3257,29715,32972
2014-10-04 22:00:00-04:00,0,10,22,5,0,3166,26880,30046
2014-10-04 23:00:00-04:00,0,10,23,5,0,3279,27045,30324
2014-10-05 00:00:00-04:00,0,10,0,6,0,3399,27877,31276
2014-10-05 01:00:00-04:00,0,10,1,6,0,3522,28614,32136
2014-10-05 02:00:00-04:00,0,10,2,6,0,3358,27003,30361
2014-10-05 03:00:00-04:00,0,10,3,6,0,3232,24390,27622
2014-10-05 04:00:00-04:00,0,10,4,6,0,2752,20716,23468
2014-10-05 05:00:00-04:00,0,10,5,6,0,2252,15910,18162
2014-10-05 06:00:00-04:00,0,10,6,6,0,1742,10217,11959
2014-10-05 07:00:00-04:00,0,10,7,6,0,911,4557,5468
2014-10-05 08:00:00-04:00,0,10,8,6,0,614,4712,5326
2014-10-05 09:00:00-04:00,0,10,9,6,0,611,6568,7179
2014-10-05 10:00:00-04:00,0,10,10,6,0,770,9969,10739
2014-10-05 11:00:00-04:00,0,10,11,6,0,1101,13932,15033
2014-10-05 12:00:00-04:00,0,10,12,6,0,1465,18566,20031
2014-10-05 13:00:00-04:00,0,10,13,6,0,1624,21533,23157
2014-10-05 14:00:00-04:00,0,10,14,6,0,1822,22110,23932
2014-10-05 15:00:00-04:00,0,10,15,6,0,1971,21317,23288
2014-10-05 16:00:00-04:00,0,10,16,6,0,2186,20491,22677
2014-10-05 17:00:00-04:00,0,10,17,6,0,2296,19845,22141
2014-10-05 18:00:00-04:00,0,10,18,6,0,2485,17871,20356
2014-10-05 19:00:00-04:00,0,10,19,6,0,2472,19747,22219
2014-10-05 20:00:00-04:00,0,10,20,6,0,2701,22808,25509
2014-10-05 21:00:00-04:00,0,10,21,6,0,2822,23239,26061
2014-10-05 22:00:00-04:00,0,10,22,6,0,2540,20964,23504
2014-10-05 23:00:00-04:00,0,10,23,6,0,2278,19357,21635
2014-10-06 00:00:00-04:00,0,10,0,0,0,2070,17114,19184
2014-10-06 01:00:00-04:00,0,10,1,0,0,1668,13280,14948
2014-10-06 02:00:00-04:00,0,10,2,0,0,1246,8382,9628
2014-10-06 03:00:00-04:00,0,10,3,0,0,806,4805,5611
2014-10-06 04:00:00-04:00,0,10,4,0,0,507,3102,3609
2014-10-06 05:00:00-04:00,0,10,5,0,0,401,2171,2572
2014-10-06 06:00:00-04:00,0,10,6,0,0,455,2651,3106
2014-10-06 07:00:00-04:00,0,10,7,0,0,384,4724,5108
2014-10-06 08:00:00-04:00,0,10,8,0,0,648,11699,12347
2014-10-06 09:00:00-04:00,0,10,9,0,0,1517,20118,21635
2014-10-06 10:00:00-04:00,0,10,10,0,0,2177,22471,24648
2014-10-06 11:00:00-04:00,0,10,11,0,0,2117,21613,23730
2014-10-06 12:00:00-04:00,0,10,12,0,0,1853,19253,21106
2014-10-06 13:00:00-04:00,0,10,13,0,0,1615,19384,20999
2014-10-06 14:00:00-04:00,0,10,14,0,0,1553,20139,21692
2014-10-06 15:00:00-04:00,0,10,15,0,0,1574,19445,21019
2014-10-06 16:00:00-04:00,0,10,16,0,0,1838,21116,22954
2014-10-06 17:00:00-04:00,0,10,17,0,0,1937,20912,22849
2014-10-06 18:00:00-04:00,0,10,18,0,0,2094,18698,20792
2014-10-06 19:00:00-04:00,0,10,19,0,0,2482,23543,26025
2014-10-06 20:00:00-04:00,0,10,20,0,0,2572,28349,30921
2014-10-06 21:00:00-04:00,0,10,21,0,0,2563,28733,31296
2014-10-06 22:00:00-04:00,0,10,22,0,0,2213,26019,28232
2014-10-06 23:00:00-04:00,0,10,23,0,0,1895,24549,26444
2014-10-07 00:00:00-04:00,0,10,0,1,0,1686,21553,23239
2014-10-07 01:00:00-04:00,0,10,1,1,0,1447,16155,17602
2014-10-07 02:00:00-04:00,0,10,2,1,0,1085,9721,10806
2014-10-07 03:00:00-04:00,0,10,3,1,0,744,5716,6460
2014-10-07 04:00:00-04:00,0,10,4,1,0,407,3590,3997
2014-10-07 05:00:00-04:00,0,10,5,1,0,298,2335,2633
2014-10-07 06:00:00-04:00,0,10,6,1,0,361,2394,2755
2014-10-07 07:00:00-04:00,0,10,7,1,0,331,4335,4666
2014-10-07 08:00:00-04:00,0,10,8,1,0,618,11715,12333
2014-10-07 09:00:00-04:00,0,10,9,1,0,1487,21535,23022
2014-10-07 10:00:00-04:00,0,10,10,1,0,2154,24375,26529
2014-10-07 11:00:00-04:00,0,10,11,1,0,2060,22774,24834
2014-10-07 12:00:00-04:00,0,10,12,1,0,1746,20625,22371
2014-10-07 13:00:00-04:00,0,10,13,1,0,1611,20038,21649
2014-10-07 14:00:00-04:00,0,10,14,1,0,1609,21094,22703
2014-10-07 15:00:00-04:00,0,10,15,1,0,1619,20483,22102
2014-10-07 16:00:00-04:00,0,10,16,1,0,1907,22000,23907
2014-10-07 17:00:00-04:00,0,10,17,1,0,2163,20732,22895
2014-10-07 18:00:00-04:00,0,10,18,1,0,2220,17097,19317
2014-10-07 19:00:00-04:00,0,10,19,1,0,2549,22676,25225
2014-10-07 20:00:00-04:00,0,10,20,1,0,2730,28177,30907
2014-10-07 21:00:00-04:00,0,10,21,1,0,2735,29979,32714
2014-10-07 22:00:00-04:00,0,10,22,1,0,2408,28903,31311
2014-10-07 23:00:00-04:00,0.01,10,23,1,0,2194,28024,30218
2014-10-08 00:00:00-04:00,0.02,10,0,2,0,2040,26392,28432
2014-10-08 01:00:00-04:00,0.02,10,1,2,0,1909,22181,24090
2014-10-08 02:00:00-04:00,0.01,10,2,2,0,1398,12880,14278
2014-10-08 03:00:00-04:00,0,10,3,2,0,871,7312,8183
2014-10-08 04:00:00-04:00,0,10,4,2,0,494,4255,4749
2014-10-08 05:00:00-04:00,0,10,5,2,0,399,2978,3377
2014-10-08 06:00:00-04:00,0,10,6,2,0,357,2755,3112
2014-10-08 07:00:00-04:00,0,10,7,2,0,335,4438,4773
2014-10-08 08:00:00-04:00,0,10,8,2,0,592,11955,12547
2014-10-08 09:00:00-04:00,0,10,9,2,0,1521,22281,23802
2014-10-08 10:00:00-04:00,0,10,10,2,0,2258,25012,27270
2014-10-08 11:00:00-04:00,0,10,11,2,0,2088,22775,24863
2014-10-08 12:00:00-04:00,0,10,12,2,0,1815,21244,23059
2014-10-08 13:00:00-04:00,0,10,13,2,0,1757,21475,23232
2014-10-08 14:00:00-04:00,0,10,14,2,0,1750,21716,23466
2014-10-08 15:00:00-04:00,0,10,15,2,0,1667,21229,22896
2014-10-08 16:00:00-04:00,0,10,16,2,0,2032,22592,24624
2014-10-08 17:00:00-04:00,0,10,17,2,0,2156,21526,23682
2014-10-08 18:00:00-04:00,0,10,18,2,0,2369,17448,19817
2014-10-08 19:00:00-04:00,0,10,19,2,0,2681,22515,25196
2014-10-08 20:00:00-04:00,0,10,20,2,0,2964,28797,31761
2014-10-08 21:00:00-04:00,0,10,21,2,0,2981,30747,33728
2014-10-08 22:00:00-04:00,0,10,22,2,0,2582,29895,32477
2014-10-08 23:00:00-04:00,0,10,23,2,0,2346,29653,31999
2014-10-09 00:00:00-04:00,0,10,0,3,0,2214,28267,30481
2014-10-09 01:00:00-04:00,0,10,1,3,0,1908,22325,24233
2014-10-09 02:00:00-04:00,0,10,2,3,0,1532,14263,15795
2014-10-09 03:00:00-04:00,0,10,3,3,0,1034,8372,9406
2014-10-09 04:00:00-04:00,0,10,4,3,0,676,5263,5939
2014-10-09 05:00:00-04:00,0,10,5,3,0,483,3446,3929
2014-10-09 06:00:00-04:00,0,10,6,3,0,449,3355,3804
2014-10-09 07:00:00-04:00,0,10,7,3,0,396,4830,5226
2014-10-09 08:00:00-04:00,0,10,8,3,0,676,12107,12783
2014-10-09 09:00:00-04:00,0,10,9,3,0,1589,22189,23778
2014-10-09 10:00:00-04:00,0,10,10,3,0,2258,25132,27390
2014-10-09 11:00:00-04:00,0,10,11,3,0,2075,23474,25549
2014-10-09 12:00:00-04:00,0,10,12,3,0,1848,22002,23850
2014-10-09 13:00:00-04:00,0,10,13,3,0,1766,21756,23522
2014-10-09 14:00:00-04:00,0,10,14,3,0,1777,22277,24054
2014-10-09 15:00:00-04:00,0,10,15,3,0,1779,22080,23859
2014-10-09 16:00:00-04:00,0,10,16,3,0,2045,23483,25528
2014-10-09 17:00:00-04:00,0,10,17,3,0,2252,21872,24124
2014-10-09 18:00:00-04:00,0,10,18,3,0,2522,17854,20376
2014-10-09 19:00:00-04:00,0,10,19,3,0,2912,23358,26270
2014-10-09 20:00:00-04:00,0,10,20,3,0,3226,28929,32155
2014-10-09 21:00:00-04:00,0,10,21,3,0,3215,31642,34857
2014-10-09 22:00:00-04:00,0,10,22,3,0,3004,31242,34246
2014-10-09 23:00:00-04:00,0,10,23,3,0,2736,31404,34140
2014-10-10 00:00:00-04:00,0,10,0,4,0,2543,30274,32817
2014-10-10 01:00:00-04:00,0,10,1,4,0,2310,26757,29067
2014-10-10 02:00:00-04:00,0,10,2,4,0,1869,19729,21598
2014-10-10 03:00:00-04:00,0,10,3,4,0,1467,14224,15691
2014-10-10 04:00:00-04:00,0,10,4,4,0,1007,8547,9554
2014-10-10 05:00:00-04:00,0,10,5,4,0,732,5641,6373
2014-10-10 06:00:00-04:00,0,10,6,4,0,655,4738,5393
2014-10-10 07:00:00-04:00,0,10,7,4,0,511,5513,6024
2014-10-10 08:00:00-04:00,0,10,8,4,0,688,12213,12901
2014-10-10 09:00:00-04:00,0,10,9,4,0,1625,21868,23493
2014-10-10 10:00:00-04:00,0,10,10,4,0,2400,25487,27887
2014-10-10 11:00:00-04:00,0,10,11,4,0,2217,23990,26207
2014-10-10 12:00:00-04:00,0,10,12,4,0,1958,21907,23865
2014-10-10 13:00:00-04:00,0,10,13,4,0,1809,22200,24009
2014-10-10 14:00:00-04:00,0,10,14,4,0,1750,22380,24130
2014-10-10 15:00:00-04:00,0,10,15,4,0,1788,21495,23283
2014-10-10 16:00:00-04:00,0,10,16,4,0,2087,23906,25993
2014-10-10 17:00:00-04:00,0,10,17,4,0,2515,20998,23513
2014-10-10 18:00:00-04:00,0,10,18,4,0,2758,16973,19731
2014-10-10 19:00:00-04:00,0,10,19,4,0,3515,22136,25651
2014-10-10 20:00:00-04:00,0,10,20,4,0,3773,27416,31189
2014-10-10 21:00:00-04:00,0,10,21,4,0,3891,30358,34249
2014-10-10 22:00:00-04:00,0,10,22,4,0,3778,29420,33198
2014-10-10 23:00:00-04:00,0,10,23,4,0,3553,29245,32798
2014-10-11 00:00:00-04:00,0,10,0,5,0,3638,29589,33227
2014-10-11 01:00:00-04:00,0,10,1,5,0,3723,30009,33732
2014-10-11 02:00:00-04:00,0,10,2,5,0,3653,27399,31052
2014-10-11 03:00:00-04:00,0,10,3,5,0,3239,24053,27292
2014-10-11 04:00:00-04:00,0.03,10,4,5,0,2913,20401,23314
2014-10-11 05:00:00-04:00,0.05,10,5,5,0,2274,14856,17130
2014-10-11 06:00:00-04:00,0.04,10,6,5,0,1804,9693,11497
2014-10-11 07:00:00-04:00,0.01,10,7,5,0,958,4819,5777
2014-10-11 08:00:00-04:00,0.05,10,8,5,0,676,5759,6435
2014-10-11 09:00:00-04:00,0.05,10,9,5,0,875,9207,10082
2014-10-11 10:00:00-04:00,0.07,10,10,5,0,1290,14507,15797
2014-10-11 11:00:00-04:00,0.03,10,11,5,0,1626,19650,21276
2014-10-11 12:00:00-04:00,0,10,12,5,0,1911,23367,25278
2014-10-11 13:00:00-04:00,0,10,13,5,0,1949,24801,26750
2014-10-11 14:00:00-04:00,0,10,14,5,0,2086,25054,27140
2014-10-11 15:00:00-04:00,0,10,15,5,0,2193,24396,26589
2014-10-11 16:00:00-04:00,0,10,16,5,0,2339,23569,25908
2014-10-11 17:00:00-04:00,0,10,17,5,0,2520,23437,25957
2014-10-11 18:00:00-04:00,0,10,18,5,0,2774,20841,23615
2014-10-11 19:00:00-04:00,0,10,19,5,0,3000,24105,27105
2014-10-11 20:00:00-04:00,0,10,20,5,0,3290,28212,31502
2014-10-11 21:00:00-04:00,0,10,21,5,0,3765,29689,33454
2014-10-11 22:00:00-04:00,0,10,22,5,0,3599,27340,30939
2014-10-11 23:00:00-04:00,0,10,23,5,0,3525,26327,29852
2014-10-12 00:00:00-04:00,0,10,0,6,0,3709,28296,32005
2014-10-12 01:00:00-04:00,0,10,1,6,0,3953,29752,33705
2014-10-12 02:00:00-04:00,0,10,2,6,0,3890,28822,32712
2014-10-12 03:00:00-04:00,0,10,3,6,0,3654,25941,29595
2014-10-12 04:00:00-04:00,0,10,4,6,0,3182,22403,25585
2014-10-12 05:00:00-04:00,0,10,5,6,0,2650,17229,19879
2014-10-12 06:00:00-04:00,0,10,6,6,0,2056,10713,12769
2014-10-12 07:00:00-04:00,0,10,7,6,0,988,4812,5800
2014-10-12 08:00:00-04:00,0,10,8,6,0,725,5329,6054
2014-10-12 09:00:00-04:00,0,10,9,6,0,654,6332,6986
2014-10-12 10:00:00-04:00,0,10,10,6,0,840,9722,10562
2014-10-12 11:00:00-04:00,0,10,11,6,0,1194,14570,15764
2014-10-12 12:00:00-04:00,0,10,12,6,0,1539,19215,20754
2014-10-12 13:00:00-04:00,0,10,13,6,0,1699,21832,23531
2014-10-12 14:00:00-04:00,0,10,14,6,0,1882,22677,24559
2014-10-12 15:00:00-04:00,0,10,15,6,0,2015,22377,24392
2014-10-12 16:00:00-04:00,0,10,16,6,0,2271,21304,23575
2014-10-12 17:00:00-04:00,0,10,17,6,0,2406,19866,22272
2014-10-12 18:00:00-04:00,0,10,18,6,0,2607,17799,20406
2014-10-12 19:00:00-04:00,0,10,19,6,0,2806,20507,23313
2014-10-12 20:00:00-04:00,0,10,20,6,0,2926,22948,25874
2014-10-12 21:00:00-04:00,0,10,21,6,0,2957,23442,26399
2014-10-12 22:00:00-04:00,0,10,22,6,0,2844,21953,24797
2014-10-12 23:00:00-04:00,0,10,23,6,0,2541,20713,23254
2014-10-13 00:00:00-04:00,0,10,0,0,1,2514,20288,22802
2014-10-13 01:00:00-04:00,0,10,1,0,1,2353,16879,19232
2014-10-13 02:00:00-04:00,0,10,2,0,1,1833,11989,13822
2014-10-13 03:00:00-04:00,0,10,3,0,1,1316,7168,8484
2014-10-13 04:00:00-04:00,0,10,4,0,1,860,5046,5906
2014-10-13 05:00:00-04:00,0,10,5,0,1,737,3494,4231
2014-10-13 06:00:00-04:00,0,10,6,0,1,690,3486,4176
2014-10-13 07:00:00-04:00,0,10,7,0,1,456,4261,4717
2014-10-13 08:00:00-04:00,0,10,8,0,1,503,8486,8989
2014-10-13 09:00:00-04:00,0,10,9,0,1,832,14020,14852
2014-10-13 10:00:00-04:00,0,10,10,0,1,1327,18240,19567
2014-10-13 11:00:00-04:00,0,10,11,0,1,1509,19209,20718
2014-10-13 12:00:00-04:00,0,10,12,0,1,1349,17827,19176
2014-10-13 13:00:00-04:00,0,10,13,0,1,1340,18028,19368
2014-10-13 14:00:00-04:00,0,10,14,0,1,1373,18664,20037
2014-10-13 15:00:00-04:00,0,10,15,0,1,1478,19033,20511
2014-10-13 16:00:00-04:00,0,10,16,0,1,1638,20030,21668
2014-10-13 17:00:00-04:00,0,10,17,0,1,1877,20080,21957
2014-10-13 18:00:00-04:00,0,10,18,0,1,1993,18639,20632
2014-10-13 19:00:00-04:00,0.01,10,19,0,1,2250,21998,24248
2014-10-13 20:00:00-04:00,0,10,20,0,1,2523,27539,30062
2014-10-13 21:00:00-04:00,0.01,10,21,0,1,2514,27688,30202
2014-10-13 22:00:00-04:00,0,10,22,0,1,2228,25889,28117
2014-10-13 23:00:00-04:00,0,10,23,0,1,1923,23981,25904
2014-10-14 00:00:00-04:00,0.01,10,0,1,0,1549,19420,20969
2014-10-14 01:00:00-04:00,0,10,1,1,0,1325,14956,16281
2014-10-14 02:00:00-04:00,0,10,2,1,0,979,9124,10103
2014-10-14 03:00:00-04:00,0,10,3,1,0,678,5716,6394
2014-10-14 04:00:00-04:00,0,10,4,1,0,407,3306,3713
2014-10-14 05:00:00-04:00,0,10,5,1,0,299,2162,2461
2014-10-14 06:00:00-04:00,0,10,6,1,0,343,2410,2753
2014-10-14 07:00:00-04:00,0,10,7,1,0,334,4433,4767
2014-10-14 08:00:00-04:00,0,10,8,1,0,603,11867,12470
2014-10-14 09:00:00-04:00,0,10,9,1,0,1549,21528,23077
2014-10-14 10:00:00-04:00,0,10,10,1,0,2421,24892,27313
2014-10-14 11:00:00-04:00,0,10,11,1,0,2122,23277,25399
2014-10-14 12:00:00-04:00,0,10,12,1,0,1728,20832,22560
2014-10-14 13:00:00-04:00,0,10,13,1,0,1597,20719,22316
2014-10-14 14:00:00-04:00,0,10,14,1,0,1630,21309,22939
2014-10-14 15:00:00-04:00,0,10,15,1,0,1640,21146,22786
2014-10-14 16:00:00-04:00,0,10,16,1,0,1934,22561,24495
2014-10-14 17:00:00-04:00,0,10,17,1,0,2002,21374,23376
2014-10-14 18:00:00-04:00,0,10,18,1,0,2148,17595,19743
2014-10-14 19:00:00-04:00,0,10,19,1,0,2488,21699,24187
2014-10-14 20:00:00-04:00,0,10,20,1,0,2902,27582,30484
2014-10-14 21:00:00-04:00,0,10,21,1,0,2681,28481,31162
2014-10-14 22:00:00-04:00,0,10,22,1,0,2301,28078,30379
2014-10-14 23:00:00-04:00,0,10,23,1,0,2127,27916,30043
2014-10-15 00:00:00-04:00,0,10,0,2,0,1869,24850,26719
2014-10-15 01:00:00-04:00,0,10,1,2,0,1615,18672,20287
2014-10-15 02:00:00-04:00,0,10,2,2,0,1223,11896,13119
2014-10-15 03:00:00-04:00,0,10,3,2,0,781,7007,7788
2014-10-15 04:00:00-04:00,0,10,4,2,0,513,4394,4907
2014-10-15 05:00:00-04:00,0,10,5,2,0,406,2887,3293
2014-10-15 06:00:00-04:00,0,10,6,2,0,376,2767,3143
2014-10-15 07:00:00-04:00,0,10,7,2,0,393,4439,4832
2014-10-15 08:00:00-04:00,0,10,8,2,0,704,12218,12922
2014-10-15 09:00:00-04:00,0,10,9,2,0,1542,22431,23973
2014-10-15 10:00:00-04:00,0,10,10,2,0,2320,25612,27932
2014-10-15 11:00:00-04:00,0,10,11,2,0,2176,23986,26162
2014-10-15 12:00:00-04:00,0,10,12,2,0,2000,22215,24215
2014-10-15 13:00:00-04:00,0,10,13,2,0,1772,22110,23882
2014-10-15 14:00:00-04:00,0,10,14,2,0,1733,22473,24206
2014-10-15 15:00:00-04:00,0,10,15,2,0,1756,21962,23718
2014-10-15 16:00:00-04:00,0,10,16,2,0,2089,23320,25409
2014-10-15 17:00:00-04:00,0,10,17,2,0,2267,21409,23676
2014-10-15 18:00:00-04:00,0,10,18,2,0,2402,17431,19833
2014-10-15 19:00:00-04:00,0,10,19,2,0,3231,23088,26319
2014-10-15 20:00:00-04:00,0,10,20,2,0,3195,26582,29777
2014-10-15 21:00:00-04:00,0,10,21,2,0,3082,29898,32980
2014-10-15 22:00:00-04:00,0.01,10,22,2,0,2816,29620,32436
2014-10-15 23:00:00-04:00,0.02,10,23,2,0,2907,29534,32441
2014-10-16 00:00:00-04:00,0,10,0,3,0,2607,27979,30586
2014-10-16 01:00:00-04:00,0,10,1,3,0,2064,21378,23442
2014-10-16 02:00:00-04:00,0.04,10,2,3,0,1588,14139,15727
2014-10-16 03:00:00-04:00,0.1,10,3,3,0,1008,8388,9396
2014-10-16 04:00:00-04:00,0.53,10,4,3,0,685,4932,5617
2014-10-16 05:00:00-04:00,0,10,5,3,0,512,3328,3840
2014-10-16 06:00:00-04:00,0.01,10,6,3,0,481,3186,3667
2014-10-16 07:00:00-04:00,0.01,10,7,3,0,381,4750,5131
2014-10-16 08:00:00-04:00,0,10,8,3,0,681,12735,13416
2014-10-16 09:00:00-04:00,0.04,10,9,3,0,1683,23847,25530
2014-10-16 10:00:00-04:00,0.02,10,10,3,0,2422,26333,28755
2014-10-16 11:00:00-04:00,0.01,10,11,3,0,2522,25446,27968
2014-10-16 12:00:00-04:00,0.01,10,12,3,0,2142,23373,25515
2014-10-16 13:00:00-04:00,0,10,13,3,0,1922,21551,23473
2014-10-16 14:00:00-04:00,0,10,14,3,0,1764,21151,22915
2014-10-16 15:00:00-04:00,0,10,15,3,0,1758,21435,23193
2014-10-16 16:00:00-04:00,0,10,16,3,0,2133,22866,24999
2014-10-16 17:00:00-04:00,0,10,17,3,0,2204,21479,23683
2014-10-16 18:00:00-04:00,0,10,18,3,0,2545,17929,20474
2014-10-16 19:00:00-04:00,0,10,19,3,0,2868,23746,26614
2014-10-16 20:00:00-04:00,0,10,20,3,0,3214,29268,32482
2014-10-16 21:00:00-04:00,0,10,21,3,0,3386,31648,35034
2014-10-16 22:00:00-04:00,0,10,22,3,0,3015,30756,33771
2014-10-16 23:00:00-04:00,0,10,23,3,0,2778,31092,33870
2014-10-17 00:00:00-04:00,0,10,0,4,0,2635,30068,32703
2014-10-17 01:00:00-04:00,0,10,1,4,0,2491,28189,30680
2014-10-17 02:00:00-04:00,0,10,2,4,0,1976,20324,22300
2014-10-17 03:00:00-04:00,0,10,3,4,0,1685,13453,15138
2014-10-17 04:00:00-04:00,0,10,4,4,0,1056,8861,9917
2014-10-17 05:00:00-04:00,0,10,5,4,0,763,5774,6537
2014-10-17 06:00:00-04:00,0,10,6,4,0,609,4736,5345
2014-10-17 07:00:00-04:00,0,10,7,4,0,464,5120,5584
2014-10-17 08:00:00-04:00,0,10,8,4,0,695,11952,12647
2014-10-17 09:00:00-04:00,0,10,9,4,0,1595,21797,23392
2014-10-17 10:00:00-04:00,0,10,10,4,0,2309,24934,27243
2014-10-17 11:00:00-04:00,0,10,11,4,0,2267,23476,25743
2014-10-17 12:00:00-04:00,0,10,12,4,0,1947,21617,23564
2014-10-17 13:00:00-04:00,0,10,13,4,0,1848,21696,23544
2014-10-17 14:00:00-04:00,0,10,14,4,0,1757,22363,24120
2014-10-17 15:00:00-04:00,0,10,15,4,0,1715,21894,23609
2014-10-17 16:00:00-04:00,0,10,16,4,0,2130,23387,25517
2014-10-17 17:00:00-04:00,0,10,17,4,0,2485,21320,23805
2014-10-17 18:00:00-04:00,0,10,18,4,0,2824,17160,19984
2014-10-17 19:00:00-04:00,0,10,19,4,0,3469,22782,26251
2014-10-17 20:00:00-04:00,0,10,20,4,0,3955,28194,32149
2014-10-17 21:00:00-04:00,0,10,21,4,0,4193,30914,35107
2014-10-17 22:00:00-04:00,0,10,22,4,0,4067,30486,34553
2014-10-17 23:00:00-04:00,0,10,23,4,0,3954,30197,34151
2014-10-18 00:00:00-04:00,0,10,0,5,0,4075,30234,34309
2014-10-18 01:00:00-04:00,0,10,1,5,0,4142,29823,33965
2014-10-18 02:00:00-04:00,0,10,2,5,0,3838,27799,31637
2014-10-18 03:00:00-04:00,0,10,3,5,0,3619,24546,28165
2014-10-18 04:00:00-04:00,0,10,4,5,0,3020,20724,23744
2014-10-18 05:00:00-04:00,0,10,5,5,0,2437,15202,17639
2014-10-18 06:00:00-04:00,0,10,6,5,0,1833,9649,11482
2014-10-18 07:00:00-04:00,0,10,7,5,0,952,5088,6040
2014-10-18 08:00:00-04:00,0,10,8,5,0,692,5745,6437
2014-10-18 09:00:00-04:00,0,10,9,5,0,879,9190,10069
2014-10-18 10:00:00-04:00,0,10,10,5,0,1313,14552,15865
2014-10-18 11:00:00-04:00,0,10,11,5,0,1542,18491,20033
2014-10-18 12:00:00-04:00,0,10,12,5,0,1800,21179,22979
2014-10-18 13:00:00-04:00,0,10,13,5,0,2027,23777,25804
2014-10-18 14:00:00-04:00,0,10,14,5,0,2139,25010,27149
2014-10-18 15:00:00-04:00,0,10,15,5,0,2193,24988,27181
2014-10-18 16:00:00-04:00,0,10,16,5,0,2564,24840,27404
2014-10-18 17:00:00-04:00,0,10,17,5,0,2824,24197,27021
2014-10-18 18:00:00-04:00,0,10,18,5,0,2985,20390,23375
2014-10-18 19:00:00-04:00,0,10,19,5,0,3395,23652,27047
2014-10-18 20:00:00-04:00,0,10,20,5,0,3661,28595,32256
2014-10-18 21:00:00-04:00,0,10,21,5,0,3899,30508,34407
2014-10-18 22:00:00-04:00,0,10,22,5,0,3891,27633,31524
2014-10-18 23:00:00-04:00,0,10,23,5,0,3969,27533,31502
2014-10-19 00:00:00-04:00,0,10,0,6,0,4012,29320,33332
2014-10-19 01:00:00-04:00,0,10,1,6,0,4263,31094,35357
2014-10-19 02:00:00-04:00,0,10,2,6,0,4098,29937,34035
2014-10-19 03:00:00-04:00,0,10,3,6,0,3871,27121,30992
2014-10-19 04:00:00-04:00,0,10,4,6,0,3442,22932,26374
2014-10-19 05:00:00-04:00,0,10,5,6,0,2814,17213,20027
2014-10-19 06:00:00-04:00,0,10,6,6,0,2155,10858,13013
2014-10-19 07:00:00-04:00,0,10,7,6,0,1020,5044,6064
2014-10-19 08:00:00-04:00,0,10,8,6,0,668,5083,5751
2014-10-19 09:00:00-04:00,0,10,9,6,0,775,7450,8225
2014-10-19 10:00:00-04:00,0,10,10,6,0,828,10403,11231
2014-10-19 11:00:00-04:00,0,10,11,6,0,1188,15267,16455
2014-10-19 12:00:00-04:00,0,10,12,6,0,1508,19951,21459
2014-10-19 13:00:00-04:00,0,10,13,6,0,1853,23403,25256
2014-10-19 14:00:00-04:00,0,10,14,6,0,2056,25405,27461
2014-10-19 15:00:00-04:00,0,10,15,6,0,2221,25346,27567
2014-10-19 16:00:00-04:00,0,10,16,6,0,2452,24809,27261
2014-10-19 17:00:00-04:00,0,10,17,6,0,2535,23363,25898
2014-10-19 18:00:00-04:00,0,10,18,6,0,2834,20704,23538
2014-10-19 19:00:00-04:00,0,10,19,6,0,3035,22361,25396
2014-10-19 20:00:00-04:00,0,10,20,6,0,3198,24470,27668
2014-10-19 21:00:00-04:00,0,10,21,6,0,3187,25622,28809
2014-10-19 22:00:00-04:00,0,10,22,6,0,2909,22283,25192
2014-10-19 23:00:00-04:00,0,10,23,6,0,2639,20844,23483
2014-10-20 00:00:00-04:00,0,10,0,0,0,2342,18365,20707
2014-10-20 01:00:00-04:00,0,10,1,0,0,1952,13624,15576
2014-10-20 02:00:00-04:00,0,10,2,0,0,1329,9095,10424
2014-10-20 03:00:00-04:00,0,10,3,0,0,859,4936,5795
2014-10-20 04:00:00-04:00,0,10,4,0,0,540,3236,3776
2014-10-20 05:00:00-04:00,0,10,5,0,0,417,2283,2700
2014-10-20 06:00:00-04:00,0,10,6,0,0,470,2684,3154
2014-10-20 07:00:00-04:00,0,10,7,0,0,416,4982,5398
2014-10-20 08:00:00-04:00,0,10,8,0,0,644,12212,12856
2014-10-20 09:00:00-04:00,0,10,9,0,0,1575,20421,21996
2014-10-20 10:00:00-04:00,0,10,10,0,0,2237,22853,25090
2014-10-20 11:00:00-04:00,0,10,11,0,0,2166,21975,24141
2014-10-20 12:00:00-04:00,0,10,12,0,0,1780,20179,21959
2014-10-20 13:00:00-04:00,0,10,13,0,0,1674,20085,21759
2014-10-20 14:00:00-04:00,0,10,14,0,0,1583,20501,22084
2014-10-20 15:00:00-04:00,0,10,15,0,0,1586,20038,21624
2014-10-20 16:00:00-04:00,0,10,16,0,0,1824,21504,23328
2014-10-20 17:00:00-04:00,0,10,17,0,0,1942,21345,23287
2014-10-20 18:00:00-04:00,0,10,18,0,0,2182,18734,20916
2014-10-20 19:00:00-04:00,0,10,19,0,0,2435,23538,25973
2014-10-20 20:00:00-04:00,0,10,20,0,0,2655,28821,31476
2014-10-20 21:00:00-04:00,0,10,21,0,0,2539,28405,30944
2014-10-20 22:00:00-04:00,0,10,22,0,0,2241,26105,28346
2014-10-20 23:00:00-04:00,0,10,23,0,0,1940,25370,27310
2014-10-21 00:00:00-04:00,0,10,0,1,0,1676,22044,23720
2014-10-21 01:00:00-04:00,0,10,1,1,0,1469,15076,16545
2014-10-21 02:00:00-04:00,0,10,2,1,0,1035,9779,10814
2014-10-21 03:00:00-04:00,0,10,3,1,0,750,5695,6445
2014-10-21 04:00:00-04:00,0,10,4,1,0,432,3614,4046
2014-10-21 05:00:00-04:00,0,10,5,1,0,378,2420,2798
2014-10-21 06:00:00-04:00,0,10,6,1,0,366,2496,2862
2014-10-21 07:00:00-04:00,0,10,7,1,0,378,4445,4823
2014-10-21 08:00:00-04:00,0,10,8,1,0,628,11902,12530
2014-10-21 09:00:00-04:00,0,10,9,1,0,1522,21910,23432
2014-10-21 10:00:00-04:00,0,10,10,1,0,2131,25149,27280
2014-10-21 11:00:00-04:00,0,10,11,1,0,2057,23477,25534
2014-10-21 12:00:00-04:00,0,10,12,1,0,1749,20703,22452
2014-10-21 13:00:00-04:00,0,10,13,1,0,1648,20935,22583
2014-10-21 14:00:00-04:00,0,10,14,1,0,1689,21884,23573
2014-10-21 15:00:00-04:00,0,10,15,1,0,1685,20696,22381
2014-10-21 16:00:00-04:00,0,10,16,1,0,1926,22167,24093
2014-10-21 17:00:00-04:00,0,10,17,1,0,2086,21749,23835
2014-10-21 18:00:00-04:00,0,10,18,1,0,2223,18376,20599
2014-10-21 19:00:00-04:00,0,10,19,1,0,2569,23649,26218
2014-10-21 20:00:00-04:00,0,10,20,1,0,2849,28566,31415
2014-10-21 21:00:00-04:00,0,10,21,1,0,2925,30051,32976
2014-10-21 22:00:00-04:00,0,10,22,1,0,2533,29755,32288
2014-10-21 23:00:00-04:00,0,10,23,1,0,2243,29770,32013
2014-10-22 00:00:00-04:00,0,10,0,2,0,2057,26323,28380
2014-10-22 01:00:00-04:00,0,10,1,2,0,1810,20060,21870
2014-10-22 02:00:00-04:00,0,10,2,2,0,1342,12559,13901
2014-10-22 03:00:00-04:00,0.02,10,3,2,0,949,7315,8264
2014-10-22 04:00:00-04:00,0.09,10,4,2,0,569,4520,5089
2014-10-22 05:00:00-04:00,0.13,10,5,2,0,480,3202,3682
2014-10-22 06:00:00-04:00,0.07,10,6,2,0,436,2960,3396
2014-10-22 07:00:00-04:00,0.04,10,7,2,0,434,4931,5365
2014-10-22 08:00:00-04:00,0.09,10,8,2,0,722,13751,14473
2014-10-22 09:00:00-04:00,0.05,10,9,2,0,1684,23013,24697
2014-10-22 10:00:00-04:00,0.05,10,10,2,0,2530,25963,28493
2014-10-22 11:00:00-04:00,0,10,11,2,0,2434,24449,26883
2014-10-22 12:00:00-04:00,0,10,12,2,0,2034,21922,23956
2014-10-22 13:00:00-04:00,0,10,13,2,0,1836,21241,23077
2014-10-22 14:00:00-04:00,0,10,14,2,0,1834,21631,23465
2014-10-22 15:00:00-04:00,0,10,15,2,0,1722,20911,22633
2014-10-22 16:00:00-04:00,0.02,10,16,2,0,2023,22864,24887
2014-10-22 17:00:00-04:00,0.09,10,17,2,0,2214,21192,23406
2014-10-22 18:00:00-04:00,0.13,10,18,2,0,2692,17519,20211
2014-10-22 19:00:00-04:00,0.11,10,19,2,0,3540,22800,26340
2014-10-22 20:00:00-04:00,0.09,10,20,2,0,3741,27674,31415
2014-10-22 21:00:00-04:00,0.08,10,21,2,0,3920,29938,33858
2014-10-22 22:00:00-04:00,0.14,10,22,2,0,3483,30338,33821
2014-10-22 23:00:00-04:00,0.11,10,23,2,0,3084,30183,33267
2014-10-23 00:00:00-04:00,0,10,0,3,0,2843,27380,30223
2014-10-23 01:00:00-04:00,0,10,1,3,0,2297,23466,25763
2014-10-23 02:00:00-04:00,0,10,2,3,0,1537,14162,15699
2014-10-23 03:00:00-04:00,0,10,3,3,0,951,8377,9328
2014-10-23 04:00:00-04:00,0.05,10,4,3,0,634,4687,5321
2014-10-23 05:00:00-04:00,0.01,10,5,3,0,461,3205,3666
2014-10-23 06:00:00-04:00,0,10,6,3,0,422,3010,3432
2014-10-23 07:00:00-04:00,0.03,10,7,3,0,387,4845,5232
2014-10-23 08:00:00-04:00,0.05,10,8,3,0,705,13211,13916
2014-10-23 09:00:00-04:00,0.02,10,9,3,0,1774,23192,24966
2014-10-23 10:00:00-04:00,0.01,10,10,3,0,2643,26562,29205
2014-10-23 11:00:00-04:00,0,10,11,3,0,2501,24547,27048
2014-10-23 12:00:00-04:00,0.03,10,12,3,0,2162,22587,24749
2014-10-23 13:00:00-04:00,0,10,13,3,0,2003,23384,25387
2014-10-23 14:00:00-04:00,0.08,10,14,3,0,2100,24000,26100
2014-10-23 15:00:00-04:00,0.02,10,15,3,0,2005,22207,24212
2014-10-23 16:00:00-04:00,0,10,16,3,0,2408,22709,25117
2014-10-23 17:00:00-04:00,0,10,17,3,0,2533,19525,22058
2014-10-23 18:00:00-04:00,0,10,18,3,0,2717,15717,18434
2014-10-23 19:00:00-04:00,0,10,19,3,0,2976,21206,24182
2014-10-23 20:00:00-04:00,0,10,20,3,0,3387,27317,30704
2014-10-23 21:00:00-04:00,0.02,10,21,3,0,3330,30169,33499
2014-10-23 22:00:00-04:00,0,10,22,3,0,3040,30551,33591
2014-10-23 23:00:00-04:00,0,10,23,3,0,2961,30345,33306
2014-10-24 00:00:00-04:00,0,10,0,4,0,2709,29208,31917
2014-10-24 01:00:00-04:00,0,10,1,4,0,2430,27095,29525
2014-10-24 02:00:00-04:00,0,10,2,4,0,2027,20983,23010
2014-10-24 03:00:00-04:00,0,10,3,4,0,1535,13135,14670
2014-10-24 04:00:00-04:00,0,10,4,4,0,980,8290,9270
2014-10-24 05:00:00-04:00,0,10,5,4,0,751,5635,6386
2014-10-24 06:00:00-04:00,0,10,6,4,0,639,4593,5232
2014-10-24 07:00:00-04:00,0,10,7,4,0,459,4989,5448
2014-10-24 08:00:00-04:00,0,10,8,4,0,667,12302,12969
2014-10-24 09:00:00-04:00,0,10,9,4,0,1578,21599,23177
2014-10-24 10:00:00-04:00,0,10,10,4,0,2372,24690,27062
2014-10-24 11:00:00-04:00,0,10,11,4,0,2246,23657,25903
2014-10-24 12:00:00-04:00,0,10,12,4,0,1950,21996,23946
2014-10-24 13:00:00-04:00,0,10,13,4,0,1824,21832,23656
2014-10-24 14:00:00-04:00,0,10,14,4,0,1872,22111,23983
2014-10-24 15:00:00-04:00,0,10,15,4,0,1850,21865,23715
2014-10-24 16:00:00-04:00,0,10,16,4,0,2262,23295,25557
2014-10-24 17:00:00-04:00,0,10,17,4,0,2483,20926,23409
2014-10-24 18:00:00-04:00,0,10,18,4,0,2905,17381,20286
2014-10-24 19:00:00-04:00,0,10,19,4,0,3260,22568,25828
2014-10-24 20:00:00-04:00,0,10,20,4,0,3745,28335,32080
2014-10-24 21:00:00-04:00,0,10,21,4,0,3967,31228,35195
2014-10-24 22:00:00-04:00,0,10,22,4,0,3929,30254,34183
2014-10-24 23:00:00-04:00,0,10,23,4,0,3935,29665,33600
2014-10-25 00:00:00-04:00,0,10,0,5,0,4000,30297,34297
2014-10-25 01:00:00-04:00,0,10,1,5,0,4107,30438,34545
2014-10-25 02:00:00-04:00,0,10,2,5,0,3932,27680,31612
2014-10-25 03:00:00-04:00,0,10,3,5,0,3657,24319,27976
2014-10-25 04:00:00-04:00,0,10,4,5,0,3025,20537,23562
2014-10-25 05:00:00-04:00,0,10,5,5,0,2421,15024,17445
2014-10-25 06:00:00-04:00,0,10,6,5,0,1710,9507,11217
2014-10-25 07:00:00-04:00,0,10,7,5,0,888,4658,5546
2014-10-25 08:00:00-04:00,0,10,8,5,0,715,5359,6074
2014-10-25 09:00:00-04:00,0,10,9,5,0,808,8680,9488
2014-10-25 10:00:00-04:00,0,10,10,5,0,1207,12935,14142
2014-10-25 11:00:00-04:00,0,10,11,5,0,1504,18009,19513
2014-10-25 12:00:00-04:00,0,10,12,5,0,1756,20506,22262
2014-10-25 13:00:00-04:00,0,10,13,5,0,2017,23651,25668
2014-10-25 14:00:00-04:00,0,10,14,5,0,2141,24861,27002
2014-10-25 15:00:00-04:00,0,10,15,5,0,2257,24839,27096
2014-10-25 16:00:00-04:00,0,10,16,5,0,2603,23708,26311
2014-10-25 17:00:00-04:00,0,10,17,5,0,2750,23595,26345
2014-10-25 18:00:00-04:00,0,10,18,5,0,3042,19931,22973
2014-10-25 19:00:00-04:00,0,10,19,5,0,3447,23089,26536
2014-10-25 20:00:00-04:00,0,10,20,5,0,3742,27679,31421
2014-10-25 21:00:00-04:00,0,10,21,5,0,4016,29811,33827
2014-10-25 22:00:00-04:00,0,10,22,5,0,3966,27238,31204
2014-10-25 23:00:00-04:00,0,10,23,5,0,4009,26434,30443
2014-10-26 00:00:00-04:00,0,10,0,6,0,4266,28460,32726
2014-10-26 01:00:00-04:00,0,10,1,6,0,4300,30363,34663
2014-10-26 02:00:00-04:00,0,10,2,6,0,4335,29422,33757
2014-10-26 03:00:00-04:00,0,10,3,6,0,3974,26100,30074
2014-10-26 04:00:00-04:00,0,10,4,6,0,3530,22205,25735
2014-10-26 05:00:00-04:00,0,10,5,6,0,2841,17125,19966
2014-10-26 06:00:00-04:00,0,10,6,6,0,2116,10760,12876
2014-10-26 07:00:00-04:00,0,10,7,6,0,971,5016,5987
2014-10-26 08:00:00-04:00,0,10,8,6,0,666,4873,5539
2014-10-26 09:00:00-04:00,0,10,9,6,0,694,6662,7356
2014-10-26 10:00:00-04:00,0,10,10,6,0,827,10031,10858
2014-10-26 11:00:00-04:00,0,10,11,6,0,1101,14957,16058
2014-10-26 12:00:00-04:00,0,10,12,6,0,1442,20047,21489
2014-10-26 13:00:00-04:00,0,10,13,6,0,1883,22594,24477
2014-10-26 14:00:00-04:00,0,10,14,6,0,2007,24396,26403
2014-10-26 15:00:00-04:00,0,10,15,6,0,1983,23604,25587
2014-10-26 16:00:00-04:00,0,10,16,6,0,2353,23729,26082
2014-10-26 17:00:00-04:00,0,10,17,6,0,2509,22971,25480
2014-10-26 18:00:00-04:00,0,10,18,6,0,2656,20421,23077
2014-10-26 19:00:00-04:00,0,10,19,6,0,2859,21616,24475
2014-10-26 20:00:00-04:00,0,10,20,6,0,2884,23402,26286
2014-10-26 21:00:00-04:00,0,10,21,6,0,2738,22708,25446
2014-10-26 22:00:00-04:00,0,10,22,6,0,2583,20408,22991
2014-10-26 23:00:00-04:00,0,10,23,6,0,2312,18868,21180
2014-10-27 00:00:00-04:00,0,10,0,0,0,2144,16293,18437
2014-10-27 01:00:00-04:00,0,10,1,0,0,1753,12985,14738
2014-10-27 02:00:00-04:00,0,10,2,0,0,1233,9005,10238
2014-10-27 03:00:00-04:00,0,10,3,0,0,823,4861,5684
2014-10-27 04:00:00-04:00,0,10,4,0,0,514,3206,3720
2014-10-27 05:00:00-04:00,0,10,5,0,0,438,2193,2631
2014-10-27 06:00:00-04:00,0,10,6,0,0,484,2796,3280
2014-10-27 07:00:00-04:00,0,10,7,0,0,429,5022,5451
2014-10-27 08:00:00-04:00,0,10,8,0,0,694,11703,12397
2014-10-27 09:00:00-04:00,0,10,9,0,0,1556,20000,21556
2014-10-27 10:00:00-04:00,0,10,10,0,0,2272,22423,24695
2014-10-27 11:00:00-04:00,0,10,11,0,0,2200,21602,23802
2014-10-27 12:00:00-04:00,0,10,12,0,0,1811,19622,21433
2014-10-27 13:00:00-04:00,0,10,13,0,0,1558,19095,20653
2014-10-27 14:00:00-04:00,0,10,14,0,0,1595,20106,21701
2014-10-27 15:00:00-04:00,0,10,15,0,0,1603,19286,20889
2014-10-27 16:00:00-04:00,0,10,16,0,0,1856,20927,22783
2014-10-27 17:00:00-04:00,0,10,17,0,0,1992,21283,23275
2014-10-27 18:00:00-04:00,0,10,18,0,0,2178,18800,20978
2014-10-27 19:00:00-04:00,0,10,19,0,0,2314,23041,25355
2014-10-27 20:00:00-04:00,0,10,20,0,0,2724,27705,30429
2014-10-27 21:00:00-04:00,0,10,21,0,0,2484,28378,30862
2014-10-27 22:00:00-04:00,0,10,22,0,0,2199,25727,27926
2014-10-27 23:00:00-04:00,0,10,23,0,0,1954,25137,27091
2014-10-28 00:00:00-04:00,0,10,0,1,0,1707,22496,24203
2014-10-28 01:00:00-04:00,0,10,1,1,0,1356,17442,18798
2014-10-28 02:00:00-04:00,0,10,2,1,0,1114,11080,12194
2014-10-28 03:00:00-04:00,0,10,3,1,0,717,6119,6836
2014-10-28 04:00:00-04:00,0,10,4,1,0,432,3814,4246
2014-10-28 05:00:00-04:00,0,10,5,1,0,323,2563,2886
2014-10-28 06:00:00-04:00,0,10,6,1,0,353,2576,2929
2014-10-28 07:00:00-04:00,0,10,7,1,0,386,4619,5005
2014-10-28 08:00:00-04:00,0,10,8,1,0,610,11748,12358
2014-10-28 09:00:00-04:00,0,10,9,1,0,1551,21707,23258
2014-10-28 10:00:00-04:00,0,10,10,1,0,2210,24265,26475
2014-10-28 11:00:00-04:00,0,10,11,1,0,2126,22431,24557
2014-10-28 12:00:00-04:00,0,10,12,1,0,1834,20737,22571
2014-10-28 13:00:00-04:00,0,10,13,1,0,1647,20446,22093
2014-10-28 14:00:00-04:00,0,10,14,1,0,1639,21222,22861
2014-10-28 15:00:00-04:00,0,10,15,1,0,1569,20559,22128
2014-10-28 16:00:00-04:00,0,10,16,1,0,1875,22170,24045
2014-10-28 17:00:00-04:00,0,10,17,1,0,2117,21226,23343
2014-10-28 18:00:00-04:00,0,10,18,1,0,2266,17397,19663
2014-10-28 19:00:00-04:00,0,10,19,1,0,2576,22005,24581
2014-10-28 20:00:00-04:00,0,10,20,1,0,2838,26925,29763
2014-10-28 21:00:00-04:00,0,10,21,1,0,2684,28045,30729
2014-10-28 22:00:00-04:00,0,10,22,1,0,2426,28161,30587
2014-10-28 23:00:00-04:00,0,10,23,1,0,2235,28485,30720
2014-10-29 00:00:00-04:00,0,10,0,2,0,1952,25654,27606
2014-10-29 01:00:00-04:00,0,10,1,2,0,1620,20848,22468
2014-10-29 02:00:00-04:00,0,10,2,2,0,1269,12934,14203
2014-10-29 03:00:00-04:00,0,10,3,2,0,871,7646,8517
2014-10-29 04:00:00-04:00,0,10,4,2,0,547,4828,5375
2014-10-29 05:00:00-04:00,0,10,5,2,0,386,3091,3477
2014-10-29 06:00:00-04:00,0,10,6,2,0,384,2971,3355
2014-10-29 07:00:00-04:00,0,10,7,2,0,353,4384,4737
2014-10-29 08:00:00-04:00,0,10,8,2,0,674,11722,12396
2014-10-29 09:00:00-04:00,0,10,9,2,0,1514,22061,23575
2014-10-29 10:00:00-04:00,0,10,10,2,0,2257,24589,26846
2014-10-29 11:00:00-04:00,0,10,11,2,0,2091,23310,25401
2014-10-29 12:00:00-04:00,0,10,12,2,0,1820,20689,22509
2014-10-29 13:00:00-04:00,0,10,13,2,0,1661,20714,22375
2014-10-29 14:00:00-04:00,0,10,14,2,0,1653,21231,22884
2014-10-29 15:00:00-04:00,0,10,15,2,0,1657,21031,22688
2014-10-29 16:00:00-04:00,0,10,16,2,0,1981,22716,24697
2014-10-29 17:00:00-04:00,0,10,17,2,0,2113,21418,23531
2014-10-29 18:00:00-04:00,0,10,18,2,0,2414,17379,19793
2014-10-29 19:00:00-04:00,0,10,19,2,0,3316,23395,26711
2014-10-29 20:00:00-04:00,0,10,20,2,0,3062,27244,30306
2014-10-29 21:00:00-04:00,0,10,21,2,0,3286,30306,33592
2014-10-29 22:00:00-04:00,0,10,22,2,0,2782,29653,32435
2014-10-29 23:00:00-04:00,0,10,23,2,0,2573,29605,32178
2014-10-30 00:00:00-04:00,0,10,0,3,0,2298,28140,30438
2014-10-30 01:00:00-04:00,0,10,1,3,0,2000,22984,24984
2014-10-30 02:00:00-04:00,0,10,2,3,0,1530,14634,16164
2014-10-30 03:00:00-04:00,0,10,3,3,0,1014,8871,9885
2014-10-30 04:00:00-04:00,0,10,4,3,0,634,5466,6100
2014-10-30 05:00:00-04:00,0,10,5,3,0,472,3717,4189
2014-10-30 06:00:00-04:00,0,10,6,3,0,515,3293,3808
2014-10-30 07:00:00-04:00,0,10,7,3,0,461,5164,5625
2014-10-30 08:00:00-04:00,0,10,8,3,0,666,12892,13558
2014-10-30 09:00:00-04:00,0,10,9,3,0,1643,22191,23834
2014-10-30 10:00:00-04:00,0,10,10,3,0,2388,24804,27192
2014-10-30 11:00:00-04:00,0,10,11,3,0,2293,23847,26140
2014-10-30 12:00:00-04:00,0,10,12,3,0,2004,22060,24064
2014-10-30 13:00:00-04:00,0,10,13,3,0,1789,21573,23362
2014-10-30 14:00:00-04:00,0,10,14,3,0,1820,22263,24083
2014-10-30 15:00:00-04:00,0,10,15,3,0,1917,21574,23491
2014-10-30 16:00:00-04:00,0,10,16,3,0,2200,23171,25371
2014-10-30 17:00:00-04:00,0,10,17,3,0,2262,21222,23484
2014-10-30 18:00:00-04:00,0,10,18,3,0,2674,16515,19189
2014-10-30 19:00:00-04:00,0,10,19,3,0,3072,21590,24662
2014-10-30 20:00:00-04:00,0,10,20,3,0,3504,27101,30605
2014-10-30 21:00:00-04:00,0,10,21,3,0,3591,29885,33476
2014-10-30 22:00:00-04:00,0,10,22,3,0,3354,30519,33873
2014-10-30 23:00:00-04:00,0,10,23,3,0,3112,30471,33583
2014-10-31 00:00:00-04:00,0,10,0,4,0,2873,29302,32175
2014-10-31 01:00:00-04:00,0,10,1,4,0,2750,27369,30119
2014-10-31 02:00:00-04:00,0,10,2,4,0,2211,21460,23671
2014-10-31 03:00:00-04:00,0,10,3,4,0,1674,14374,16048
2014-10-31 04:00:00-04:00,0,10,4,4,0,1188,9722,10910
2014-10-31 05:00:00-04:00,0,10,5,4,0,789,6612,7401
2014-10-31 06:00:00-04:00,0,10,6,4,0,714,5036,5750
2014-10-31 07:00:00-04:00,0,10,7,4,0,513,5157,5670
2014-10-31 08:00:00-04:00,0,10,8,4,0,702,12233,12935
2014-10-31 09:00:00-04:00,0,10,9,4,0,1584,21389,22973
2014-10-31 10:00:00-04:00,0,10,10,4,0,2431,25279,27710
2014-10-31 11:00:00-04:00,0,10,11,4,0,2430,23714,26144
2014-10-31 12:00:00-04:00,0,10,12,4,0,2217,22291,24508
2014-10-31 13:00:00-04:00,0,10,13,4,0,2006,22182,24188
2014-10-31 14:00:00-04:00,0,10,14,4,0,2080,23081,25161
2014-10-31 15:00:00-04:00,0,10,15,4,0,2046,22794,24840
2014-10-31 16:00:00-04:00,0,10,16,4,0,2522,24736,27258
2014-10-31 17:00:00-04:00,0,10,17,4,0,2871,21937,24808
2014-10-31 18:00:00-04:00,0,10,18,4,0,3322,17035,20357
2014-10-31 19:00:00-04:00,0,10,19,4,0,3814,21559,25373
2014-10-31 20:00:00-04:00,0,10,20,4,0,4085,26456,30541
2014-10-31 21:00:00-04:00,0,10,21,4,0,4557,29555,34112
2014-10-31 22:00:00-04:00,0,10,22,4,0,4793,30051,34844
2014-10-31 23:00:00-04:00,0.03,10,23,4,0,5056,30117,35173
2014-11-01 00:00:00-04:00,0.01,11,0,5,0,5150,29012,34162
2014-11-01 01:00:00-04:00,0,11,1,5,0,5258,28538,33796
2014-11-01 02:00:00-04:00,0,11,2,5,0,5073,27472,32545
2014-11-01 03:00:00-04:00,0,11,3,5,0,4817,26964,31781
2014-11-01 04:00:00-04:00,0.01,11,4,5,0,4432,24763,29195
2014-11-01 05:00:00-04:00,0,11,5,5,0,3992,20891,24883
2014-11-01 06:00:00-04:00,0,11,6,5,0,3327,14484,17811
2014-11-01 07:00:00-04:00,0,11,7,5,0,1905,7977,9882
2014-11-01 08:00:00-04:00,0.01,11,8,5,0,1149,7471,8620
2014-11-01 09:00:00-04:00,0.03,11,9,5,0,1097,9683,10780
2014-11-01 10:00:00-04:00,0.01,11,10,5,0,1404,13902,15306
2014-11-01 11:00:00-04:00,0.02,11,11,5,0,1757,19649,21406
2014-11-01 12:00:00-04:00,0.01,11,12,5,0,2085,24469,26554
2014-11-01 13:00:00-04:00,0.02,11,13,5,0,2314,27427,29741
2014-11-01 14:00:00-04:00,0.02,11,14,5,0,2469,29881,32350
2014-11-01 15:00:00-04:00,0,11,15,5,0,2596,29089,31685
2014-11-01 16:00:00-04:00,0,11,16,5,0,2803,27185,29988
2014-11-01 17:00:00-04:00,0.01,11,17,5,0,3055,25871,28926
2014-11-01 18:00:00-04:00,0,11,18,5,0,3302,21984,25286
2014-11-01 19:00:00-04:00,0.01,11,19,5,0,3582,25204,28786
2014-11-01 20:00:00-04:00,0.02,11,20,5,0,4015,30114,34129
2014-11-01 21:00:00-04:00,0,11,21,5,0,4401,31427,35828
2014-11-01 22:00:00-04:00,0.01,11,22,5,0,4573,29418,33991
2014-11-01 23:00:00-04:00,0,11,23,5,0,4371,27705,32076
2014-11-02 00:00:00-04:00,0,11,0,6,0,4267,29470,33737
2014-11-02 01:00:00-04:00,0,11,1,6,0,4335,28904,33239
2014-11-02 01:00:00-05:00,0,11,1,6,0,4099,26888,30987
2014-11-02 02:00:00-05:00,0,11,2,6,0,6601,41894,48495
2014-11-02 03:00:00-05:00,0,11,3,6,0,2440,14265,16705
2014-11-02 04:00:00-05:00,0,11,4,6,0,1877,10126,12003
2014-11-02 05:00:00-05:00,0,11,5,6,0,1408,6323,7731
2014-11-02 06:00:00-05:00,0,11,6,6,0,836,6361,7197
2014-11-02 07:00:00-05:00,0,11,7,6,0,712,6243,6955
2014-11-02 08:00:00-05:00,0,11,8,6,0,715,7138,7853
2014-11-02 09:00:00-05:00,0,11,9,6,0,922,9268,10190
2014-11-02 10:00:00-05:00,0,11,10,6,0,1224,13547,14771
2014-11-02 11:00:00-05:00,0,11,11,6,0,1573,17974,19547
2014-11-02 12:00:00-05:00,0,11,12,6,0,1839,20879,22718
2014-11-02 13:00:00-05:00,0,11,13,6,0,1962,22539,24501
2014-11-02 14:00:00-05:00,0,11,14,6,0,2039,22580,24619
2014-11-02 15:00:00-05:00,0,11,15,6,0,2323,21815,24138
2014-11-02 16:00:00-05:00,0,11,16,6,0,2553,20585,23138
2014-11-02 17:00:00-05:00,0,11,17,6,0,2884,19305,22189
2014-11-02 18:00:00-05:00,0,11,18,6,0,3071,21007,24078
2014-11-02 19:00:00-05:00,0,11,19,6,0,3224,24073,27297
2014-11-02 20:00:00-05:00,0,11,20,6,0,3268,25549,28817
2014-11-02 21:00:00-05:00,0,11,21,6,0,2927,23541,26468
2014-11-02 22:00:00-05:00,0,11,22,6,0,2544,21067,23611
2014-11-02 23:00:00-05:00,0,11,23,6,0,2345,19046,21391
2014-11-03 00:00:00-05:00,0,11,0,0,0,1890,13708,15598
2014-11-03 01:00:00-05:00,0,11,1,0,0,1337,8817,10154
2014-11-03 02:00:00-05:00,0,11,2,0,0,798,4681,5479
2014-11-03 03:00:00-05:00,0,11,3,0,0,528,2946,3474
2014-11-03 04:00:00-05:00,0,11,4,0,0,353,2088,2441
2014-11-03 05:00:00-05:00,0,11,5,0,0,499,2808,3307
2014-11-03 06:00:00-05:00,0,11,6,0,0,425,5040,5465
2014-11-03 07:00:00-05:00,0,11,7,0,0,810,13459,14269
2014-11-03 08:00:00-05:00,0,11,8,0,0,1707,20634,22341
2014-11-03 09:00:00-05:00,0,11,9,0,0,2299,22643,24942
2014-11-03 10:00:00-05:00,0,11,10,0,0,2128,21940,24068
2014-11-03 11:00:00-05:00,0,11,11,0,0,1863,19802,21665
2014-11-03 12:00:00-05:00,0,11,12,0,0,1759,19555,21314
2014-11-03 13:00:00-05:00,0,11,13,0,0,1646,20439,22085
2014-11-03 14:00:00-05:00,0,11,14,0,0,1733,20087,21820
2014-11-03 15:00:00-05:00,0,11,15,0,0,1942,21594,23536
2014-11-03 16:00:00-05:00,0,11,16,0,0,2099,21101,23200
2014-11-03 17:00:00-05:00,0,11,17,0,0,2414,18549,20963
2014-11-03 18:00:00-05:00,0,11,18,0,0,2616,22376,24992
2014-11-03 19:00:00-05:00,0,11,19,0,0,2869,27204,30073
2014-11-03 20:00:00-05:00,0,11,20,0,0,2662,27394,30056
2014-11-03 21:00:00-05:00,0,11,21,0,0,2255,25916,28171
2014-11-03 22:00:00-05:00,0,11,22,0,0,2045,24470,26515
2014-11-03 23:00:00-05:00,0,11,23,0,0,1824,22866,24690
2014-11-04 00:00:00-05:00,0,11,0,1,0,1571,16094,17665
2014-11-04 01:00:00-05:00,0,11,1,1,0,1131,11353,12484
2014-11-04 02:00:00-05:00,0,11,2,1,0,693,6067,6760
2014-11-04 03:00:00-05:00,0,11,3,1,0,443,3545,3988
2014-11-04 04:00:00-05:00,0,11,4,1,0,304,2482,2786
2014-11-04 05:00:00-05:00,0,11,5,1,0,396,2656,3052
2014-11-04 06:00:00-05:00,0,11,6,1,0,408,4453,4861
2014-11-04 07:00:00-05:00,0,11,7,1,0,721,12300,13021
2014-11-04 08:00:00-05:00,0,11,8,1,0,1433,20794,22227
2014-11-04 09:00:00-05:00,0,11,9,1,0,1921,23291,25212
2014-11-04 10:00:00-05:00,0,11,10,1,0,1974,22082,24056
2014-11-04 11:00:00-05:00,0,11,11,1,0,1703,20147,21850
2014-11-04 12:00:00-05:00,0,11,12,1,0,1622,20357,21979
2014-11-04 13:00:00-05:00,0,11,13,1,0,1559,21166,22725
2014-11-04 14:00:00-05:00,0,11,14,1,0,1658,20802,22460
2014-11-04 15:00:00-05:00,0,11,15,1,0,1825,22010,23835
2014-11-04 16:00:00-05:00,0,11,16,1,0,2012,21013,23025
2014-11-04 17:00:00-05:00,0,11,17,1,0,2230,16817,19047
2014-11-04 18:00:00-05:00,0,11,18,1,0,2432,20733,23165
2014-11-04 19:00:00-05:00,0,11,19,1,0,2558,26078,28636
2014-11-04 20:00:00-05:00,0,11,20,1,0,2611,27513,30124
2014-11-04 21:00:00-05:00,0,11,21,1,0,2264,27274,29538
2014-11-04 22:00:00-05:00,0,11,22,1,0,2045,27354,29399
2014-11-04 23:00:00-05:00,0,11,23,1,0,1995,25136,27131
2014-11-05 00:00:00-05:00,0,11,0,2,0,1639,19259,20898
2014-11-05 01:00:00-05:00,0,11,1,2,0,1198,12350,13548
2014-11-05 02:00:00-05:00,0,11,2,2,0,764,7276,8040
2014-11-05 03:00:00-05:00,0,11,3,2,0,476,4534,5010
2014-11-05 04:00:00-05:00,0,11,4,2,0,364,3030,3394
2014-11-05 05:00:00-05:00,0,11,5,2,0,381,2875,3256
2014-11-05 06:00:00-05:00,0,11,6,2,0,389,4580,4969
2014-11-05 07:00:00-05:00,0,11,7,2,0,755,12352,13107
2014-11-05 08:00:00-05:00,0,11,8,2,0,1600,22195,23795
2014-11-05 09:00:00-05:00,0,11,9,2,0,2327,25121,27448
2014-11-05 10:00:00-05:00,0,11,10,2,0,2150,24373,26523
2014-11-05 11:00:00-05:00,0,11,11,2,0,1901,21110,23011
2014-11-05 12:00:00-05:00,0,11,12,2,0,1822,21645,23467
2014-11-05 13:00:00-05:00,0,11,13,2,0,1775,22012,23787
2014-11-05 14:00:00-05:00,0,11,14,2,0,1816,21526,23342
2014-11-05 15:00:00-05:00,0,11,15,2,0,2060,22544,24604
2014-11-05 16:00:00-05:00,0,11,16,2,0,2209,21143,23352
2014-11-05 17:00:00-05:00,0,11,17,2,0,2447,16350,18797
2014-11-05 18:00:00-05:00,0,11,18,2,0,2859,21435,24294
2014-11-05 19:00:00-05:00,0,11,19,2,0,3191,26942,30133
2014-11-05 20:00:00-05:00,0,11,20,2,0,3232,28632,31864
2014-11-05 21:00:00-05:00,0,11,21,2,0,3053,28503,31556
2014-11-05 22:00:00-05:00,0,11,22,2,0,2618,28698,31316
2014-11-05 23:00:00-05:00,0,11,23,2,0,2356,27341,29697
2014-11-06 00:00:00-05:00,0,11,0,3,0,2015,22543,24558
2014-11-06 01:00:00-05:00,0.01,11,1,3,0,1533,14415,15948
2014-11-06 02:00:00-05:00,0,11,2,3,0,1128,8895,10023
2014-11-06 03:00:00-05:00,0.01,11,3,3,0,721,5333,6054
2014-11-06 04:00:00-05:00,0.03,11,4,3,0,521,3561,4082
2014-11-06 05:00:00-05:00,0.04,11,5,3,0,446,3378,3824
2014-11-06 06:00:00-05:00,0.04,11,6,3,0,392,5033,5425
2014-11-06 07:00:00-05:00,0.04,11,7,3,0,849,14094,14943
2014-11-06 08:00:00-05:00,0.03,11,8,3,0,1803,23907,25710
2014-11-06 09:00:00-05:00,0.01,11,9,3,0,2543,26385,28928
2014-11-06 10:00:00-05:00,0.06,11,10,3,0,2495,24929,27424
2014-11-06 11:00:00-05:00,0.03,11,11,3,0,2335,23427,25762
2014-11-06 12:00:00-05:00,0,11,12,3,0,1946,22240,24186
2014-11-06 13:00:00-05:00,0.01,11,13,3,0,1956,22106,24062
2014-11-06 14:00:00-05:00,0,11,14,3,0,1938,21484,23422
2014-11-06 15:00:00-05:00,0,11,15,3,0,2146,21873,24019
2014-11-06 16:00:00-05:00,0,11,16,3,0,2398,19886,22284
2014-11-06 17:00:00-05:00,0.01,11,17,3,0,2593,15784,18377
2014-11-06 18:00:00-05:00,0,11,18,3,0,3115,20997,24112
2014-11-06 19:00:00-05:00,0,11,19,3,0,3395,27369,30764
2014-11-06 20:00:00-05:00,0,11,20,3,0,3314,29695,33009
2014-11-06 21:00:00-05:00,0,11,21,3,0,2962,29987,32949
2014-11-06 22:00:00-05:00,0,11,22,3,0,2821,30354,33175
2014-11-06 23:00:00-05:00,0,11,23,3,0,2621,29238,31859
2014-11-07 00:00:00-05:00,0,11,0,4,0,2290,25862,28152
2014-11-07 01:00:00-05:00,0,11,1,4,0,1837,19181,21018
2014-11-07 02:00:00-05:00,0,11,2,4,0,1275,12306,13581
2014-11-07 03:00:00-05:00,0,11,3,4,0,891,7956,8847
2014-11-07 04:00:00-05:00,0,11,4,4,0,589,5705,6294
2014-11-07 05:00:00-05:00,0,11,5,4,0,558,4359,4917
2014-11-07 06:00:00-05:00,0,11,6,4,0,433,5191,5624
2014-11-07 07:00:00-05:00,0,11,7,4,0,769,12667,13436
2014-11-07 08:00:00-05:00,0,11,8,4,0,1662,21528,23190
2014-11-07 09:00:00-05:00,0,11,9,4,0,2245,23960,26205
2014-11-07 10:00:00-05:00,0,11,10,4,0,2227,22657,24884
2014-11-07 11:00:00-05:00,0,11,11,4,0,1903,21294,23197
2014-11-07 12:00:00-05:00,0,11,12,4,0,1885,21653,23538
2014-11-07 13:00:00-05:00,0,11,13,4,0,1886,22067,23953
2014-11-07 14:00:00-05:00,0,11,14,4,0,1984,22954,24938
2014-11-07 15:00:00-05:00,0,11,15,4,0,2565,23471,26036
2014-11-07 16:00:00-05:00,0,11,16,4,0,2921,20433,23354
2014-11-07 17:00:00-05:00,0,11,17,4,0,3218,16282,19500
2014-11-07 18:00:00-05:00,0,11,18,4,0,3737,20913,24650
2014-11-07 19:00:00-05:00,0,11,19,4,0,4273,27467,31740
2014-11-07 20:00:00-05:00,0,11,20,4,0,4616,30938,35554
2014-11-07 21:00:00-05:00,0,11,21,4,0,4538,31156,35694
2014-11-07 22:00:00-05:00,0,11,22,4,0,4342,30854,35196
2014-11-07 23:00:00-05:00,0,11,23,4,0,4480,31181,35661
2014-11-08 00:00:00-05:00,0,11,0,5,0,4370,30524,34894
2014-11-08 01:00:00-05:00,0,11,1,5,0,4201,28059,32260
2014-11-08 02:00:00-05:00,0,11,2,5,0,3737,24420,28157
2014-11-08 03:00:00-05:00,0,11,3,5,0,3061,20641,23702
2014-11-08 04:00:00-05:00,0,11,4,5,0,2331,15105,17436
2014-11-08 05:00:00-05:00,0,11,5,5,0,1693,9457,11150
2014-11-08 06:00:00-05:00,0,11,6,5,0,855,4722,5577
2014-11-08 07:00:00-05:00,0,11,7,5,0,718,5729,6447
2014-11-08 08:00:00-05:00,0,11,8,5,0,886,8697,9583
2014-11-08 09:00:00-05:00,0,11,9,5,0,1206,13666,14872
2014-11-08 10:00:00-05:00,0,11,10,5,0,1686,18715,20401
2014-11-08 11:00:00-05:00,0,11,11,5,0,1869,21801,23670
2014-11-08 12:00:00-05:00,0,11,12,5,0,2175,24434,26609
2014-11-08 13:00:00-05:00,0,11,13,5,0,2191,26065,28256
2014-11-08 14:00:00-05:00,0,11,14,5,0,2423,26170,28593
2014-11-08 15:00:00-05:00,0,11,15,5,0,2539,25649,28188
2014-11-08 16:00:00-05:00,0,11,16,5,0,2916,25036,27952
2014-11-08 17:00:00-05:00,0,11,17,5,0,3267,19643,22910
2014-11-08 18:00:00-05:00,0,11,18,5,0,3617,22961,26578
2014-11-08 19:00:00-05:00,0,11,19,5,0,4178,29214,33392
2014-11-08 20:00:00-05:00,0,11,20,5,0,4381,30480,34861
2014-11-08 21:00:00-05:00,0,11,21,5,0,4388,27783,32171
2014-11-08 22:00:00-05:00,0,11,22,5,0,4467,26975,31442
2014-11-08 23:00:00-05:00,0,11,23,5,0,4381,29522,33903
2014-11-09 00:00:00-05:00,0,11,0,6,0,4525,30731,35256
2014-11-09 01:00:00-05:00,0,11,1,6,0,4372,28996,33368
2014-11-09 02:00:00-05:00,0,11,2,6,0,3986,25950,29936
2014-11-09 03:00:00-05:00,0,11,3,6,0,3484,22368,25852
2014-11-09 04:00:00-05:00,0,11,4,6,0,2800,16806,19606
2014-11-09 05:00:00-05:00,0,11,5,6,0,2018,10747,12765
2014-11-09 06:00:00-05:00,0,11,6,6,0,1006,4896,5902
2014-11-09 07:00:00-05:00,0,11,7,6,0,677,4819,5496
2014-11-09 08:00:00-05:00,0,11,8,6,0,686,6430,7116
2014-11-09 09:00:00-05:00,0,11,9,6,0,894,10192,11086
2014-11-09 10:00:00-05:00,0,11,10,6,0,1296,15667,16963
2014-11-09 11:00:00-05:00,0,11,11,6,0,1596,20506,22102
2014-11-09 12:00:00-05:00,0,11,12,6,0,1842,22883,24725
2014-11-09 13:00:00-05:00,0,11,13,6,0,1971,25045,27016
2014-11-09 14:00:00-05:00,0,11,14,6,0,2266,24534,26800
2014-11-09 15:00:00-05:00,0,11,15,6,0,2400,24213,26613
2014-11-09 16:00:00-05:00,0,11,16,6,0,2583,23515,26098
2014-11-09 17:00:00-05:00,0,11,17,6,0,2839,20955,23794
2014-11-09 18:00:00-05:00,0,11,18,6,0,2741,22437,25178
2014-11-09 19:00:00-05:00,0,11,19,6,0,2964,23584,26548
2014-11-09 20:00:00-05:00,0,11,20,6,0,2810,22407,25217
2014-11-09 21:00:00-05:00,0,11,21,6,0,2544,20399,22943
2014-11-09 22:00:00-05:00,0,11,22,6,0,2255,18856,21111
2014-11-09 23:00:00-05:00,0,11,23,6,0,2092,17039,19131
2014-11-10 00:00:00-05:00,0,11,0,0,0,1717,12664,14381
2014-11-10 01:00:00-05:00,0,11,1,0,0,1248,8353,9601
2014-11-10 02:00:00-05:00,0,11,2,0,0,884,4917,5801
2014-11-10 03:00:00-05:00,0,11,3,0,0,568,3186,3754
2014-11-10 04:00:00-05:00,0,11,4,0,0,494,2250,2744
2014-11-10 05:00:00-05:00,0,11,5,0,0,506,2818,3324
2014-11-10 06:00:00-05:00,0,11,6,0,0,435,4964,5399
2014-11-10 07:00:00-05:00,0,11,7,0,0,843,12020,12863
2014-11-10 08:00:00-05:00,0,11,8,0,0,1654,19928,21582
2014-11-10 09:00:00-05:00,0,11,9,0,0,2226,22128,24354
2014-11-10 10:00:00-05:00,0,11,10,0,0,2121,21335,23456
2014-11-10 11:00:00-05:00,0,11,11,0,0,1783,19288,21071
2014-11-10 12:00:00-05:00,0,11,12,0,0,1715,19167,20882
2014-11-10 13:00:00-05:00,0,11,13,0,0,1671,19916,21587
2014-11-10 14:00:00-05:00,0,11,14,0,0,1692,19779,21471
2014-11-10 15:00:00-05:00,0,11,15,0,0,1896,21221,23117
2014-11-10 16:00:00-05:00,0,11,16,0,0,2043,21039,23082
2014-11-10 17:00:00-05:00,0,11,17,0,0,2351,18199,20550
2014-11-10 18:00:00-05:00,0,11,18,0,0,2510,22230,24740
2014-11-10 19:00:00-05:00,0,11,19,0,0,2626,26943,29569
2014-11-10 20:00:00-05:00,0,11,20,0,0,2522,27235,29757
2014-11-10 21:00:00-05:00,0,11,21,0,0,2274,25767,28041
2014-11-10 22:00:00-05:00,0,11,22,0,0,2007,24978,26985
2014-11-10 23:00:00-05:00,0,11,23,0,0,1846,22781,24627
2014-11-11 00:00:00-05:00,0,11,0,1,1,1592,16755,18347
2014-11-11 01:00:00-05:00,0,11,1,1,1,1138,10807,11945
2014-11-11 02:00:00-05:00,0,11,2,1,1,816,6639,7455
2014-11-11 03:00:00-05:00,0,11,3,1,1,523,4116,4639
2014-11-11 04:00:00-05:00,0,11,4,1,1,400,2846,3246
2014-11-11 05:00:00-05:00,0,11,5,1,1,356,2638,2994
2014-11-11 06:00:00-05:00,0,11,6,1,1,332,4042,4374
2014-11-11 07:00:00-05:00,0,11,7,1,1,635,9755,10390
2014-11-11 08:00:00-05:00,0,11,8,1,1,1168,18215,19383
2014-11-11 09:00:00-05:00,0,11,9,1,1,1760,21980,23740
2014-11-11 10:00:00-05:00,0,11,10,1,1,1858,21554,23412
2014-11-11 11:00:00-05:00,0,11,11,1,1,1636,19567,21203
2014-11-11 12:00:00-05:00,0,11,12,1,1,1486,19207,20693
2014-11-11 13:00:00-05:00,0,11,13,1,1,1504,19169,20673
2014-11-11 14:00:00-05:00,0,11,14,1,1,1560,19051,20611
2014-11-11 15:00:00-05:00,0,11,15,1,1,1697,19747,21444
2014-11-11 16:00:00-05:00,0,11,16,1,1,2005,18706,20711
2014-11-11 17:00:00-05:00,0,11,17,1,1,2083,15317,17400
2014-11-11 18:00:00-05:00,0,11,18,1,1,2316,20161,22477
2014-11-11 19:00:00-05:00,0,11,19,1,1,2505,25691,28196
2014-11-11 20:00:00-05:00,0,11,20,1,1,2545,27236,29781
2014-11-11 21:00:00-05:00,0,11,21,1,1,2249,26480,28729
2014-11-11 22:00:00-05:00,0,11,22,1,1,2002,26968,28970
2014-11-11 23:00:00-05:00,0,11,23,1,1,1892,24370,26262
2014-11-12 00:00:00-05:00,0,11,0,2,0,1624,18173,19797
2014-11-12 01:00:00-05:00,0,11,1,2,0,1229,11374,12603
2014-11-12 02:00:00-05:00,0,11,2,2,0,776,6833,7609
2014-11-12 03:00:00-05:00,0,11,3,2,0,494,4258,4752
2014-11-12 04:00:00-05:00,0,11,4,2,0,383,2850,3233
2014-11-12 05:00:00-05:00,0,11,5,2,0,343,2776,3119
2014-11-12 06:00:00-05:00,0,11,6,2,0,353,4487,4840
2014-11-12 07:00:00-05:00,0,11,7,2,0,725,12223,12948
2014-11-12 08:00:00-05:00,0,11,8,2,0,1670,22427,24097
2014-11-12 09:00:00-05:00,0,11,9,2,0,2298,24746,27044
2014-11-12 10:00:00-05:00,0,11,10,2,0,2233,22944,25177
2014-11-12 11:00:00-05:00,0,11,11,2,0,1909,21094,23003
2014-11-12 12:00:00-05:00,0,11,12,2,0,1848,21660,23508
2014-11-12 13:00:00-05:00,0,11,13,2,0,1723,20875,22598
2014-11-12 14:00:00-05:00,0,11,14,2,0,1852,20711,22563
2014-11-12 15:00:00-05:00,0,11,15,2,0,2076,22073,24149
2014-11-12 16:00:00-05:00,0,11,16,2,0,2250,20495,22745
2014-11-12 17:00:00-05:00,0,11,17,2,0,2433,16352,18785
2014-11-12 18:00:00-05:00,0,11,18,2,0,2769,21248,24017
2014-11-12 19:00:00-05:00,0,11,19,2,0,3073,27112,30185
2014-11-12 20:00:00-05:00,0,11,20,2,0,3090,29488,32578
2014-11-12 21:00:00-05:00,0,11,21,2,0,2811,29007,31818
2014-11-12 22:00:00-05:00,0,11,22,2,0,2587,29242,31829
2014-11-12 23:00:00-05:00,0,11,23,2,0,2347,27877,30224
2014-11-13 00:00:00-05:00,0,11,0,3,0,2034,22593,24627
2014-11-13 01:00:00-05:00,0,11,1,3,0,1517,14158,15675
2014-11-13 02:00:00-05:00,0,11,2,3,0,1008,8361,9369
2014-11-13 03:00:00-05:00,0,11,3,3,0,635,5314,5949
2014-11-13 04:00:00-05:00,0,11,4,3,0,425,3315,3740
2014-11-13 05:00:00-05:00,0,11,5,3,0,394,3125,3519
2014-11-13 06:00:00-05:00,0,11,6,3,0,393,4682,5075
2014-11-13 07:00:00-05:00,0,11,7,3,0,779,12463,13242
2014-11-13 08:00:00-05:00,0,11,8,3,0,1718,22243,23961
2014-11-13 09:00:00-05:00,0,11,9,3,0,2404,25055,27459
2014-11-13 10:00:00-05:00,0,11,10,3,0,2222,23269,25491
2014-11-13 11:00:00-05:00,0,11,11,3,0,1941,21423,23364
2014-11-13 12:00:00-05:00,0,11,12,3,0,1902,22335,24237
2014-11-13 13:00:00-05:00,0,11,13,3,0,1896,22379,24275
2014-11-13 14:00:00-05:00,0,11,14,3,0,1999,22273,24272
2014-11-13 15:00:00-05:00,0,11,15,3,0,2224,23352,25576
2014-11-13 16:00:00-05:00,0,11,16,3,0,2552,20957,23509
2014-11-13 17:00:00-05:00,0,11,17,3,0,2829,15785,18614
2014-11-13 18:00:00-05:00,0.01,11,18,3,0,3443,21323,24766
2014-11-13 19:00:00-05:00,0,11,19,3,0,3922,26907,30829
2014-11-13 20:00:00-05:00,0.03,11,20,3,0,4044,29671,33715
2014-11-13 21:00:00-05:00,0.06,11,21,3,0,3908,30941,34849
2014-11-13 22:00:00-05:00,0.04,11,22,3,0,3795,30723,34518
2014-11-13 23:00:00-05:00,0.03,11,23,3,0,3341,28427,31768
2014-11-14 00:00:00-05:00,0.02,11,0,4,0,2921,25596,28517
2014-11-14 01:00:00-05:00,0.01,11,1,4,0,2095,19186,21281
2014-11-14 02:00:00-05:00,0,11,2,4,0,1357,12454,13811
2014-11-14 03:00:00-05:00,0,11,3,4,0,896,7663,8559
2014-11-14 04:00:00-05:00,0,11,4,4,0,596,5237,5833
2014-11-14 05:00:00-05:00,0,11,5,4,0,535,4169,4704
2014-11-14 06:00:00-05:00,0,11,6,4,0,441,5055,5496
2014-11-14 07:00:00-05:00,0,11,7,4,0,847,12494,13341
2014-11-14 08:00:00-05:00,0,11,8,4,0,1821,22503,24324
2014-11-14 09:00:00-05:00,0,11,9,4,0,2659,25501,28160
2014-11-14 10:00:00-05:00,0,11,10,4,0,2481,23676,26157
2014-11-14 11:00:00-05:00,0,11,11,4,0,2156,22261,24417
2014-11-14 12:00:00-05:00,0,11,12,4,0,1897,22040,23937
2014-11-14 13:00:00-05:00,0,11,13,4,0,1906,22064,23970
2014-11-14 14:00:00-05:00,0,11,14,4,0,1916,21329,23245
2014-11-14 15:00:00-05:00,0,11,15,4,0,2272,22973,25245
2014-11-14 16:00:00-05:00,0,11,16,4,0,2663,20886,23549
2014-11-14 17:00:00-05:00,0,11,17,4,0,3030,16893,19923
2014-11-14 18:00:00-05:00,0,11,18,4,0,3614,22371,25985
2014-11-14 19:00:00-05:00,0,11,19,4,0,4145,29050,33195
2014-11-14 20:00:00-05:00,0,11,20,4,0,4451,31745,36196
2014-11-14 21:00:00-05:00,0,11,21,4,0,4321,30410,34731
2014-11-14 22:00:00-05:00,0,11,22,4,0,4148,30736,34884
2014-11-14 23:00:00-05:00,0,11,23,4,0,4304,30803,35107
2014-11-15 00:00:00-05:00,0,11,0,5,0,4330,29983,34313
2014-11-15 01:00:00-05:00,0,11,1,5,0,4121,27938,32059
2014-11-15 02:00:00-05:00,0,11,2,5,0,3745,24649,28394
2014-11-15 03:00:00-05:00,0,11,3,5,0,3042,20450,23492
2014-11-15 04:00:00-05:00,0,11,4,5,0,2370,15289,17659
2014-11-15 05:00:00-05:00,0,11,5,5,0,1754,9396,11150
2014-11-15 06:00:00-05:00,0,11,6,5,0,815,4635,5450
2014-11-15 07:00:00-05:00,0,11,7,5,0,689,5520,6209
2014-11-15 08:00:00-05:00,0,11,8,5,0,881,8083,8964
2014-11-15 09:00:00-05:00,0,11,9,5,0,1255,12859,14114
2014-11-15 10:00:00-05:00,0,11,10,5,0,1717,18261,19978
2014-11-15 11:00:00-05:00,0,11,11,5,0,1979,21269,23248
2014-11-15 12:00:00-05:00,0,11,12,5,0,2187,23975,26162
2014-11-15 13:00:00-05:00,0,11,13,5,0,2224,25830,28054
2014-11-15 14:00:00-05:00,0,11,14,5,0,2398,25716,28114
2014-11-15 15:00:00-05:00,0,11,15,5,0,2725,25179,27904
2014-11-15 16:00:00-05:00,0,11,16,5,0,2900,24601,27501
2014-11-15 17:00:00-05:00,0,11,17,5,0,3252,19272,22524
2014-11-15 18:00:00-05:00,0,11,18,5,0,3644,22764,26408
2014-11-15 19:00:00-05:00,0,11,19,5,0,3962,28484,32446
2014-11-15 20:00:00-05:00,0,11,20,5,0,4420,30340,34760
2014-11-15 21:00:00-05:00,0,11,21,5,0,4149,27311,31460
2014-11-15 22:00:00-05:00,0,11,22,5,0,4343,26461,30804
2014-11-15 23:00:00-05:00,0,11,23,5,0,4557,29145,33702
2014-11-16 00:00:00-05:00,0,11,0,6,0,4700,30616,35316
2014-11-16 01:00:00-05:00,0,11,1,6,0,4415,28771,33186
2014-11-16 02:00:00-05:00,0,11,2,6,0,4160,26349,30509
2014-11-16 03:00:00-05:00,0,11,3,6,0,3596,22505,26101
2014-11-16 04:00:00-05:00,0,11,4,6,0,2765,17476,20241
2014-11-16 05:00:00-05:00,0,11,5,6,0,2183,11156,13339
2014-11-16 06:00:00-05:00,0,11,6,6,0,1048,4891,5939
2014-11-16 07:00:00-05:00,0,11,7,6,0,708,4605,5313
2014-11-16 08:00:00-05:00,0,11,8,6,0,690,6009,6699
2014-11-16 09:00:00-05:00,0,11,9,6,0,816,9448,10264
2014-11-16 10:00:00-05:00,0,11,10,6,0,1242,14801,16043
2014-11-16 11:00:00-05:00,0,11,11,6,0,1690,19987,21677
2014-11-16 12:00:00-05:00,0,11,12,6,0,1994,23296,25290
2014-11-16 13:00:00-05:00,0,11,13,6,0,2231,25531,27762
2014-11-16 14:00:00-05:00,0,11,14,6,0,2424,25163,27587
2014-11-16 15:00:00-05:00,0,11,15,6,0,2518,24487,27005
2014-11-16 16:00:00-05:00,0,11,16,6,0,2712,22915,25627
2014-11-16 17:00:00-05:00,0,11,17,6,0,2911,20441,23352
2014-11-16 18:00:00-05:00,0,11,18,6,0,2815,21682,24497
2014-11-16 19:00:00-05:00,0,11,19,6,0,2824,23251,26075
2014-11-16 20:00:00-05:00,0,11,20,6,0,2859,21644,24503
2014-11-16 21:00:00-05:00,0,11,21,6,0,2641,19628,22269
2014-11-16 22:00:00-05:00,0,11,22,6,0,2410,18188,20598
2014-11-16 23:00:00-05:00,0.02,11,23,6,0,2110,16165,18275
2014-11-17 00:00:00-05:00,0.01,11,0,0,0,1879,13695,15574
2014-11-17 01:00:00-05:00,0.01,11,1,0,0,1266,8574,9840
2014-11-17 02:00:00-05:00,0.05,11,2,0,0,806,4826,5632
2014-11-17 03:00:00-05:00,0.07,11,3,0,0,583,3285,3868
2014-11-17 04:00:00-05:00,0.11,11,4,0,0,435,2430,2865
2014-11-17 05:00:00-05:00,0.15,11,5,0,0,501,2841,3342
2014-11-17 06:00:00-05:00,0.09,11,6,0,0,417,5273,5690
2014-11-17 07:00:00-05:00,0.05,11,7,0,0,860,12842,13702
2014-11-17 08:00:00-05:00,0.04,11,8,0,0,1825,20068,21893
2014-11-17 09:00:00-05:00,0.01,11,9,0,0,2739,23098,25837
2014-11-17 10:00:00-05:00,0.02,11,10,0,0,2413,22045,24458
2014-11-17 11:00:00-05:00,0.04,11,11,0,0,2118,20417,22535
2014-11-17 12:00:00-05:00,0.06,11,12,0,0,1852,19674,21526
2014-11-17 13:00:00-05:00,0.16,11,13,0,0,1915,20941,22856
2014-11-17 14:00:00-05:00,0.5,11,14,0,0,2094,21803,23897
2014-11-17 15:00:00-05:00,0.06,11,15,0,0,2644,22798,25442
2014-11-17 16:00:00-05:00,0.03,11,16,0,0,2406,19017,21423
2014-11-17 17:00:00-05:00,0.03,11,17,0,0,2558,16305,18863
2014-11-17 18:00:00-05:00,0,11,18,0,0,2840,20837,23677
2014-11-17 19:00:00-05:00,0,11,19,0,0,2911,24789,27700
2014-11-17 20:00:00-05:00,0,11,20,0,0,2652,25654,28306
2014-11-17 21:00:00-05:00,0,11,21,0,0,2282,24343,26625
2014-11-17 22:00:00-05:00,0,11,22,0,0,1938,23550,25488
2014-11-17 23:00:00-05:00,0,11,23,0,0,1792,20745,22537
2014-11-18 00:00:00-05:00,0,11,0,1,0,1351,16034,17385
2014-11-18 01:00:00-05:00,0,11,1,1,0,1035,10433,11468
2014-11-18 02:00:00-05:00,0,11,2,1,0,657,6413,7070
2014-11-18 03:00:00-05:00,0,11,3,1,0,464,3451,3915
2014-11-18 04:00:00-05:00,0,11,4,1,0,315,2367,2682
2014-11-18 05:00:00-05:00,0,11,5,1,0,342,2459,2801
2014-11-18 06:00:00-05:00,0,11,6,1,0,412,4436,4848
2014-11-18 07:00:00-05:00,0,11,7,1,0,764,12780,13544
2014-11-18 08:00:00-05:00,0,11,8,1,0,1769,22926,24695
2014-11-18 09:00:00-05:00,0,11,9,1,0,2608,26072,28680
2014-11-18 10:00:00-05:00,0,11,10,1,0,2364,24544,26908
2014-11-18 11:00:00-05:00,0,11,11,1,0,2000,22138,24138
2014-11-18 12:00:00-05:00,0,11,12,1,0,1831,21358,23189
2014-11-18 13:00:00-05:00,0,11,13,1,0,1827,22116,23943
2014-11-18 14:00:00-05:00,0,11,14,1,0,1950,21579,23529
2014-11-18 15:00:00-05:00,0,11,15,1,0,2089,23281,25370
2014-11-18 16:00:00-05:00,0,11,16,1,0,2464,21727,24191
2014-11-18 17:00:00-05:00,0,11,17,1,0,2817,17254,20071
2014-11-18 18:00:00-05:00,0,11,18,1,0,3355,22598,25953
2014-11-18 19:00:00-05:00,0,11,19,1,0,3680,28669,32349
2014-11-18 20:00:00-05:00,0,11,20,1,0,3670,29644,33314
2014-11-18 21:00:00-05:00,0,11,21,1,0,3277,30884,34161
2014-11-18 22:00:00-05:00,0,11,22,1,0,2943,30151,33094
2014-11-18 23:00:00-05:00,0,11,23,1,0,2564,27933,30497
2014-11-19 00:00:00-05:00,0,11,0,2,0,1935,21174,23109
2014-11-19 01:00:00-05:00,0,11,1,2,0,1396,12645,14041
2014-11-19 02:00:00-05:00,0,11,2,2,0,879,7018,7897
2014-11-19 03:00:00-05:00,0,11,3,2,0,536,4442,4978
2014-11-19 04:00:00-05:00,0,11,4,2,0,393,2976,3369
2014-11-19 05:00:00-05:00,0,11,5,2,0,349,2764,3113
2014-11-19 06:00:00-05:00,0,11,6,2,0,354,4658,5012
2014-11-19 07:00:00-05:00,0,11,7,2,0,772,13117,13889
2014-11-19 08:00:00-05:00,0,11,8,2,0,1795,23450,25245
2014-11-19 09:00:00-05:00,0,11,9,2,0,2677,26968,29645
2014-11-19 10:00:00-05:00,0,11,10,2,0,2549,24450,26999
2014-11-19 11:00:00-05:00,0,11,11,2,0,2133,22521,24654
2014-11-19 12:00:00-05:00,0,11,12,2,0,1933,22283,24216
2014-11-19 13:00:00-05:00,0,11,13,2,0,1839,22565,24404
2014-11-19 14:00:00-05:00,0,11,14,2,0,1865,21542,23407
2014-11-19 15:00:00-05:00,0,11,15,2,0,2146,22277,24423
2014-11-19 16:00:00-05:00,0,11,16,2,0,2399,21074,23473
2014-11-19 17:00:00-05:00,0,11,17,2,0,2752,16582,19334
2014-11-19 18:00:00-05:00,0,11,18,2,0,3211,21276,24487
2014-11-19 20:00:00-05:00,0,11,20,2,0,3673,27011,30684
2014-11-19 21:00:00-05:00,0,11,21,2,0,3572,29311,32883
2014-11-19 22:00:00-05:00,0,11,22,2,0,3218,29609,32827
2014-11-19 23:00:00-05:00,0,11,23,2,0,2863,29490,32353
2014-11-20 00:00:00-05:00,0,11,0,3,0,2657,27333,29990
2014-11-20 01:00:00-05:00,0,11,1,3,0,2232,23282,25514
2014-11-20 02:00:00-05:00,0,11,2,3,0,1610,15098,16708
2014-11-20 03:00:00-05:00,0,11,3,3,0,1017,8573,9590
2014-11-20 04:00:00-05:00,0,11,4,3,0,671,5439,6110
2014-11-20 05:00:00-05:00,0,11,5,3,0,497,3434,3931
2014-11-20 06:00:00-05:00,0,11,6,3,0,423,3008,3431
2014-11-20 07:00:00-05:00,0,11,7,3,0,424,4468,4892
2014-11-20 08:00:00-05:00,0,11,8,3,0,797,12686,13483
2014-11-20 09:00:00-05:00,0,11,9,3,0,1779,22931,24710
2014-11-20 10:00:00-05:00,0,11,10,3,0,2647,24691,27338
2014-11-20 11:00:00-05:00,0,11,11,3,0,2414,23294,25708
2014-11-20 12:00:00-05:00,0,11,12,3,0,2007,22762,24769
2014-11-20 13:00:00-05:00,0,11,13,3,0,1912,21789,23701
2014-11-20 14:00:00-05:00,0,11,14,3,0,1921,21789,23710
2014-11-20 15:00:00-05:00,0,11,15,3,0,1934,21132,23066
2014-11-20 16:00:00-05:00,0,11,16,3,0,2118,22454,24572
2014-11-20 17:00:00-05:00,0,11,17,3,0,2489,20266,22755
2014-11-20 18:00:00-05:00,0,11,18,3,0,2776,14855,17631
2014-11-20 19:00:00-05:00,0,11,19,3,0,3283,20055,23338
2014-11-20 20:00:00-05:00,0,11,20,3,0,3593,26899,30492
2014-11-20 21:00:00-05:00,0,11,21,3,0,3656,29413,33069
2014-11-20 22:00:00-05:00,0,11,22,3,0,3573,29989,33562
2014-11-20 23:00:00-05:00,0,11,23,3,0,3327,29503,32830
2014-11-21 00:00:00-05:00,0,11,0,4,0,3203,28378,31581
2014-11-21 01:00:00-05:00,0,11,1,4,0,2876,25714,28590
2014-11-21 02:00:00-05:00,0,11,2,4,0,2310,21294,23604
2014-11-21 03:00:00-05:00,0,11,3,4,0,1610,13350,14960
2014-11-21 04:00:00-05:00,0,11,4,4,0,969,8562,9531
2014-11-21 05:00:00-05:00,0,11,5,4,0,653,5601,6254
2014-11-21 06:00:00-05:00,0,11,6,4,0,531,4493,5024
2014-11-21 07:00:00-05:00,0,11,7,4,0,461,5001,5462
2014-11-21 08:00:00-05:00,0,11,8,4,0,836,12716,13552
2014-11-21 09:00:00-05:00,0,11,9,4,0,1780,22269,24049
2014-11-21 10:00:00-05:00,0,11,10,4,0,2610,26047,28657
2014-11-21 11:00:00-05:00,0,11,11,4,0,2457,24327,26784
2014-11-21 12:00:00-05:00,0,11,12,4,0,2102,22684,24786
2014-11-21 13:00:00-05:00,0,11,13,4,0,1952,22710,24662
2014-11-21 14:00:00-05:00,0,11,14,4,0,1909,22367,24276
2014-11-21 15:00:00-05:00,0,11,15,4,0,2001,21597,23598
2014-11-21 16:00:00-05:00,0,11,16,4,0,2315,22886,25201
2014-11-21 17:00:00-05:00,0,11,17,4,0,2806,20272,23078
2014-11-21 18:00:00-05:00,0,11,18,4,0,3230,16208,19438
2014-11-21 19:00:00-05:00,0,11,19,4,0,3755,21119,24874
2014-11-21 20:00:00-05:00,0,11,20,4,0,4435,27958,32393
2014-11-21 21:00:00-05:00,0,11,21,4,0,4576,31242,35818
2014-11-21 22:00:00-05:00,0,11,22,4,0,4347,30653,35000
2014-11-21 23:00:00-05:00,0,11,23,4,0,4235,30409,34644
2014-11-22 00:00:00-05:00,0,11,0,5,0,4355,30569,34924
2014-11-22 01:00:00-05:00,0,11,1,5,0,4572,31042,35614
2014-11-22 02:00:00-05:00,0,11,2,5,0,4328,28849,33177
2014-11-22 03:00:00-05:00,0,11,3,5,0,3843,24990,28833
2014-11-22 04:00:00-05:00,0,11,4,5,0,3223,20469,23692
2014-11-22 05:00:00-05:00,0,11,5,5,0,2536,15163,17699
2014-11-22 06:00:00-05:00,0,11,6,5,0,1931,9344,11275
2014-11-22 07:00:00-05:00,0,11,7,5,0,943,4623,5566
2014-11-22 08:00:00-05:00,0,11,8,5,0,754,5634,6388
2014-11-22 09:00:00-05:00,0,11,9,5,0,895,7923,8818
2014-11-22 10:00:00-05:00,0,11,10,5,0,1281,12891,14172
2014-11-22 11:00:00-05:00,0,11,11,5,0,1688,18634,20322
2014-11-22 12:00:00-05:00,0,11,12,5,0,1963,22117,24080
2014-11-22 13:00:00-05:00,0,11,13,5,0,2182,25288,27470
2014-11-22 14:00:00-05:00,0,11,14,5,0,2245,27067,29312
2014-11-22 15:00:00-05:00,0,11,15,5,0,2423,25841,28264
2014-11-22 16:00:00-05:00,0,11,16,5,0,2612,25384,27996
2014-11-22 17:00:00-05:00,0,11,17,5,0,3206,25379,28585
2014-11-22 18:00:00-05:00,0,11,18,5,0,3386,19952,23338
2014-11-22 19:00:00-05:00,0,11,19,5,0,3690,23777,27467
2014-11-22 20:00:00-05:00,0,11,20,5,0,4303,28919,33222
2014-11-22 21:00:00-05:00,0,11,21,5,0,4480,30202,34682
2014-11-22 22:00:00-05:00,0,11,22,5,0,4386,26833,31219
2014-11-22 23:00:00-05:00,0,11,23,5,0,4352,25921,30273
2014-11-23 00:00:00-05:00,0,11,0,6,0,4539,29451,33990
2014-11-23 01:00:00-05:00,0,11,1,6,0,4780,31465,36245
2014-11-23 02:00:00-05:00,0,11,2,6,0,4482,29407,33889
2014-11-23 03:00:00-05:00,0,11,3,6,0,4230,26671,30901
2014-11-23 04:00:00-05:00,0,11,4,6,0,3679,22743,26422
2014-11-23 05:00:00-05:00,0,11,5,6,0,2926,17319,20245
2014-11-23 06:00:00-05:00,0,11,6,6,0,2223,10837,13060
2014-11-23 07:00:00-05:00,0,11,7,6,0,1023,4781,5804
2014-11-23 08:00:00-05:00,0,11,8,6,0,672,4737,5409
2014-11-23 09:00:00-05:00,0,11,9,6,0,710,6363,7073
2014-11-23 10:00:00-05:00,0,11,10,6,0,861,9227,10088
2014-11-23 11:00:00-05:00,0,11,11,6,0,1217,14031,15248
2014-11-23 12:00:00-05:00,0,11,12,6,0,1563,18769,20332
2014-11-23 13:00:00-05:00,0,11,13,6,0,1780,21742,23522
2014-11-23 14:00:00-05:00,0,11,14,6,0,2017,23729,25746
2014-11-23 15:00:00-05:00,0,11,15,6,0,2260,23327,25587
2014-11-23 16:00:00-05:00,0,11,16,6,0,2359,23016,25375
2014-11-23 17:00:00-05:00,0,11,17,6,0,2580,22062,24642
2014-11-23 18:00:00-05:00,0,11,18,6,0,2897,20310,23207
2014-11-23 19:00:00-05:00,0,11,19,6,0,2969,21684,24653
2014-11-23 20:00:00-05:00,0,11,20,6,0,2963,23075,26038
2014-11-23 21:00:00-05:00,0,11,21,6,0,2706,20391,23097
2014-11-23 22:00:00-05:00,0,11,22,6,0,2574,17866,20440
2014-11-23 23:00:00-05:00,0,11,23,6,0,2303,17198,19501
2014-11-24 00:00:00-05:00,0,11,0,0,0,2050,14923,16973
2014-11-24 01:00:00-05:00,0.02,11,1,0,0,1699,11781,13480
2014-11-24 02:00:00-05:00,0.12,11,2,0,0,1399,9061,10460
2014-11-24 03:00:00-05:00,0.21,11,3,0,0,963,5722,6685
2014-11-24 04:00:00-05:00,0.19,11,4,0,0,670,3731,4401
2014-11-24 05:00:00-05:00,0.02,11,5,0,0,517,2408,2925
2014-11-24 06:00:00-05:00,0.05,11,6,0,0,548,2595,3143
2014-11-24 07:00:00-05:00,0,11,7,0,0,443,4567,5010
2014-11-24 08:00:00-05:00,0,11,8,0,0,818,12364,13182
2014-11-24 09:00:00-05:00,0,11,9,0,0,1703,20040,21743
2014-11-24 10:00:00-05:00,0,11,10,0,0,2462,22588,25050
2014-11-24 11:00:00-05:00,0,11,11,0,0,2319,21371,23690
2014-11-24 12:00:00-05:00,0,11,12,0,0,1913,19325,21238
2014-11-24 13:00:00-05:00,0,11,13,0,0,1945,20324,22269
2014-11-24 14:00:00-05:00,0,11,14,0,0,1760,19852,21612
2014-11-24 15:00:00-05:00,0,11,15,0,0,1765,19959,21724
2014-11-24 16:00:00-05:00,0,11,16,0,0,2018,20903,22921
2014-11-24 17:00:00-05:00,0,11,17,0,0,2125,20422,22547
2014-11-24 18:00:00-05:00,0,11,18,0,0,2323,16973,19296
2014-11-24 19:00:00-05:00,0,11,19,0,0,2589,21101,23690
2014-11-24 20:00:00-05:00,0,11,20,0,0,2797,25191,27988
2014-11-24 21:00:00-05:00,0,11,21,0,0,2633,26089,28722
2014-11-24 22:00:00-05:00,0,11,22,0,0,2362,23929,26291
2014-11-24 23:00:00-05:00,0,11,23,0,0,2028,23241,25269
2014-11-25 00:00:00-05:00,0,11,0,1,0,1853,21356,23209
2014-11-25 01:00:00-05:00,0,11,1,1,0,1486,15521,17007
2014-11-25 02:00:00-05:00,0,11,2,1,0,1185,10537,11722
2014-11-25 03:00:00-05:00,0,11,3,1,0,825,6499,7324
2014-11-25 04:00:00-05:00,0,11,4,1,0,467,4085,4552
2014-11-25 05:00:00-05:00,0,11,5,1,0,377,2758,3135
2014-11-25 06:00:00-05:00,0,11,6,1,0,399,2953,3352
2014-11-25 07:00:00-05:00,0,11,7,1,0,435,4484,4919
2014-11-25 08:00:00-05:00,0,11,8,1,0,776,11493,12269
2014-11-25 09:00:00-05:00,0,11,9,1,0,1696,20675,22371
2014-11-25 10:00:00-05:00,0,11,10,1,0,2422,23739,26161
2014-11-25 11:00:00-05:00,0,11,11,1,0,2221,22727,24948
2014-11-25 12:00:00-05:00,0,11,12,1,0,1923,21021,22944
2014-11-25 13:00:00-05:00,0,11,13,1,0,1915,20945,22860
2014-11-25 14:00:00-05:00,0,11,14,1,0,1838,21802,23640
2014-11-25 15:00:00-05:00,0,11,15,1,0,2010,21690,23700
2014-11-25 16:00:00-05:00,0,11,16,1,0,2183,22414,24597
2014-11-25 17:00:00-05:00,0,11,17,1,0,2444,20388,22832
2014-11-25 18:00:00-05:00,0,11,18,1,0,2612,15070,17682
2014-11-25 19:00:00-05:00,0,11,19,1,0,2880,18752,21632
2014-11-25 20:00:00-05:00,0,11,20,1,0,3187,23492,26679
2014-11-25 21:00:00-05:00,0,11,21,1,0,3115,24864,27979
2014-11-25 22:00:00-05:00,0,11,22,1,0,2805,24110,26915
2014-11-25 23:00:00-05:00,0,11,23,1,0,2570,23283,25853
2014-11-26 00:00:00-05:00,0,11,0,2,0,2263,21592,23855
2014-11-26 01:00:00-05:00,0,11,1,2,0,1925,19870,21795
2014-11-26 02:00:00-05:00,0,11,2,2,0,1581,14585,16166
2014-11-26 03:00:00-05:00,0,11,3,2,0,1057,9143,10200
2014-11-26 04:00:00-05:00,0,11,4,2,0,693,5798,6491
2014-11-26 05:00:00-05:00,0,11,5,2,0,538,4168,4706
2014-11-26 06:00:00-05:00,0,11,6,2,0,516,4410,4926
2014-11-26 07:00:00-05:00,0.06,11,7,2,0,489,5413,5902
2014-11-26 08:00:00-05:00,0.07,11,8,2,0,808,11664,12472
2014-11-26 09:00:00-05:00,0.12,11,9,2,0,1770,19733,21503
2014-11-26 10:00:00-05:00,0.12,11,10,2,0,2906,23875,26781
2014-11-26 11:00:00-05:00,0.1,11,11,2,0,3005,23226,26231
2014-11-26 12:00:00-05:00,0.13,11,12,2,0,2730,22377,25107
2014-11-26 13:00:00-05:00,0.12,11,13,2,0,2577,22957,25534
2014-11-26 14:00:00-05:00,0.1,11,14,2,0,2670,23484,26154
2014-11-26 15:00:00-05:00,0.06,11,15,2,0,2897,23555,26452
2014-11-26 16:00:00-05:00,0.05,11,16,2,0,3085,22948,26033
2014-11-26 17:00:00-05:00,0.04,11,17,2,0,3413,21199,24612
2014-11-26 18:00:00-05:00,0.03,11,18,2,0,3570,17241,20811
2014-11-26 19:00:00-05:00,0.01,11,19,2,0,3683,21866,25549
2014-11-26 20:00:00-05:00,0.03,11,20,2,0,3804,24698,28502
2014-11-26 21:00:00-05:00,0.02,11,21,2,0,3694,24935,28629
2014-11-26 22:00:00-05:00,0.01,11,22,2,0,3182,21211,24393
2014-11-26 23:00:00-05:00,0,11,23,2,0,2651,20713,23364
2014-11-27 00:00:00-05:00,0,11,0,3,1,2456,19320,21776
2014-11-27 01:00:00-05:00,0,11,1,3,1,2178,16930,19108
2014-11-27 02:00:00-05:00,0,11,2,3,1,1754,14229,15983
2014-11-27 03:00:00-05:00,0,11,3,3,1,1448,11113,12561
2014-11-27 04:00:00-05:00,0,11,4,3,1,1067,9014,10081
2014-11-27 05:00:00-05:00,0,11,5,3,1,896,6822,7718
2014-11-27 06:00:00-05:00,0,11,6,3,1,843,5477,6320
2014-11-27 07:00:00-05:00,0,11,7,3,1,640,4376,5016
2014-11-27 08:00:00-05:00,0,11,8,3,1,694,6113,6807
2014-11-27 09:00:00-05:00,0,11,9,3,1,805,7359,8164
2014-11-27 10:00:00-05:00,0,11,10,3,1,958,8654,9612
2014-11-27 11:00:00-05:00,0.01,11,11,3,1,1128,10083,11211
2014-11-27 12:00:00-05:00,0,11,12,3,1,1359,12179,13538
2014-11-27 13:00:00-05:00,0,11,13,3,1,1650,14801,16451
2014-11-27 14:00:00-05:00,0,11,14,3,1,1957,15535,17492
2014-11-27 15:00:00-05:00,0,11,15,3,1,2282,15560,17842
2014-11-27 16:00:00-05:00,0,11,16,3,1,2506,16281,18787
2014-11-27 17:00:00-05:00,0,11,17,3,1,3070,16602,19672
2014-11-27 18:00:00-05:00,0,11,18,3,1,3373,14947,18320
2014-11-27 19:00:00-05:00,0,11,19,3,1,3460,14679,18139
2014-11-27 20:00:00-05:00,0,11,20,3,1,3524,14362,17886
2014-11-27 21:00:00-05:00,0,11,21,3,1,3547,15250,18797
2014-11-27 22:00:00-05:00,0,11,22,3,1,3747,15677,19424
2014-11-27 23:00:00-05:00,0,11,23,3,1,3750,16942,20692
2014-11-28 00:00:00-05:00,0,11,0,4,0,3718,16506,20224
2014-11-28 01:00:00-05:00,0,11,1,4,0,3669,13748,17417
2014-11-28 02:00:00-05:00,0,11,2,4,0,3150,9915,13065
2014-11-28 03:00:00-05:00,0,11,3,4,0,2290,7017,9307
2014-11-28 04:00:00-05:00,0,11,4,4,0,1560,4821,6381
2014-11-28 05:00:00-05:00,0,11,5,4,0,1060,3423,4483
2014-11-28 06:00:00-05:00,0,11,6,4,0,873,2939,3812
2014-11-28 07:00:00-05:00,0,11,7,4,0,542,2594,3136
2014-11-28 08:00:00-05:00,0,11,8,4,0,564,4668,5232
2014-11-28 09:00:00-05:00,0,11,9,4,0,751,7024,7775
2014-11-28 10:00:00-05:00,0,11,10,4,0,1040,9706,10746
2014-11-28 11:00:00-05:00,0,11,11,4,0,1262,12163,13425
2014-11-28 12:00:00-05:00,0,11,12,4,0,1397,14323,15720
2014-11-28 13:00:00-05:00,0,11,13,4,0,1534,16773,18307
2014-11-28 14:00:00-05:00,0,11,14,4,0,1581,18685,20266
2014-11-28 15:00:00-05:00,0,11,15,4,0,1719,20354,22073
2014-11-28 16:00:00-05:00,0,11,16,4,0,1947,20502,22449
2014-11-28 17:00:00-05:00,0,11,17,4,0,2481,21161,23642
2014-11-28 18:00:00-05:00,0,11,18,4,0,2719,19188,21907
2014-11-28 19:00:00-05:00,0,11,19,4,0,2914,21856,24770
2014-11-28 20:00:00-05:00,0,11,20,4,0,3095,23270,26365
2014-11-28 21:00:00-05:00,0,11,21,4,0,3131,23994,27125
2014-11-28 22:00:00-05:00,0,11,22,4,0,2917,20608,23525
2014-11-28 23:00:00-05:00,0,11,23,4,0,2888,20477,23365
2014-11-29 00:00:00-05:00,0,11,0,5,0,2972,21765,24737
2014-11-29 01:00:00-05:00,0,11,1,5,0,2883,20485,23368
2014-11-29 02:00:00-05:00,0,11,2,5,0,2587,17132,19719
2014-11-29 03:00:00-05:00,0,11,3,5,0,2276,14201,16477
2014-11-29 04:00:00-05:00,0,11,4,5,0,1857,11698,13555
2014-11-29 05:00:00-05:00,0,11,5,5,0,1568,9438,11006
2014-11-29 06:00:00-05:00,0,11,6,5,0,1211,6554,7765
2014-11-29 07:00:00-05:00,0,11,7,5,0,629,3216,3845
2014-11-29 08:00:00-05:00,0,11,8,5,0,551,3476,4027
2014-11-29 09:00:00-05:00,0,11,9,5,0,625,4954,5579
2014-11-29 10:00:00-05:00,0,11,10,5,0,850,7621,8471
2014-11-29 11:00:00-05:00,0,11,11,5,0,1168,11766,12934
2014-11-29 12:00:00-05:00,0,11,12,5,0,1346,15932,17278
2014-11-29 13:00:00-05:00,0,11,13,5,0,1609,18701,20310
2014-11-29 14:00:00-05:00,0,11,14,5,0,1888,20997,22885
2014-11-29 15:00:00-05:00,0,11,15,5,0,2117,22075,24192
2014-11-29 16:00:00-05:00,0,11,16,5,0,2275,21913,24188
2014-11-29 17:00:00-05:00,0,11,17,5,0,2521,22614,25135
2014-11-29 18:00:00-05:00,0,11,18,5,0,2721,19715,22436
2014-11-29 19:00:00-05:00,0,11,19,5,0,2922,22016,24938
2014-11-29 20:00:00-05:00,0,11,20,5,0,3066,24648,27714
2014-11-29 21:00:00-05:00,0,11,21,5,0,3269,26221,29490
2014-11-29 22:00:00-05:00,0,11,22,5,0,3138,22177,25315
2014-11-29 23:00:00-05:00,0,11,23,5,0,3105,21516,24621
2014-11-30 00:00:00-05:00,0,11,0,6,0,3253,23235,26488
2014-11-30 01:00:00-05:00,0,11,1,6,0,3312,23562,26874
2014-11-30 02:00:00-05:00,0,11,2,6,0,3351,21742,25093
2014-11-30 03:00:00-05:00,0,11,3,6,0,3022,18769,21791
2014-11-30 04:00:00-05:00,0,11,4,6,0,2587,15875,18462
2014-11-30 05:00:00-05:00,0,11,5,6,0,2290,11997,14287
2014-11-30 06:00:00-05:00,0,11,6,6,0,1763,8412,10175
2014-11-30 07:00:00-05:00,0,11,7,6,0,932,4238,5170
2014-11-30 08:00:00-05:00,0,11,8,6,0,599,4413,5012
2014-11-30 09:00:00-05:00,0,11,9,6,0,517,5539,6056
2014-11-30 10:00:00-05:00,0,11,10,6,0,704,8074,8778
2014-11-30 11:00:00-05:00,0,11,11,6,0,1032,11967,12999
2014-11-30 12:00:00-05:00,0,11,12,6,0,1386,16083,17469
2014-11-30 13:00:00-05:00,0,11,13,6,0,1612,18401,20013
2014-11-30 14:00:00-05:00,0,11,14,6,0,1797,20652,22449
2014-11-30 15:00:00-05:00,0,11,15,6,0,2036,20953,22989
2014-11-30 16:00:00-05:00,0,11,16,6,0,2466,21844,24310
2014-11-30 17:00:00-05:00,0,11,17,6,0,2502,20759,23261
2014-11-30 18:00:00-05:00,0,11,18,6,0,2437,19074,21511
2014-11-30 19:00:00-05:00,0,11,19,6,0,2583,19948,22531
2014-11-30 20:00:00-05:00,0,11,20,6,0,2490,20837,23327
2014-11-30 21:00:00-05:00,0,11,21,6,0,2480,19985,22465
2014-11-30 22:00:00-05:00,0,11,22,6,0,2207,18010,20217
2014-11-30 23:00:00-05:00,0,11,23,6,0,1911,16264,18175
2014-12-01 00:00:00-05:00,0,12,0,0,0,1809,15029,16838
2014-12-01 01:00:00-05:00,0,12,1,0,0,1438,11312,12750
2014-12-01 02:00:00-05:00,0,12,2,0,0,1085,7959,9044
2014-12-01 03:00:00-05:00,0,12,3,0,0,692,4375,5067
2014-12-01 04:00:00-05:00,0,12,4,0,0,526,2996,3522
2014-12-01 05:00:00-05:00,0,12,5,0,0,398,2063,2461
2014-12-01 06:00:00-05:00,0,12,6,0,0,467,2493,2960
2014-12-01 07:00:00-05:00,0,12,7,0,0,421,4811,5232
2014-12-01 08:00:00-05:00,0,12,8,0,0,799,12144,12943
2014-12-01 09:00:00-05:00,0,12,9,0,0,1656,19928,21584
2014-12-01 10:00:00-05:00,0,12,10,0,0,2503,23077,25580
2014-12-01 11:00:00-05:00,0,12,11,0,0,2303,21535,23838
2014-12-01 12:00:00-05:00,0,12,12,0,0,1938,18955,20893
2014-12-01 13:00:00-05:00,0,12,13,0,0,1771,18601,20372
2014-12-01 14:00:00-05:00,0,12,14,0,0,1694,19443,21137
2014-12-01 15:00:00-05:00,0,12,15,0,0,1888,19442,21330
2014-12-01 16:00:00-05:00,0,12,16,0,0,2011,20787,22798
2014-12-01 17:00:00-05:00,0,12,17,0,0,2345,20707,23052
2014-12-01 18:00:00-05:00,0.04,12,18,0,0,2705,17401,20106
2014-12-01 19:00:00-05:00,0,12,19,0,0,3273,22243,25516
2014-12-01 20:00:00-05:00,0.01,12,20,0,0,3885,26436,30321
2014-12-01 21:00:00-05:00,0,12,21,0,0,3344,26153,29497
2014-12-01 22:00:00-05:00,0,12,22,0,0,3069,26301,29370
2014-12-01 23:00:00-05:00,0,12,23,0,0,2324,23751,26075
2014-12-02 00:00:00-05:00,0,12,0,1,0,1981,21581,23562
2014-12-02 01:00:00-05:00,0,12,1,1,0,1643,15862,17505
2014-12-02 02:00:00-05:00,0,12,2,1,0,1137,10341,11478
2014-12-02 03:00:00-05:00,0,12,3,1,0,792,5553,6345
2014-12-02 04:00:00-05:00,0,12,4,1,0,496,3485,3981
2014-12-02 05:00:00-05:00,0,12,5,1,0,335,2202,2537
2014-12-02 06:00:00-05:00,0,12,6,1,0,379,2555,2934
2014-12-02 07:00:00-05:00,0,12,7,1,0,362,4490,4852
2014-12-02 08:00:00-05:00,0,12,8,1,0,771,12147,12918
2014-12-02 09:00:00-05:00,0,12,9,1,0,1733,22034,23767
2014-12-02 10:00:00-05:00,0,12,10,1,0,2597,26156,28753
2014-12-02 11:00:00-05:00,0,12,11,1,0,2451,24032,26483
2014-12-02 12:00:00-05:00,0,12,12,1,0,2105,21423,23528
2014-12-02 13:00:00-05:00,0.02,12,13,1,0,1896,20912,22808
2014-12-02 14:00:00-05:00,0.01,12,14,1,0,1989,22582,24571
2014-12-02 15:00:00-05:00,0,12,15,1,0,2157,23368,25525
2014-12-02 16:00:00-05:00,0,12,16,1,0,2219,22628,24847
2014-12-02 17:00:00-05:00,0,12,17,1,0,2395,21014,23409
2014-12-02 18:00:00-05:00,0,12,18,1,0,2605,16296,18901
2014-12-02 19:00:00-05:00,0,12,19,1,0,2891,21292,24183
2014-12-02 20:00:00-05:00,0,12,20,1,0,3143,26650,29793
2014-12-02 21:00:00-05:00,0.01,12,21,1,0,3104,28373,31477
2014-12-02 22:00:00-05:00,0.05,12,22,1,0,2799,28304,31103
2014-12-02 23:00:00-05:00,0.02,12,23,1,0,2509,28247,30756
2014-12-03 00:00:00-05:00,0,12,0,2,0,2384,26343,28727
2014-12-03 01:00:00-05:00,0,12,1,2,0,1913,20193,22106
2014-12-03 02:00:00-05:00,0.01,12,2,2,0,1345,13003,14348
2014-12-03 03:00:00-05:00,0,12,3,2,0,843,7123,7966
2014-12-03 04:00:00-05:00,0,12,4,2,0,526,4403,4929
2014-12-03 05:00:00-05:00,0,12,5,2,0,357,2996,3353
2014-12-03 06:00:00-05:00,0,12,6,2,0,363,2762,3125
2014-12-03 07:00:00-05:00,0,12,7,2,0,404,4303,4707
2014-12-03 08:00:00-05:00,0,12,8,2,0,766,12124,12890
2014-12-03 09:00:00-05:00,0,12,9,2,0,1730,22304,24034
2014-12-03 10:00:00-05:00,0,12,10,2,0,2632,25837,28469
2014-12-03 11:00:00-05:00,0,12,11,2,0,2483,24364,26847
2014-12-03 12:00:00-05:00,0,12,12,2,0,2176,22007,24183
2014-12-03 13:00:00-05:00,0.04,12,13,2,0,2013,21195,23208
2014-12-03 14:00:00-05:00,0.05,12,14,2,0,2062,23234,25296
2014-12-03 15:00:00-05:00,0,12,15,2,0,2215,22518,24733
2014-12-03 16:00:00-05:00,0,12,16,2,0,2382,22403,24785
2014-12-03 17:00:00-05:00,0,12,17,2,0,2402,19116,21518
2014-12-03 18:00:00-05:00,0,12,18,2,0,2635,15048,17683
2014-12-03 19:00:00-05:00,0,12,19,2,0,2996,19982,22978
2014-12-03 20:00:00-05:00,0,12,20,2,0,3364,25460,28824
2014-12-03 21:00:00-05:00,0,12,21,2,0,3321,26370,29691
2014-12-03 22:00:00-05:00,0,12,22,2,0,2926,26787,29713
2014-12-03 23:00:00-05:00,0,12,23,2,0,2730,26474,29204
2014-12-04 00:00:00-05:00,0,12,0,3,0,2561,25762,28323
2014-12-04 01:00:00-05:00,0,12,1,3,0,2208,22857,25065
2014-12-04 02:00:00-05:00,0,12,2,3,0,1616,15717,17333
2014-12-04 03:00:00-05:00,0,12,3,3,0,1068,9405,10473
2014-12-04 04:00:00-05:00,0,12,4,3,0,750,5576,6326
2014-12-04 05:00:00-05:00,0,12,5,3,0,549,3541,4090
2014-12-04 06:00:00-05:00,0,12,6,3,0,488,3273,3761
2014-12-04 07:00:00-05:00,0,12,7,3,0,457,4603,5060
2014-12-04 08:00:00-05:00,0,12,8,3,0,762,12338,13100
2014-12-04 09:00:00-05:00,0,12,9,3,0,1772,22601,24373
2014-12-04 10:00:00-05:00,0,12,10,3,0,2578,25652,28230
2014-12-04 11:00:00-05:00,0,12,11,3,0,2333,24148,26481
2014-12-04 12:00:00-05:00,0,12,12,3,0,2077,22507,24584
2014-12-04 13:00:00-05:00,0,12,13,3,0,1857,21836,23693
2014-12-04 14:00:00-05:00,0,12,14,3,0,1883,22019,23902
2014-12-04 15:00:00-05:00,0,12,15,3,0,1963,21327,23290
2014-12-04 16:00:00-05:00,0,12,16,3,0,2187,22789,24976
2014-12-04 17:00:00-05:00,0,12,17,3,0,2571,21310,23881
2014-12-04 18:00:00-05:00,0,12,18,3,0,2812,16177,18989
2014-12-04 19:00:00-05:00,0,12,19,3,0,3316,20936,24252
2014-12-04 20:00:00-05:00,0,12,20,3,0,3577,26790,30367
2014-12-04 21:00:00-05:00,0,12,21,3,0,3591,28029,31620
2014-12-04 22:00:00-05:00,0,12,22,3,0,3461,27462,30923
2014-12-04 23:00:00-05:00,0,12,23,3,0,3077,27824,30901
2014-12-05 00:00:00-05:00,0,12,0,4,0,3051,26978,30029
2014-12-05 01:00:00-05:00,0,12,1,4,0,2884,25778,28662
2014-12-05 02:00:00-05:00,0,12,2,4,0,2126,21003,23129
2014-12-05 03:00:00-05:00,0,12,3,4,0,1545,13920,15465
2014-12-05 04:00:00-05:00,0,12,4,4,0,1054,9005,10059
2014-12-05 05:00:00-05:00,0,12,5,4,0,753,6058,6811
2014-12-05 06:00:00-05:00,0,12,6,4,0,554,4575,5129
2014-12-05 07:00:00-05:00,0,12,7,4,0,468,5175,5643
2014-12-05 08:00:00-05:00,0,12,8,4,0,759,12153,12912
2014-12-05 09:00:00-05:00,0,12,9,4,0,1735,22362,24097
2014-12-05 10:00:00-05:00,0,12,10,4,0,2500,25777,28277
2014-12-05 11:00:00-05:00,0,12,11,4,0,2486,24203,26689
2014-12-05 12:00:00-05:00,0,12,12,4,0,2197,22222,24419
2014-12-05 13:00:00-05:00,0,12,13,4,0,2106,22211,24317
2014-12-05 14:00:00-05:00,0,12,14,4,0,2066,22072,24138
2014-12-05 15:00:00-05:00,0,12,15,4,0,2084,22128,24212
2014-12-05 16:00:00-05:00,0,12,16,4,0,2484,23561,26045
2014-12-05 17:00:00-05:00,0,12,17,4,0,2880,20743,23623
2014-12-05 18:00:00-05:00,0.03,12,18,4,0,3148,16653,19801
2014-12-05 19:00:00-05:00,0.07,12,19,4,0,3935,22371,26306
2014-12-05 20:00:00-05:00,0.1,12,20,4,0,4810,29332,34142
2014-12-05 21:00:00-05:00,0.06,12,21,4,0,5318,31367,36685
2014-12-05 22:00:00-05:00,0.14,12,22,4,0,5192,30288,35480
2014-12-05 23:00:00-05:00,0.11,12,23,4,0,4814,30716,35530
2014-12-06 00:00:00-05:00,0.04,12,0,5,0,4848,29975,34823
2014-12-06 01:00:00-05:00,0.01,12,1,5,0,4727,28164,32891
2014-12-06 02:00:00-05:00,0.03,12,2,5,0,4060,25964,30024
2014-12-06 03:00:00-05:00,0.04,12,3,5,0,3395,23260,26655
2014-12-06 04:00:00-05:00,0.04,12,4,5,0,3061,19435,22496
2014-12-06 05:00:00-05:00,0.03,12,5,5,0,2300,13629,15929
2014-12-06 06:00:00-05:00,0,12,6,5,0,1667,8607,10274
2014-12-06 07:00:00-05:00,0.01,12,7,5,0,831,4183,5014
2014-12-06 08:00:00-05:00,0,12,8,5,0,664,5095,5759
2014-12-06 09:00:00-05:00,0,12,9,5,0,952,8382,9334
2014-12-06 10:00:00-05:00,0,12,10,5,0,1214,12615,13829
2014-12-06 11:00:00-05:00,0.07,12,11,5,0,1603,17514,19117
2014-12-06 12:00:00-05:00,0.14,12,12,5,0,1900,21360,23260
2014-12-06 13:00:00-05:00,0.04,12,13,5,0,2394,28019,30413
2014-12-06 14:00:00-05:00,0.09,12,14,5,0,2532,28372,30904
2014-12-06 15:00:00-05:00,0.16,12,15,5,0,2662,27265,29927
2014-12-06 16:00:00-05:00,0.1,12,16,5,0,3121,27349,30470
2014-12-06 17:00:00-05:00,0.08,12,17,5,0,3552,25503,29055
2014-12-06 18:00:00-05:00,0.05,12,18,5,0,3656,19180,22836
2014-12-06 19:00:00-05:00,0.1,12,19,5,0,3961,22585,26546
2014-12-06 20:00:00-05:00,0.08,12,20,5,0,4412,27404,31816
2014-12-06 21:00:00-05:00,0.02,12,21,5,0,5011,28636,33647
2014-12-06 22:00:00-05:00,0.07,12,22,5,0,4854,27850,32704
2014-12-06 23:00:00-05:00,0.09,12,23,5,0,4612,26930,31542
2014-12-07 00:00:00-05:00,0.03,12,0,6,0,4932,29047,33979
2014-12-07 01:00:00-05:00,0.01,12,1,6,0,5157,30715,35872
2014-12-07 02:00:00-05:00,0,12,2,6,0,4807,29338,34145
2014-12-07 03:00:00-05:00,0,12,3,6,0,4111,26523,30634
2014-12-07 04:00:00-05:00,0,12,4,6,0,3362,22577,25939
2014-12-07 05:00:00-05:00,0,12,5,6,0,2860,17095,19955
2014-12-07 06:00:00-05:00,0,12,6,6,0,2010,10355,12365
2014-12-07 07:00:00-05:00,0,12,7,6,0,972,4380,5352
2014-12-07 08:00:00-05:00,0,12,8,6,0,693,4464,5157
2014-12-07 09:00:00-05:00,0,12,9,6,0,730,6020,6750
2014-12-07 10:00:00-05:00,0,12,10,6,0,878,9633,10511
2014-12-07 11:00:00-05:00,0,12,11,6,0,1322,15575,16897
2014-12-07 12:00:00-05:00,0,12,12,6,0,1729,21304,23033
2014-12-07 13:00:00-05:00,0,12,13,6,0,2009,25249,27258
2014-12-07 14:00:00-05:00,0,12,14,6,0,2316,26748,29064
2014-12-07 15:00:00-05:00,0,12,15,6,0,2534,25834,28368
2014-12-07 16:00:00-05:00,0,12,16,6,0,2567,25555,28122
2014-12-07 17:00:00-05:00,0,12,17,6,0,2819,24228,27047
2014-12-07 18:00:00-05:00,0,12,18,6,0,3171,20816,23987
2014-12-07 19:00:00-05:00,0,12,19,6,0,3348,22327,25675
2014-12-07 20:00:00-05:00,0,12,20,6,0,3411,24837,28248
2014-12-07 21:00:00-05:00,0,12,21,6,0,3381,24209,27590
2014-12-07 22:00:00-05:00,0,12,22,6,0,3022,21091,24113
2014-12-07 23:00:00-05:00,0,12,23,6,0,2800,20290,23090
2014-12-08 00:00:00-05:00,0,12,0,0,0,2400,18638,21038
2014-12-08 01:00:00-05:00,0,12,1,0,0,2111,13886,15997
2014-12-08 02:00:00-05:00,0,12,2,0,0,1464,8833,10297
2014-12-08 03:00:00-05:00,0,12,3,0,0,950,5151,6101
2014-12-08 04:00:00-05:00,0,12,4,0,0,667,3367,4034
2014-12-08 05:00:00-05:00,0,12,5,0,0,479,2327,2806
2014-12-08 06:00:00-05:00,0,12,6,0,0,532,2762,3294
2014-12-08 07:00:00-05:00,0,12,7,0,0,482,4879,5361
2014-12-08 08:00:00-05:00,0,12,8,0,0,808,12356,13164
2014-12-08 09:00:00-05:00,0,12,9,0,0,1721,20804,22525
2014-12-08 10:00:00-05:00,0,12,10,0,0,2665,24290,26955
2014-12-08 11:00:00-05:00,0,12,11,0,0,2479,23662,26141
2014-12-08 12:00:00-05:00,0,12,12,0,0,2245,21580,23825
2014-12-08 13:00:00-05:00,0,12,13,0,0,2004,21153,23157
2014-12-08 14:00:00-05:00,0,12,14,0,0,1993,21770,23763
2014-12-08 15:00:00-05:00,0,12,15,0,0,1968,21790,23758
2014-12-08 16:00:00-05:00,0,12,16,0,0,2225,22407,24632
2014-12-08 17:00:00-05:00,0,12,17,0,0,2530,21243,23773
2014-12-08 18:00:00-05:00,0,12,18,0,0,2667,17676,20343
2014-12-08 19:00:00-05:00,0,12,19,0,0,2977,22009,24986
2014-12-08 20:00:00-05:00,0,12,20,0,0,3147,27015,30162
2014-12-08 21:00:00-05:00,0,12,21,0,0,3061,28202,31263
2014-12-08 22:00:00-05:00,0,12,22,0,0,2738,27063,29801
2014-12-08 23:00:00-05:00,0,12,23,0,0,2543,27118,29661
2014-12-09 00:00:00-05:00,0,12,0,1,0,2082,24848,26930
2014-12-09 01:00:00-05:00,0,12,1,1,0,1745,18737,20482
2014-12-09 02:00:00-05:00,0,12,2,1,0,1386,12233,13619
2014-12-09 03:00:00-05:00,0.04,12,3,1,0,861,7434,8295
2014-12-09 04:00:00-05:00,0.05,12,4,1,0,540,4239,4779
2014-12-09 05:00:00-05:00,0.09,12,5,1,0,406,2908,3314
2014-12-09 06:00:00-05:00,0.27,12,6,1,0,420,2735,3155
2014-12-09 07:00:00-05:00,0.28,12,7,1,0,421,4772,5193
2014-12-09 08:00:00-05:00,0.25,12,8,1,0,844,14126,14970
2014-12-09 09:00:00-05:00,0.23,12,9,1,0,1863,22932,24795
2014-12-09 10:00:00-05:00,0.27,12,10,1,0,2887,25688,28575
2014-12-09 11:00:00-05:00,0.24,12,11,1,0,2747,24078,26825
2014-12-09 12:00:00-05:00,0.24,12,12,1,0,2530,21962,24492
2014-12-09 13:00:00-05:00,0.39,12,13,1,0,2404,21488,23892
2014-12-09 14:00:00-05:00,0.27,12,14,1,0,2224,20203,22427
2014-12-09 15:00:00-05:00,0.03,12,15,1,0,2421,20224,22645
2014-12-09 16:00:00-05:00,0.03,12,16,1,0,2659,21275,23934
2014-12-09 17:00:00-05:00,0,12,17,1,0,2753,18742,21495
2014-12-09 18:00:00-05:00,0,12,18,1,0,2500,14975,17475
2014-12-09 19:00:00-05:00,0,12,19,1,0,2839,20529,23368
2014-12-09 20:00:00-05:00,0,12,20,1,0,3110,26040,29150
2014-12-09 21:00:00-05:00,0,12,21,1,0,3161,27251,30412
2014-12-09 22:00:00-05:00,0,12,22,1,0,2582,27535,30117
2014-12-09 23:00:00-05:00,0,12,23,1,0,2270,27923,30193
2014-12-10 00:00:00-05:00,0,12,0,2,0,2030,26238,28268
2014-12-10 01:00:00-05:00,0.01,12,1,2,0,1672,21690,23362
2014-12-10 02:00:00-05:00,0,12,2,2,0,1304,14785,16089
2014-12-10 03:00:00-05:00,0,12,3,2,0,885,8314,9199
2014-12-10 04:00:00-05:00,0.01,12,4,2,0,543,5273,5816
2014-12-10 05:00:00-05:00,0,12,5,2,0,398,3196,3594
2014-12-10 06:00:00-05:00,0.01,12,6,2,0,393,3026,3419
2014-12-10 07:00:00-05:00,0.01,12,7,2,0,368,4491,4859
2014-12-10 08:00:00-05:00,0,12,8,2,0,746,12126,12872
2014-12-10 09:00:00-05:00,0,12,9,2,0,1733,22371,24104
2014-12-10 10:00:00-05:00,0,12,10,2,0,2597,26453,29050
2014-12-10 11:00:00-05:00,0,12,11,2,0,2562,24298,26860
2014-12-10 12:00:00-05:00,0,12,12,2,0,2184,21996,24180
2014-12-10 13:00:00-05:00,0,12,13,2,0,2128,22178,24306
2014-12-10 14:00:00-05:00,0,12,14,2,0,2139,22152,24291
2014-12-10 15:00:00-05:00,0,12,15,2,0,2215,21264,23479
2014-12-10 16:00:00-05:00,0.01,12,16,2,0,2391,21386,23777
2014-12-10 17:00:00-05:00,0,12,17,2,0,2645,19202,21847
2014-12-10 18:00:00-05:00,0,12,18,2,0,2856,14298,17154
2014-12-10 19:00:00-05:00,0,12,19,2,0,3235,18688,21923
2014-12-10 20:00:00-05:00,0,12,20,2,0,3739,24425,28164
2014-12-10 21:00:00-05:00,0,12,21,2,0,3723,26715,30438
2014-12-10 22:00:00-05:00,0,12,22,2,0,3183,28166,31349
2014-12-10 23:00:00-05:00,0,12,23,2,0,2831,29389,32220
2014-12-11 00:00:00-05:00,0,12,0,3,0,2606,28279,30885
2014-12-11 01:00:00-05:00,0,12,1,3,0,2242,24879,27121
2014-12-11 02:00:00-05:00,0,12,2,3,0,1687,18376,20063
2014-12-11 03:00:00-05:00,0,12,3,3,0,1173,10870,12043
2014-12-11 04:00:00-05:00,0,12,4,3,0,754,6453,7207
2014-12-11 05:00:00-05:00,0,12,5,3,0,453,3868,4321
2014-12-11 06:00:00-05:00,0,12,6,3,0,441,3224,3665
2014-12-11 07:00:00-05:00,0,12,7,3,0,420,4643,5063
2014-12-11 08:00:00-05:00,0,12,8,3,0,783,12346,13129
2014-12-11 09:00:00-05:00,0,12,9,3,0,1764,22456,24220
2014-12-11 10:00:00-05:00,0,12,10,3,0,2713,25807,28520
2014-12-11 11:00:00-05:00,0,12,11,3,0,2584,24957,27541
2014-12-11 12:00:00-05:00,0,12,12,3,0,2250,22506,24756
2014-12-11 13:00:00-05:00,0,12,13,3,0,2152,22285,24437
2014-12-11 14:00:00-05:00,0,12,14,3,0,2003,22436,24439
2014-12-11 15:00:00-05:00,0,12,15,3,0,2087,22183,24270
2014-12-11 16:00:00-05:00,0,12,16,3,0,2380,23641,26021
2014-12-11 17:00:00-05:00,0,12,17,3,0,2873,20906,23779
2014-12-11 18:00:00-05:00,0,12,18,3,0,2919,15483,18402
2014-12-11 19:00:00-05:00,0,12,19,3,0,3538,20313,23851
2014-12-11 20:00:00-05:00,0,12,20,3,0,4114,26559,30673
2014-12-11 21:00:00-05:00,0,12,21,3,0,4273,28510,32783
2014-12-11 22:00:00-05:00,0,12,22,3,0,4092,28519,32611
2014-12-11 23:00:00-05:00,0,12,23,3,0,3699,28869,32568
2014-12-12 00:00:00-05:00,0,12,0,4,0,3441,28129,31570
2014-12-12 01:00:00-05:00,0,12,1,4,0,3055,26348,29403
2014-12-12 02:00:00-05:00,0,12,2,4,0,2512,23694,26206
2014-12-12 03:00:00-05:00,0,12,3,4,0,1879,17313,19192
2014-12-12 04:00:00-05:00,0,12,4,4,0,1184,11144,12328
2014-12-12 05:00:00-05:00,0,12,5,4,0,814,6927,7741
2014-12-12 06:00:00-05:00,0,12,6,4,0,664,4990,5654
2014-12-12 07:00:00-05:00,0,12,7,4,0,457,5058,5515
2014-12-12 08:00:00-05:00,0,12,8,4,0,771,12267,13038
2014-12-12 09:00:00-05:00,0,12,9,4,0,1695,21988,23683
2014-12-12 10:00:00-05:00,0,12,10,4,0,2506,25667,28173
2014-12-12 11:00:00-05:00,0,12,11,4,0,2476,23954,26430
2014-12-12 12:00:00-05:00,0,12,12,4,0,2235,22482,24717
2014-12-12 13:00:00-05:00,0,12,13,4,0,2095,22530,24625
2014-12-12 14:00:00-05:00,0,12,14,4,0,2045,21264,23309
2014-12-12 15:00:00-05:00,0,12,15,4,0,2065,21720,23785
2014-12-12 16:00:00-05:00,0,12,16,4,0,2412,22740,25152
2014-12-12 17:00:00-05:00,0,12,17,4,0,2966,20108,23074
2014-12-12 18:00:00-05:00,0,12,18,4,0,3353,15810,19163
2014-12-12 19:00:00-05:00,0,12,19,4,0,4011,20974,24985
2014-12-12 20:00:00-05:00,0,12,20,4,0,4766,27528,32294
2014-12-12 21:00:00-05:00,0,12,21,4,0,4924,29932,34856
2014-12-12 22:00:00-05:00,0,12,22,4,0,4853,29312,34165
2014-12-12 23:00:00-05:00,0,12,23,4,0,4672,29564,34236
2014-12-13 00:00:00-05:00,0,12,0,5,0,4858,30595,35453
2014-12-13 01:00:00-05:00,0,12,1,5,0,4701,29711,34412
2014-12-13 02:00:00-05:00,0,12,2,5,0,4502,28073,32575
2014-12-13 03:00:00-05:00,0,12,3,5,0,4064,25439,29503
2014-12-13 04:00:00-05:00,0,12,4,5,0,3144,21325,24469
2014-12-13 05:00:00-05:00,0,12,5,5,0,2531,15498,18029
2014-12-13 06:00:00-05:00,0,12,6,5,0,1918,9866,11784
2014-12-13 07:00:00-05:00,0,12,7,5,0,976,4679,5655
2014-12-13 08:00:00-05:00,0,12,8,5,0,731,5383,6114
2014-12-13 09:00:00-05:00,0,12,9,5,0,883,8014,8897
2014-12-13 10:00:00-05:00,0,12,10,5,0,1225,12907,14132
2014-12-13 11:00:00-05:00,0,12,11,5,0,1612,18438,20050
2014-12-13 12:00:00-05:00,0,12,12,5,0,1975,23986,25961
2014-12-13 13:00:00-05:00,0,12,13,5,0,2173,26313,28486
2014-12-13 14:00:00-05:00,0,12,14,5,0,2327,27531,29858
2014-12-13 15:00:00-05:00,0,12,15,5,0,2565,27139,29704
2014-12-13 16:00:00-05:00,0,12,16,5,0,2792,25452,28244
2014-12-13 17:00:00-05:00,0,12,17,5,0,3232,22650,25882
2014-12-13 18:00:00-05:00,0,12,18,5,0,3582,16234,19816
2014-12-13 19:00:00-05:00,0,12,19,5,0,3974,18851,22825
2014-12-13 20:00:00-05:00,0,12,20,5,0,4587,24236,28823
2014-12-13 21:00:00-05:00,0,12,21,5,0,4779,27039,31818
2014-12-13 22:00:00-05:00,0,12,22,5,0,4862,26894,31756
2014-12-13 23:00:00-05:00,0,12,23,5,0,4699,27176,31875
2014-12-14 00:00:00-05:00,0,12,0,6,0,4992,28430,33422
2014-12-14 01:00:00-05:00,0,12,1,6,0,5230,29723,34953
2014-12-14 02:00:00-05:00,0,12,2,6,0,4868,29211,34079
2014-12-14 03:00:00-05:00,0,12,3,6,0,4637,26418,31055
2014-12-14 04:00:00-05:00,0,12,4,6,0,3883,22806,26689
2014-12-14 05:00:00-05:00,0,12,5,6,0,3075,16900,19975
2014-12-14 06:00:00-05:00,0,12,6,6,0,2220,10764,12984
2014-12-14 07:00:00-05:00,0,12,7,6,0,1068,4892,5960
2014-12-14 08:00:00-05:00,0,12,8,6,0,698,4740,5438
2014-12-14 09:00:00-05:00,0,12,9,6,0,702,6133,6835
2014-12-14 10:00:00-05:00,0,12,10,6,0,877,9712,10589
2014-12-14 11:00:00-05:00,0,12,11,6,0,1250,14855,16105
2014-12-14 12:00:00-05:00,0,12,12,6,0,1670,21151,22821
2014-12-14 13:00:00-05:00,0,12,13,6,0,1941,24342,26283
2014-12-14 14:00:00-05:00,0,12,14,6,0,2204,25832,28036
2014-12-14 15:00:00-05:00,0,12,15,6,0,2352,24830,27182
2014-12-14 16:00:00-05:00,0,12,16,6,0,2529,23838,26367
2014-12-14 17:00:00-05:00,0,12,17,6,0,2811,22454,25265
2014-12-14 18:00:00-05:00,0,12,18,6,0,3040,18623,21663
2014-12-14 19:00:00-05:00,0,12,19,6,0,3244,19644,22888
2014-12-14 20:00:00-05:00,0,12,20,6,0,3374,22289,25663
2014-12-14 21:00:00-05:00,0,12,21,6,0,3329,21836,25165
2014-12-14 22:00:00-05:00,0,12,22,6,0,2899,19570,22469
2014-12-14 23:00:00-05:00,0,12,23,6,0,2710,19102,21812
2014-12-15 00:00:00-05:00,0,12,0,0,0,2400,17795,20195
2014-12-15 01:00:00-05:00,0,12,1,0,0,2259,13628,15887
2014-12-15 02:00:00-05:00,0,12,2,0,0,1567,9545,11112
2014-12-15 03:00:00-05:00,0,12,3,0,0,1053,5706,6759
2014-12-15 04:00:00-05:00,0,12,4,0,0,690,3804,4494
2014-12-15 05:00:00-05:00,0,12,5,0,0,544,2570,3114
2014-12-15 06:00:00-05:00,0,12,6,0,0,574,3176,3750
2014-12-15 07:00:00-05:00,0,12,7,0,0,500,5025,5525
2014-12-15 08:00:00-05:00,0,12,8,0,0,850,12080,12930
2014-12-15 09:00:00-05:00,0,12,9,0,0,1642,20512,22154
2014-12-15 10:00:00-05:00,0,12,10,0,0,2511,23155,25666
2014-12-15 11:00:00-05:00,0,12,11,0,0,2376,22091,24467
2014-12-15 12:00:00-05:00,0,12,12,0,0,2020,19697,21717
2014-12-15 13:00:00-05:00,0,12,13,0,0,1779,19723,21502
2014-12-15 14:00:00-05:00,0,12,14,0,0,1833,20194,22027
2014-12-15 15:00:00-05:00,0,12,15,0,0,1690,19768,21458
2014-12-15 16:00:00-05:00,0,12,16,0,0,2003,21055,23058
2014-12-15 17:00:00-05:00,0,12,17,0,0,2228,20124,22352
2014-12-15 18:00:00-05:00,0,12,18,0,0,2442,16397,18839
2014-12-15 19:00:00-05:00,0,12,19,0,0,2768,20003,22771
2014-12-15 20:00:00-05:00,0,12,20,0,0,2988,24723,27711
2014-12-15 21:00:00-05:00,0,12,21,0,0,2981,26542,29523
2014-12-15 22:00:00-05:00,0,12,22,0,0,2666,26104,28770
2014-12-15 23:00:00-05:00,0,12,23,0,0,2332,25907,28239
2014-12-16 00:00:00-05:00,0,12,0,1,0,2004,23776,25780
2014-12-16 01:00:00-05:00,0,12,1,1,0,1622,18782,20404
2014-12-16 02:00:00-05:00,0,12,2,1,0,1222,12355,13577
2014-12-16 03:00:00-05:00,0,12,3,1,0,809,7458,8267
2014-12-16 04:00:00-05:00,0,12,4,1,0,524,4946,5470
2014-12-16 05:00:00-05:00,0,12,5,1,0,378,3131,3509
2014-12-16 06:00:00-05:00,0,12,6,1,0,403,2854,3257
2014-12-16 07:00:00-05:00,0,12,7,1,0,396,4374,4770
2014-12-16 08:00:00-05:00,0,12,8,1,0,739,11918,12657
2014-12-16 09:00:00-05:00,0,12,9,1,0,1675,21245,22920
2014-12-16 10:00:00-05:00,0,12,10,1,0,2474,24710,27184
2014-12-16 11:00:00-05:00,0,12,11,1,0,2417,23371,25788
2014-12-16 12:00:00-05:00,0,12,12,1,0,2044,20913,22957
2014-12-16 13:00:00-05:00,0,12,13,1,0,1884,20691,22575
2014-12-16 14:00:00-05:00,0,12,14,1,0,1934,21341,23275
2014-12-16 15:00:00-05:00,0,12,15,1,0,1851,20479,22330
2014-12-16 16:00:00-05:00,0,12,16,1,0,2090,21689,23779
2014-12-16 17:00:00-05:00,0.01,12,17,1,0,2457,20180,22637
2014-12-16 18:00:00-05:00,0,12,18,1,0,2715,15883,18598
2014-12-16 19:00:00-05:00,0.02,12,19,1,0,3196,20219,23415
2014-12-16 20:00:00-05:00,0.05,12,20,1,0,3483,25413,28896
2014-12-16 21:00:00-05:00,0.04,12,21,1,0,3660,28561,32221
2014-12-16 22:00:00-05:00,0.02,12,22,1,0,3448,28725,32173
2014-12-16 23:00:00-05:00,0.02,12,23,1,0,3134,29068,32202
2014-12-17 00:00:00-05:00,0.02,12,0,2,0,2742,27556,30298
2014-12-17 01:00:00-05:00,0,12,1,2,0,2119,22699,24818
2014-12-17 02:00:00-05:00,0.01,12,2,2,0,1519,15407,16926
2014-12-17 03:00:00-05:00,0,12,3,2,0,1013,9327,10340
2014-12-17 04:00:00-05:00,0,12,4,2,0,639,5774,6413
2014-12-17 05:00:00-05:00,0,12,5,2,0,414,3596,4010
2014-12-17 06:00:00-05:00,0,12,6,2,0,454,3344,3798
2014-12-17 07:00:00-05:00,0,12,7,2,0,390,4537,4927
2014-12-17 08:00:00-05:00,0,12,8,2,0,682,12060,12742
2014-12-17 09:00:00-05:00,0,12,9,2,0,1559,21643,23202
2014-12-17 10:00:00-05:00,0,12,10,2,0,2360,24987,27347
2014-12-17 11:00:00-05:00,0,12,11,2,0,2305,23818,26123
2014-12-17 12:00:00-05:00,0,12,12,2,0,1985,21714,23699
2014-12-17 13:00:00-05:00,0,12,13,2,0,1886,21743,23629
2014-12-17 14:00:00-05:00,0,12,14,2,0,1861,22311,24172
2014-12-17 15:00:00-05:00,0,12,15,2,0,1969,21568,23537
2014-12-17 16:00:00-05:00,0,12,16,2,0,2161,22141,24302
2014-12-17 17:00:00-05:00,0,12,17,2,0,2607,20266,22873
2014-12-17 18:00:00-05:00,0,12,18,2,0,2815,15342,18157
2014-12-17 19:00:00-05:00,0,12,19,2,0,3033,20161,23194
2014-12-17 20:00:00-05:00,0,12,20,2,0,3459,25749,29208
2014-12-17 21:00:00-05:00,0,12,21,2,0,3525,27686,31211
2014-12-17 22:00:00-05:00,0,12,22,2,0,3377,28989,32366
2014-12-17 23:00:00-05:00,0,12,23,2,0,3082,29714,32796
2014-12-18 00:00:00-05:00,0,12,0,3,0,2927,28882,31809
2014-12-18 01:00:00-05:00,0,12,1,3,0,2672,25805,28477
2014-12-18 02:00:00-05:00,0,12,2,3,0,1892,19980,21872
2014-12-18 03:00:00-05:00,0,12,3,3,0,1289,11911,13200
2014-12-18 04:00:00-05:00,0,12,4,3,0,845,7308,8153
2014-12-18 05:00:00-05:00,0,12,5,3,0,567,4472,5039
2014-12-18 06:00:00-05:00,0,12,6,3,0,513,3750,4263
2014-12-18 07:00:00-05:00,0,12,7,3,0,501,5018,5519
2014-12-18 08:00:00-05:00,0,12,8,3,0,761,12383,13144
2014-12-18 09:00:00-05:00,0,12,9,3,0,1775,21532,23307
2014-12-18 10:00:00-05:00,0,12,10,3,0,2734,25240,27974
2014-12-18 11:00:00-05:00,0,12,11,3,0,2548,24199,26747
2014-12-18 12:00:00-05:00,0,12,12,3,0,2334,22480,24814
2014-12-18 13:00:00-05:00,0,12,13,3,0,2041,22221,24262
2014-12-18 14:00:00-05:00,0,12,14,3,0,2188,23026,25214
2014-12-18 15:00:00-05:00,0,12,15,3,0,2193,22451,24644
2014-12-18 16:00:00-05:00,0,12,16,3,0,2452,23368,25820
2014-12-18 17:00:00-05:00,0,12,17,3,0,2786,21243,24029
2014-12-18 18:00:00-05:00,0,12,18,3,0,3113,15770,18883
2014-12-18 19:00:00-05:00,0,12,19,3,0,3589,20932,24521
2014-12-18 20:00:00-05:00,0,12,20,3,0,4014,26956,30970
2014-12-18 21:00:00-05:00,0,12,21,3,0,4283,29569,33852
2014-12-18 22:00:00-05:00,0,12,22,3,0,3964,30045,34009
2014-12-18 23:00:00-05:00,0,12,23,3,0,3531,30764,34295
2014-12-19 00:00:00-05:00,0,12,0,4,0,3379,29782,33161
2014-12-19 01:00:00-05:00,0,12,1,4,0,3211,28260,31471
2014-12-19 02:00:00-05:00,0,12,2,4,0,2539,23710,26249
2014-12-19 03:00:00-05:00,0,12,3,4,0,1750,17900,19650
2014-12-19 04:00:00-05:00,0,12,4,4,0,1212,11406,12618
2014-12-19 05:00:00-05:00,0,12,5,4,0,940,7385,8325
2014-12-19 06:00:00-05:00,0,12,6,4,0,751,5619,6370
2014-12-19 07:00:00-05:00,0,12,7,4,0,603,5530,6133
2014-12-19 08:00:00-05:00,0,12,8,4,0,808,11831,12639
2014-12-19 09:00:00-05:00,0,12,9,4,0,1779,21122,22901
2014-12-19 10:00:00-05:00,0,12,10,4,0,2685,25558,28243
2014-12-19 11:00:00-05:00,0,12,11,4,0,2680,25275,27955
2014-12-19 12:00:00-05:00,0,12,12,4,0,2362,22930,25292
2014-12-19 13:00:00-05:00,0,12,13,4,0,2201,23524,25725
2014-12-19 14:00:00-05:00,0,12,14,4,0,2049,22705,24754
2014-12-19 15:00:00-05:00,0,12,15,4,0,2078,22179,24257
2014-12-19 16:00:00-05:00,0,12,16,4,0,2500,23752,26252
2014-12-19 17:00:00-05:00,0,12,17,4,0,3010,21057,24067
2014-12-19 18:00:00-05:00,0,12,18,4,0,3689,16148,19837
2014-12-19 19:00:00-05:00,0,12,19,4,0,4228,21222,25450
2014-12-19 20:00:00-05:00,0,12,20,4,0,4648,28303,32951
2014-12-19 21:00:00-05:00,0,12,21,4,0,5252,31090,36342
2014-12-19 22:00:00-05:00,0,12,22,4,0,4983,30517,35500
2014-12-19 23:00:00-05:00,0,12,23,4,0,4805,30179,34984
2014-12-20 00:00:00-05:00,0,12,0,5,0,4789,30413,35202
2014-12-20 01:00:00-05:00,0,12,1,5,0,5029,29661,34690
2014-12-20 02:00:00-05:00,0,12,2,5,0,4593,28669,33262
2014-12-20 03:00:00-05:00,0,12,3,5,0,3990,25335,29325
2014-12-20 04:00:00-05:00,0,12,4,5,0,3256,20493,23749
2014-12-20 05:00:00-05:00,0,12,5,5,0,2640,15275,17915
2014-12-20 06:00:00-05:00,0,12,6,5,0,2085,10010,12095
2014-12-20 07:00:00-05:00,0,12,7,5,0,1038,5150,6188
2014-12-20 08:00:00-05:00,0,12,8,5,0,805,5777,6582
2014-12-20 09:00:00-05:00,0,12,9,5,0,900,7094,7994
2014-12-20 10:00:00-05:00,0,12,10,5,0,1245,10910,12155
2014-12-20 11:00:00-05:00,0,12,11,5,0,1700,16005,17705
2014-12-20 12:00:00-05:00,0,12,12,5,0,1943,20612,22555
2014-12-20 13:00:00-05:00,0,12,13,5,0,2287,24139,26426
2014-12-20 14:00:00-05:00,0,12,14,5,0,2465,26144,28609
2014-12-20 15:00:00-05:00,0,12,15,5,0,2612,25876,28488
2014-12-20 16:00:00-05:00,0,12,16,5,0,2807,25199,28006
2014-12-20 17:00:00-05:00,0,12,17,5,0,3383,24515,27898
2014-12-20 18:00:00-05:00,0,12,18,5,0,3690,19103,22793
2014-12-20 19:00:00-05:00,0,12,19,5,0,4098,21947,26045
2014-12-20 20:00:00-05:00,0,12,20,5,0,4458,26803,31261
2014-12-20 21:00:00-05:00,0,12,21,5,0,4930,28617,33547
2014-12-20 22:00:00-05:00,0,12,22,5,0,4713,25892,30605
2014-12-20 23:00:00-05:00,0,12,23,5,0,4797,25422,30219
2014-12-21 00:00:00-05:00,0,12,0,6,0,4719,26854,31573
2014-12-21 01:00:00-05:00,0,12,1,6,0,4947,28425,33372
2014-12-21 02:00:00-05:00,0,12,2,6,0,4690,28120,32810
2014-12-21 03:00:00-05:00,0,12,3,6,0,4151,25002,29153
2014-12-21 04:00:00-05:00,0,12,4,6,0,3537,21202,24739
2014-12-21 05:00:00-05:00,0,12,5,6,0,2882,16056,18938
2014-12-21 06:00:00-05:00,0,12,6,6,0,2205,10267,12472
2014-12-21 07:00:00-05:00,0,12,7,6,0,1139,4903,6042
2014-12-21 08:00:00-05:00,0,12,8,6,0,828,4981,5809
2014-12-21 09:00:00-05:00,0,12,9,6,0,740,5650,6390
2014-12-21 10:00:00-05:00,0,12,10,6,0,950,8305,9255
2014-12-21 11:00:00-05:00,0,12,11,6,0,1273,13011,14284
2014-12-21 12:00:00-05:00,0,12,12,6,0,1686,18629,20315
2014-12-21 13:00:00-05:00,0,12,13,6,0,1918,21736,23654
2014-12-21 14:00:00-05:00,0,12,14,6,0,2201,23566,25767
2014-12-21 15:00:00-05:00,0,12,15,6,0,2442,23321,25763
2014-12-21 16:00:00-05:00,0,12,16,6,0,2618,22834,25452
2014-12-21 17:00:00-05:00,0,12,17,6,0,2883,22045,24928
2014-12-21 18:00:00-05:00,0,12,18,6,0,3063,18634,21697
2014-12-21 19:00:00-05:00,0,12,19,6,0,3370,20632,24002
2014-12-21 20:00:00-05:00,0,12,20,6,0,3276,22436,25712
2014-12-21 21:00:00-05:00,0,12,21,6,0,3183,21067,24250
2014-12-21 22:00:00-05:00,0,12,22,6,0,3083,18941,22024
2014-12-21 23:00:00-05:00,0,12,23,6,0,2760,18652,21412
2014-12-22 00:00:00-05:00,0,12,0,0,0,2531,16874,19405
2014-12-22 01:00:00-05:00,0,12,1,0,0,2079,13025,15104
2014-12-22 02:00:00-05:00,0,12,2,0,0,1550,9204,10754
2014-12-22 03:00:00-05:00,0,12,3,0,0,1010,5627,6637
2014-12-22 04:00:00-05:00,0,12,4,0,0,697,3739,4436
2014-12-22 05:00:00-05:00,0,12,5,0,0,543,2724,3267
2014-12-22 06:00:00-05:00,0,12,6,0,0,603,3046,3649
2014-12-22 07:00:00-05:00,0,12,7,0,0,516,4155,4671
2014-12-22 08:00:00-05:00,0,12,8,0,0,735,9319,10054
2014-12-22 09:00:00-05:00,0,12,9,0,0,1529,15333,16862
2014-12-22 10:00:00-05:00,0,12,10,0,0,2453,19332,21785
2014-12-22 11:00:00-05:00,0,12,11,0,0,2408,20374,22782
2014-12-22 12:00:00-05:00,0,12,12,0,0,2069,19118,21187
2014-12-22 13:00:00-05:00,0,12,13,0,0,1887,20198,22085
2014-12-22 14:00:00-05:00,0,12,14,0,0,2026,21182,23208
2014-12-22 15:00:00-05:00,0,12,15,0,0,2091,20980,23071
2014-12-22 16:00:00-05:00,0,12,16,0,0,2253,21747,24000
2014-12-22 17:00:00-05:00,0.01,12,17,0,0,2697,20031,22728
2014-12-22 18:00:00-05:00,0,12,18,0,0,2747,15573,18320
2014-12-22 19:00:00-05:00,0,12,19,0,0,2995,19554,22549
2014-12-22 20:00:00-05:00,0,12,20,0,0,3220,23834,27054
2014-12-22 21:00:00-05:00,0,12,21,0,0,3090,24078,27168
2014-12-22 22:00:00-05:00,0.02,12,22,0,0,2871,22766,25637
2014-12-22 23:00:00-05:00,0.01,12,23,0,0,2525,23270,25795
2014-12-23 00:00:00-05:00,0,12,0,1,0,2396,21108,23504
2014-12-23 01:00:00-05:00,0.06,12,1,1,0,1870,15820,17690
2014-12-23 02:00:00-05:00,0.05,12,2,1,0,1421,11125,12546
2014-12-23 03:00:00-05:00,0.01,12,3,1,0,1032,7859,8891
2014-12-23 04:00:00-05:00,0,12,4,1,0,642,4627,5269
2014-12-23 05:00:00-05:00,0.01,12,5,1,0,436,3288,3724
2014-12-23 06:00:00-05:00,0,12,6,1,0,507,3245,3752
2014-12-23 07:00:00-05:00,0,12,7,1,0,467,4361,4828
2014-12-23 08:00:00-05:00,0,12,8,1,0,723,9767,10490
2014-12-23 09:00:00-05:00,0,12,9,1,0,1497,15738,17235
2014-12-23 10:00:00-05:00,0.02,12,10,1,0,2331,19913,22244
2014-12-23 11:00:00-05:00,0,12,11,1,0,2321,21054,23375
2014-12-23 12:00:00-05:00,0,12,12,1,0,2090,20031,22121
2014-12-23 13:00:00-05:00,0,12,13,1,0,2129,20449,22578
2014-12-23 14:00:00-05:00,0,12,14,1,0,2218,22202,24420
2014-12-23 15:00:00-05:00,0,12,15,1,0,2293,22486,24779
2014-12-23 16:00:00-05:00,0.01,12,16,1,0,2608,22563,25171
2014-12-23 17:00:00-05:00,0,12,17,1,0,2836,20362,23198
2014-12-23 18:00:00-05:00,0,12,18,1,0,2998,15225,18223
2014-12-23 19:00:00-05:00,0,12,19,1,0,3265,18605,21870
2014-12-23 20:00:00-05:00,0.01,12,20,1,0,3444,23137,26581
2014-12-23 21:00:00-05:00,0.01,12,21,1,0,3464,22855,26319
2014-12-23 22:00:00-05:00,0,12,22,1,0,3146,21061,24207
2014-12-23 23:00:00-05:00,0,12,23,1,0,2778,20409,23187
2014-12-24 00:00:00-05:00,0,12,0,2,0,2521,18374,20895
2014-12-24 01:00:00-05:00,0,12,1,2,0,2347,15610,17957
2014-12-24 02:00:00-05:00,0,12,2,2,0,1775,12075,13850
2014-12-24 03:00:00-05:00,0,12,3,2,0,1306,8144,9450
2014-12-24 04:00:00-05:00,0,12,4,2,0,778,5761,6539
2014-12-24 05:00:00-05:00,0,12,5,2,0,617,4006,4623
2014-12-24 06:00:00-05:00,0.03,12,6,2,0,592,3761,4353
2014-12-24 07:00:00-05:00,0,12,7,2,0,505,3930,4435
2014-12-24 08:00:00-05:00,0,12,8,2,0,669,7728,8397
2014-12-24 09:00:00-05:00,0.03,12,9,2,0,1013,10334,11347
2014-12-24 10:00:00-05:00,0.13,12,10,2,0,1609,13536,15145
2014-12-24 11:00:00-05:00,0.09,12,11,2,0,2010,17939,19949
2014-12-24 12:00:00-05:00,0.08,12,12,2,0,2301,20986,23287
2014-12-24 13:00:00-05:00,0.1,12,13,2,0,2324,22349,24673
2014-12-24 14:00:00-05:00,0.09,12,14,2,0,2484,22887,25371
2014-12-24 15:00:00-05:00,0,12,15,2,0,2808,23976,26784
2014-12-24 16:00:00-05:00,0.08,12,16,2,0,3142,21773,24915
2014-12-24 17:00:00-05:00,0.04,12,17,2,0,3273,20112,23385
2014-12-24 18:00:00-05:00,0,12,18,2,0,3800,18012,21812
2014-12-24 19:00:00-05:00,0,12,19,2,0,4021,19157,23178
2014-12-24 20:00:00-05:00,0,12,20,2,0,4169,19001,23170
2014-12-24 21:00:00-05:00,0,12,21,2,0,4020,16611,20631
2014-12-24 22:00:00-05:00,0,12,22,2,0,3748,14286,18034
2014-12-24 23:00:00-05:00,0,12,23,2,0,3437,14169,17606
2014-12-25 00:00:00-05:00,0,12,0,3,1,3137,14318,17455
2014-12-25 01:00:00-05:00,0,12,1,3,1,2806,13416,16222
2014-12-25 02:00:00-05:00,0.02,12,2,3,1,2260,11531,13791
2014-12-25 03:00:00-05:00,0.03,12,3,3,1,2226,8918,11144
2014-12-25 04:00:00-05:00,0,12,4,3,1,1786,6508,8294
2014-12-25 05:00:00-05:00,0,12,5,3,1,1380,4267,5647
2014-12-25 06:00:00-05:00,0.02,12,6,3,1,1084,3090,4174
2014-12-25 07:00:00-05:00,0,12,7,3,1,673,2127,2800
2014-12-25 08:00:00-05:00,0,12,8,3,1,553,2994,3547
2014-12-25 09:00:00-05:00,0,12,9,3,1,502,3464,3966
2014-12-25 10:00:00-05:00,0,12,10,3,1,534,3833,4367
2014-12-25 11:00:00-05:00,0,12,11,3,1,659,5599,6258
2014-12-25 12:00:00-05:00,0,12,12,3,1,849,8092,8941
2014-12-25 13:00:00-05:00,0,12,13,3,1,1056,10129,11185
2014-12-25 14:00:00-05:00,0,12,14,3,1,1274,11493,12767
2014-12-25 15:00:00-05:00,0,12,15,3,1,1658,11914,13572
2014-12-25 16:00:00-05:00,0,12,16,3,1,1831,12735,14566
2014-12-25 17:00:00-05:00,0,12,17,3,1,2091,12937,15028
2014-12-25 18:00:00-05:00,0,12,18,3,1,2195,11716,13911
2014-12-25 19:00:00-05:00,0,12,19,3,1,2236,11548,13784
2014-12-25 20:00:00-05:00,0,12,20,3,1,2304,11996,14300
2014-12-25 21:00:00-05:00,0,12,21,3,1,2257,11898,14155
2014-12-25 22:00:00-05:00,0,12,22,3,1,2146,11047,13193
2014-12-25 23:00:00-05:00,0,12,23,3,1,2106,11723,13829
2014-12-26 00:00:00-05:00,0,12,0,4,0,2150,11815,13965
2014-12-26 01:00:00-05:00,0,12,1,4,0,1821,8876,10697
2014-12-26 02:00:00-05:00,0,12,2,4,0,1494,6588,8082
2014-12-26 03:00:00-05:00,0,12,3,4,0,1055,4362,5417
2014-12-26 04:00:00-05:00,0,12,4,4,0,704,2978,3682
2014-12-26 05:00:00-05:00,0,12,5,4,0,519,2050,2569
2014-12-26 06:00:00-05:00,0,12,6,4,0,502,2046,2548
2014-12-26 07:00:00-05:00,0,12,7,4,0,348,2059,2407
2014-12-26 08:00:00-05:00,0,12,8,4,0,485,4218,4703
2014-12-26 09:00:00-05:00,0,12,9,4,0,687,6237,6924
2014-12-26 10:00:00-05:00,0,12,10,4,0,1052,8091,9143
2014-12-26 11:00:00-05:00,0,12,11,4,0,1163,10168,11331
2014-12-26 12:00:00-05:00,0,12,12,4,0,1160,12059,13219
2014-12-26 13:00:00-05:00,0,12,13,4,0,1283,13993,15276
2014-12-26 14:00:00-05:00,0,12,14,4,0,1352,15674,17026
2014-12-26 15:00:00-05:00,0,12,15,4,0,1475,15994,17469
2014-12-26 16:00:00-05:00,0,12,16,4,0,1709,16777,18486
2014-12-26 17:00:00-05:00,0,12,17,4,0,2139,17795,19934
2014-12-26 18:00:00-05:00,0,12,18,4,0,2354,16300,18654
2014-12-26 19:00:00-05:00,0,12,19,4,0,2592,17564,20156
2014-12-26 20:00:00-05:00,0,12,20,4,0,2604,18486,21090
2014-12-26 21:00:00-05:00,0,12,21,4,0,2707,19172,21879
2014-12-26 22:00:00-05:00,0,12,22,4,0,2508,16581,19089
2014-12-26 23:00:00-05:00,0,12,23,4,0,2508,16240,18748
2014-12-27 00:00:00-05:00,0,12,0,5,0,2533,17384,19917
2014-12-27 01:00:00-05:00,0,12,1,5,0,2513,15851,18364
2014-12-27 02:00:00-05:00,0,12,2,5,0,2399,14072,16471
2014-12-27 03:00:00-05:00,0,12,3,5,0,2126,11819,13945
2014-12-27 04:00:00-05:00,0,12,4,5,0,1768,9689,11457
2014-12-27 05:00:00-05:00,0,12,5,5,0,1470,7778,9248
2014-12-27 06:00:00-05:00,0,12,6,5,0,1256,5635,6891
2014-12-27 07:00:00-05:00,0,12,7,5,0,601,2938,3539
2014-12-27 08:00:00-05:00,0,12,8,5,0,417,3286,3703
2014-12-27 09:00:00-05:00,0,12,9,5,0,544,4380,4924
2014-12-27 10:00:00-05:00,0,12,10,5,0,763,6307,7070
2014-12-27 11:00:00-05:00,0,12,11,5,0,993,9709,10702
2014-12-27 12:00:00-05:00,0,12,12,5,0,1209,12466,13675
2014-12-27 13:00:00-05:00,0,12,13,5,0,1461,15060,16521
2014-12-27 14:00:00-05:00,0,12,14,5,0,1628,16660,18288
2014-12-27 15:00:00-05:00,0,12,15,5,0,1911,18285,20196
2014-12-27 16:00:00-05:00,0,12,16,5,0,1998,18140,20138
2014-12-27 17:00:00-05:00,0,12,17,5,0,2345,19135,21480
2014-12-27 18:00:00-05:00,0,12,18,5,0,2659,16751,19410
2014-12-27 19:00:00-05:00,0,12,19,5,0,2765,17768,20533
2014-12-27 20:00:00-05:00,0,12,20,5,0,2998,19430,22428
2014-12-27 21:00:00-05:00,0,12,21,5,0,3128,19622,22750
2014-12-27 22:00:00-05:00,0,12,22,5,0,3021,17578,20599
2014-12-27 23:00:00-05:00,0,12,23,5,0,3039,18219,21258
2014-12-28 00:00:00-05:00,0,12,0,6,0,3209,19710,22919
2014-12-28 01:00:00-05:00,0,12,1,6,0,3253,19259,22512
2014-12-28 02:00:00-05:00,0,12,2,6,0,3224,17572,20796
2014-12-28 03:00:00-05:00,0,12,3,6,0,2787,15462,18249
2014-12-28 04:00:00-05:00,0,12,4,6,0,2450,13333,15783
2014-12-28 05:00:00-05:00,0,12,5,6,0,1968,10679,12647
2014-12-28 06:00:00-05:00,0,12,6,6,0,1640,7593,9233
2014-12-28 07:00:00-05:00,0.04,12,7,6,0,831,3722,4553
2014-12-28 08:00:00-05:00,0.04,12,8,6,0,558,3692,4250
2014-12-28 09:00:00-05:00,0.02,12,9,6,0,560,4623,5183
2014-12-28 10:00:00-05:00,0,12,10,6,0,668,6903,7571
2014-12-28 11:00:00-05:00,0,12,11,6,0,963,9868,10831
2014-12-28 12:00:00-05:00,0,12,12,6,0,1308,13636,14944
2014-12-28 13:00:00-05:00,0,12,13,6,0,1497,15379,16876
2014-12-28 14:00:00-05:00,0,12,14,6,0,1586,17074,18660
2014-12-28 15:00:00-05:00,0,12,15,6,0,1767,17069,18836
2014-12-28 16:00:00-05:00,0,12,16,6,0,1911,17151,19062
2014-12-28 17:00:00-05:00,0,12,17,6,0,2143,17919,20062
2014-12-28 18:00:00-05:00,0,12,18,6,0,2259,17541,19800
2014-12-28 19:00:00-05:00,0,12,19,6,0,2379,18085,20464
2014-12-28 20:00:00-05:00,0,12,20,6,0,2360,18516,20876
2014-12-28 21:00:00-05:00,0,12,21,6,0,2371,18014,20385
2014-12-28 22:00:00-05:00,0,12,22,6,0,2229,16451,18680
2014-12-28 23:00:00-05:00,0,12,23,6,0,1991,15592,17583
2014-12-29 00:00:00-05:00,0,12,0,0,0,1852,15372,17224
2014-12-29 01:00:00-05:00,0,12,1,0,0,1753,12670,14423
2014-12-29 02:00:00-05:00,0,12,2,0,0,1423,8963,10386
2014-12-29 03:00:00-05:00,0,12,3,0,0,1004,5578,6582
2014-12-29 04:00:00-05:00,0,12,4,0,0,682,3864,4546
2014-12-29 05:00:00-05:00,0,12,5,0,0,538,2745,3283
2014-12-29 06:00:00-05:00,0,12,6,0,0,543,2556,3099
2014-12-29 07:00:00-05:00,0,12,7,0,0,391,3162,3553
2014-12-29 08:00:00-05:00,0,12,8,0,0,541,6867,7408
2014-12-29 09:00:00-05:00,0,12,9,0,0,843,9989,10832
2014-12-29 10:00:00-05:00,0,12,10,0,0,1529,13422,14951
2014-12-29 11:00:00-05:00,0,12,11,0,0,1569,15215,16784
2014-12-29 12:00:00-05:00,0,12,12,0,0,1488,15841,17329
2014-12-29 13:00:00-05:00,0,12,13,0,0,1448,17026,18474
2014-12-29 14:00:00-05:00,0,12,14,0,0,1585,18398,19983
2014-12-29 15:00:00-05:00,0,12,15,0,0,1646,18739,20385
2014-12-29 16:00:00-05:00,0,12,16,0,0,1775,19859,21634
2014-12-29 17:00:00-05:00,0,12,17,0,0,2123,20250,22373
2014-12-29 18:00:00-05:00,0,12,18,0,0,2280,17936,20216
2014-12-29 19:00:00-05:00,0,12,19,0,0,2570,20442,23012
2014-12-29 20:00:00-05:00,0,12,20,0,0,2710,22945,25655
2014-12-29 21:00:00-05:00,0,12,21,0,0,2702,22244,24946
2014-12-29 22:00:00-05:00,0,12,22,0,0,2435,19612,22047
2014-12-29 23:00:00-05:00,0,12,23,0,0,2213,19778,21991
2014-12-30 00:00:00-05:00,0,12,0,1,0,2168,18441,20609
2014-12-30 01:00:00-05:00,0,12,1,1,0,1773,15578,17351
2014-12-30 02:00:00-05:00,0,12,2,1,0,1458,11410,12868
2014-12-30 03:00:00-05:00,0,12,3,1,0,1117,7472,8589
2014-12-30 04:00:00-05:00,0,12,4,1,0,738,5192,5930
2014-12-30 05:00:00-05:00,0,12,5,1,0,495,3728,4223
2014-12-30 06:00:00-05:00,0,12,6,1,0,453,3249,3702
2014-12-30 07:00:00-05:00,0,12,7,1,0,330,3263,3593
2014-12-30 08:00:00-05:00,0,12,8,1,0,493,6934,7427
2014-12-30 09:00:00-05:00,0,12,9,1,0,846,10059,10905
2014-12-30 10:00:00-05:00,0,12,10,1,0,1459,14340,15799
2014-12-30 11:00:00-05:00,0,12,11,1,0,1691,16587,18278
2014-12-30 12:00:00-05:00,0,12,12,1,0,1634,17549,19183
2014-12-30 13:00:00-05:00,0,12,13,1,0,1687,18972,20659
2014-12-30 14:00:00-05:00,0,12,14,1,0,1643,20856,22499
2014-12-30 15:00:00-05:00,0,12,15,1,0,1911,21732,23643
2014-12-30 16:00:00-05:00,0,12,16,1,0,2111,21488,23599
2014-12-30 17:00:00-05:00,0,12,17,1,0,2522,20973,23495
2014-12-30 18:00:00-05:00,0,12,18,1,0,2643,17791,20434
2014-12-30 19:00:00-05:00,0,12,19,1,0,2903,20581,23484
2014-12-30 20:00:00-05:00,0,12,20,1,0,3277,24547,27824
2014-12-30 21:00:00-05:00,0,12,21,1,0,3311,24938,28249
2014-12-30 22:00:00-05:00,0,12,22,1,0,2976,22628,25604
2014-12-30 23:00:00-05:00,0,12,23,1,0,2809,22818,25627
2014-12-31 00:00:00-05:00,0,12,0,2,0,2471,21461,23932
2014-12-31 01:00:00-05:00,0,12,1,2,0,2196,19134,21330
2014-12-31 02:00:00-05:00,0,12,2,2,0,1911,15112,17023
2014-12-31 03:00:00-05:00,0,12,3,2,0,1453,10722,12175
2014-12-31 04:00:00-05:00,0,12,4,2,0,1039,7334,8373
2014-12-31 05:00:00-05:00,0,12,5,2,0,740,4998,5738
2014-12-31 06:00:00-05:00,0,12,6,2,0,582,4052,4634
2014-12-31 07:00:00-05:00,0,12,7,2,0,355,3237,3592
2014-12-31 08:00:00-05:00,0,12,8,2,0,453,6163,6616
2014-12-31 09:00:00-05:00,0,12,9,2,0,842,9334,10176
2014-12-31 10:00:00-05:00,0,12,10,2,0,1343,13248,14591
2014-12-31 11:00:00-05:00,0,12,11,2,0,1621,14807,16428
2014-12-31 12:00:00-05:00,0,12,12,2,0,1695,16140,17835
2014-12-31 13:00:00-05:00,0,12,13,2,0,1739,18630,20369
2014-12-31 14:00:00-05:00,0,12,14,2,0,2005,20139,22144
2014-12-31 15:00:00-05:00,0,12,15,2,0,2325,21412,23737
2014-12-31 16:00:00-05:00,0,12,16,2,0,2672,21996,24668
2014-12-31 17:00:00-05:00,0,12,17,2,0,3055,21968,25023
2014-12-31 18:00:00-05:00,0,12,18,2,0,3553,19804,23357
2014-12-31 19:00:00-05:00,0,12,19,2,0,3939,21728,25667
2014-12-31 20:00:00-05:00,0,12,20,2,0,4688,23526,28214
2014-12-31 21:00:00-05:00,0,12,21,2,0,5529,26287,31816
2014-12-31 22:00:00-05:00,0,12,22,2,0,6370,28880,35250
2014-12-31 23:00:00-05:00,0,12,23,2,0,6824,29549,36373
2015-01-01 00:00:00-05:00,0,1,0,3,1,6958,26338,33296
2015-01-01 01:00:00-05:00,0,1,1,3,1,5835,19889,25724
2015-01-01 02:00:00-05:00,0,1,2,3,1,6464,28312,34776
2015-01-01 03:00:00-05:00,0,1,3,3,1,6859,31707,38566
2015-01-01 04:00:00-05:00,0,1,4,3,1,6440,28068,34508
2015-01-01 05:00:00-05:00,0,1,5,3,1,5876,24288,30164
2015-01-01 06:00:00-05:00,0,1,6,3,1,5050,17081,22131
2015-01-01 07:00:00-05:00,0,1,7,3,1,3239,9112,12351
2015-01-01 08:00:00-05:00,0,1,8,3,1,1942,6637,8579
2015-01-01 09:00:00-05:00,0,1,9,3,1,1253,6011,7264
2015-01-01 10:00:00-05:00,0,1,10,3,1,870,5586,6456
2015-01-01 11:00:00-05:00,0,1,11,3,1,725,6977,7702
2015-01-01 12:00:00-05:00,0,1,12,3,1,786,9949,10735
2015-01-01 13:00:00-05:00,0,1,13,3,1,938,13870,14808
2015-01-01 14:00:00-05:00,0,1,14,3,1,1107,16582,17689
2015-01-01 15:00:00-05:00,0,1,15,3,1,1309,17448,18757
2015-01-01 16:00:00-05:00,0,1,16,3,1,1462,17994,19456
2015-01-01 17:00:00-05:00,0,1,17,3,1,1849,18279,20128
2015-01-01 18:00:00-05:00,0,1,18,3,1,1974,16602,18576
2015-01-01 19:00:00-05:00,0,1,19,3,1,2148,17511,19659
2015-01-01 20:00:00-05:00,0,1,20,3,1,2424,18082,20506
2015-01-01 21:00:00-05:00,0,1,21,3,1,2333,16485,18818
2015-01-01 22:00:00-05:00,0,1,22,3,1,2159,15017,17176
2015-01-01 23:00:00-05:00,0,1,23,3,1,2083,14801,16884
2015-01-02 00:00:00-05:00,0,1,0,4,0,1970,14005,15975
2015-01-02 01:00:00-05:00,0,1,1,4,0,1683,11610,13293
2015-01-02 02:00:00-05:00,0,1,2,4,0,1450,9388,10838
2015-01-02 03:00:00-05:00,0,1,3,4,0,980,6291,7271
2015-01-02 04:00:00-05:00,0,1,4,4,0,698,4027,4725
2015-01-02 05:00:00-05:00,0,1,5,4,0,549,2905,3454
2015-01-02 06:00:00-05:00,0,1,6,4,0,501,2626,3127
2015-01-02 07:00:00-05:00,0,1,7,4,0,336,2755,3091
2015-01-02 08:00:00-05:00,0,1,8,4,0,439,5811,6250
2015-01-02 09:00:00-05:00,0,1,9,4,0,776,8256,9032
2015-01-02 10:00:00-05:00,0,1,10,4,0,1311,10946,12257
2015-01-02 11:00:00-05:00,0,1,11,4,0,1536,13373,14909
2015-01-02 12:00:00-05:00,0,1,12,4,0,1536,15243,16779
2015-01-02 13:00:00-05:00,0,1,13,4,0,1653,16999,18652
2015-01-02 14:00:00-05:00,0,1,14,4,0,1642,19252,20894
2015-01-02 15:00:00-05:00,0,1,15,4,0,1689,19023,20712
2015-01-02 16:00:00-05:00,0,1,16,4,0,1966,20260,22226
2015-01-02 17:00:00-05:00,0,1,17,4,0,2482,20429,22911
2015-01-02 18:00:00-05:00,0,1,18,4,0,2648,18223,20871
2015-01-02 19:00:00-05:00,0,1,19,4,0,2911,20680,23591
2015-01-02 20:00:00-05:00,0,1,20,4,0,3076,23008,26084
2015-01-02 21:00:00-05:00,0,1,21,4,0,3240,23227,26467
2015-01-02 22:00:00-05:00,0,1,22,4,0,3018,20153,23171
2015-01-02 23:00:00-05:00,0,1,23,4,0,2878,19611,22489
2015-01-03 00:00:00-05:00,0,1,0,5,0,3008,21722,24730
2015-01-03 01:00:00-05:00,0,1,1,5,0,3087,21088,24175
2015-01-03 02:00:00-05:00,0,1,2,5,0,3049,19467,22516
2015-01-03 03:00:00-05:00,0,1,3,5,0,2750,16660,19410
2015-01-03 04:00:00-05:00,0,1,4,5,0,2201,13607,15808
2015-01-03 05:00:00-05:00,0,1,5,5,0,1809,10620,12429
2015-01-03 06:00:00-05:00,0,1,6,5,0,1361,7061,8422
2015-01-03 07:00:00-05:00,0,1,7,5,0,673,3512,4185
2015-01-03 08:00:00-05:00,0,1,8,5,0,464,4120,4584
2015-01-03 09:00:00-05:00,0,1,9,5,0,627,5216,5843
2015-01-03 10:00:00-05:00,0,1,10,5,0,923,7908,8831
2015-01-03 11:00:00-05:00,0,1,11,5,0,1231,11869,13100
2015-01-03 12:00:00-05:00,0.01,1,12,5,0,1507,14975,16482
2015-01-03 13:00:00-05:00,0.02,1,13,5,0,1634,17966,19600
2015-01-03 14:00:00-05:00,0.05,1,14,5,0,1981,21644,23625
2015-01-03 15:00:00-05:00,0.08,1,15,5,0,2424,23718,26142
2015-01-03 16:00:00-05:00,0.05,1,16,5,0,2571,24143,26714
2015-01-03 17:00:00-05:00,0.11,1,17,5,0,2951,23494,26445
2015-01-03 18:00:00-05:00,0.06,1,18,5,0,2971,20350,23321
2015-01-03 19:00:00-05:00,0.09,1,19,5,0,3142,22295,25437
2015-01-03 20:00:00-05:00,0.03,1,20,5,0,3272,25305,28577
2015-01-03 21:00:00-05:00,0.07,1,21,5,0,3490,25667,29157
2015-01-03 22:00:00-05:00,0.05,1,22,5,0,3186,20531,23717
2015-01-03 23:00:00-05:00,0.04,1,23,5,0,3243,21399,24642
2015-01-04 00:00:00-05:00,0.15,1,0,6,0,3147,22409,25556
2015-01-04 01:00:00-05:00,0.02,1,1,6,0,3259,22833,26092
2015-01-04 02:00:00-05:00,0.01,1,2,6,0,3222,20632,23854
2015-01-04 03:00:00-05:00,0.01,1,3,6,0,2660,17494,20154
2015-01-04 04:00:00-05:00,0,1,4,6,0,2099,13485,15584
2015-01-04 05:00:00-05:00,0,1,5,6,0,1629,9842,11471
2015-01-04 06:00:00-05:00,0,1,6,6,0,1294,6384,7678
2015-01-04 07:00:00-05:00,0.04,1,7,6,0,660,3365,4025
2015-01-04 08:00:00-05:00,0,1,8,6,0,501,3625,4126
2015-01-04 09:00:00-05:00,0,1,9,6,0,568,4734,5302
2015-01-04 10:00:00-05:00,0,1,10,6,0,702,7070,7772
2015-01-04 11:00:00-05:00,0,1,11,6,0,1043,10153,11196
2015-01-04 12:00:00-05:00,0,1,12,6,0,1343,14304,15647
2015-01-04 13:00:00-05:00,0,1,13,6,0,1517,16325,17842
2015-01-04 14:00:00-05:00,0,1,14,6,0,1697,18101,19798
2015-01-04 15:00:00-05:00,0,1,15,6,0,1835,18639,20474
2015-01-04 16:00:00-05:00,0,1,16,6,0,1992,18722,20714
2015-01-04 17:00:00-05:00,0,1,17,6,0,2138,18234,20372
2015-01-04 18:00:00-05:00,0,1,18,6,0,2262,18056,20318
2015-01-04 19:00:00-05:00,0.01,1,19,6,0,2282,18257,20539
2015-01-04 20:00:00-05:00,0.08,1,20,6,0,2277,18498,20775
2015-01-04 21:00:00-05:00,0,1,21,6,0,2468,18494,20962
2015-01-04 22:00:00-05:00,0,1,22,6,0,2447,17529,19976
2015-01-04 23:00:00-05:00,0,1,23,6,0,1886,14063,15949
2015-01-05 00:00:00-05:00,0,1,0,0,0,1563,12639,14202
2015-01-05 01:00:00-05:00,0,1,1,0,0,1517,10203,11720
2015-01-05 02:00:00-05:00,0,1,2,0,0,1134,7653,8787
2015-01-05 03:00:00-05:00,0,1,3,0,0,764,4685,5449
2015-01-05 04:00:00-05:00,0,1,4,0,0,524,3076,3600
2015-01-05 05:00:00-05:00,0,1,5,0,0,397,2071,2468
2015-01-05 06:00:00-05:00,0,1,6,0,0,457,2310,2767
2015-01-05 07:00:00-05:00,0,1,7,0,0,419,4218,4637
2015-01-05 08:00:00-05:00,0,1,8,0,0,651,11095,11746
2015-01-05 09:00:00-05:00,0,1,9,0,0,1643,18866,20509
2015-01-05 10:00:00-05:00,0,1,10,0,0,2493,22131,24624
2015-01-05 11:00:00-05:00,0,1,11,0,0,2192,19602,21794
2015-01-05 12:00:00-05:00,0,1,12,0,0,1817,16290,18107
2015-01-05 13:00:00-05:00,0,1,13,0,0,1735,16428,18163
2015-01-05 14:00:00-05:00,0,1,14,0,0,1648,17022,18670
2015-01-05 15:00:00-05:00,0,1,15,0,0,1810,17127,18937
2015-01-05 16:00:00-05:00,0,1,16,0,0,1953,18916,20869
2015-01-05 17:00:00-05:00,0,1,17,0,0,2294,19897,22191
2015-01-05 18:00:00-05:00,0,1,18,0,0,2461,17718,20179
2015-01-05 19:00:00-05:00,0,1,19,0,0,2842,21727,24569
2015-01-05 20:00:00-05:00,0,1,20,0,0,3189,26144,29333
2015-01-05 21:00:00-05:00,0,1,21,0,0,3005,25655,28660
2015-01-05 22:00:00-05:00,0,1,22,0,0,2684,22028,24712
2015-01-05 23:00:00-05:00,0,1,23,0,0,2130,19814,21944
2015-01-06 00:00:00-05:00,0,1,0,1,0,2022,16256,18278
2015-01-06 01:00:00-05:00,0,1,1,1,0,1659,12725,14384
2015-01-06 02:00:00-05:00,0,1,2,1,0,1196,8457,9653
2015-01-06 03:00:00-05:00,0,1,3,1,0,708,4968,5676
2015-01-06 04:00:00-05:00,0,1,4,1,0,470,3107,3577
2015-01-06 05:00:00-05:00,0,1,5,1,0,350,1976,2326
2015-01-06 06:00:00-05:00,0,1,6,1,0,391,2159,2550
2015-01-06 07:00:00-05:00,0,1,7,1,0,331,4083,4414
2015-01-06 08:00:00-05:00,0,1,8,1,0,667,11366,12033
2015-01-06 09:00:00-05:00,0.01,1,9,1,0,1562,20044,21606
2015-01-06 10:00:00-05:00,0.03,1,10,1,0,2428,24491,26919
2015-01-06 11:00:00-05:00,0,1,11,1,0,2136,21343,23479
2015-01-06 12:00:00-05:00,0.01,1,12,1,0,1853,17697,19550
2015-01-06 13:00:00-05:00,0,1,13,1,0,1722,17191,18913
2015-01-06 14:00:00-05:00,0,1,14,1,0,1665,17987,19652
2015-01-06 15:00:00-05:00,0,1,15,1,0,1629,17464,19093
2015-01-06 16:00:00-05:00,0,1,16,1,0,1882,19314,21196
2015-01-06 17:00:00-05:00,0,1,17,1,0,2146,19604,21750
2015-01-06 18:00:00-05:00,0,1,18,1,0,2370,17538,19908
2015-01-06 19:00:00-05:00,0,1,19,1,0,2709,21171,23880
2015-01-06 20:00:00-05:00,0,1,20,1,0,3068,26845,29913
2015-01-06 21:00:00-05:00,0,1,21,1,0,2964,26026,28990
2015-01-06 22:00:00-05:00,0,1,22,1,0,2605,24401,27006
2015-01-06 23:00:00-05:00,0,1,23,1,0,2228,23308,25536
2015-01-07 00:00:00-05:00,0,1,0,2,0,1965,19331,21296
2015-01-07 01:00:00-05:00,0,1,1,2,0,1601,14453,16054
2015-01-07 02:00:00-05:00,0,1,2,2,0,1143,9190,10333
2015-01-07 03:00:00-05:00,0,1,3,2,0,755,5580,6335
2015-01-07 04:00:00-05:00,0,1,4,2,0,445,3331,3776
2015-01-07 05:00:00-05:00,0,1,5,2,0,336,2282,2618
2015-01-07 06:00:00-05:00,0,1,6,2,0,331,2296,2627
2015-01-07 07:00:00-05:00,0,1,7,2,0,319,3900,4219
2015-01-07 08:00:00-05:00,0,1,8,2,0,666,11458,12124
2015-01-07 09:00:00-05:00,0,1,9,2,0,1590,20908,22498
2015-01-07 10:00:00-05:00,0,1,10,2,0,2557,25759,28316
2015-01-07 11:00:00-05:00,0,1,11,2,0,2283,23237,25520
2015-01-07 12:00:00-05:00,0,1,12,2,0,1990,19681,21671
2015-01-07 13:00:00-05:00,0,1,13,2,0,1825,19492,21317
2015-01-07 14:00:00-05:00,0,1,14,2,0,1838,20325,22163
2015-01-07 15:00:00-05:00,0,1,15,2,0,1861,20469,22330
2015-01-07 16:00:00-05:00,0,1,16,2,0,2178,21766,23944
2015-01-07 17:00:00-05:00,0,1,17,2,0,2454,21441,23895
2015-01-07 18:00:00-05:00,0,1,18,2,0,2836,19067,21903
2015-01-07 19:00:00-05:00,0,1,19,2,0,3481,23561,27042
2015-01-07 20:00:00-05:00,0,1,20,2,0,3784,29597,33381
2015-01-07 21:00:00-05:00,0,1,21,2,0,3952,30512,34464
2015-01-07 22:00:00-05:00,0,1,22,2,0,3422,27882,31304
2015-01-07 23:00:00-05:00,0,1,23,2,0,2942,27163,30105
2015-01-08 00:00:00-05:00,0,1,0,3,0,2668,24117,26785
2015-01-08 01:00:00-05:00,0,1,1,3,0,2146,16639,18785
2015-01-08 02:00:00-05:00,0,1,2,3,0,1534,10430,11964
2015-01-08 03:00:00-05:00,0,1,3,3,0,930,6034,6964
2015-01-08 04:00:00-05:00,0,1,4,3,0,502,3606,4108
2015-01-08 05:00:00-05:00,0,1,5,3,0,379,2444,2823
2015-01-08 06:00:00-05:00,0,1,6,3,0,342,2266,2608
2015-01-08 07:00:00-05:00,0,1,7,3,0,320,4016,4336
2015-01-08 08:00:00-05:00,0,1,8,3,0,731,12079,12810
2015-01-08 09:00:00-05:00,0,1,9,3,0,1737,22534,24271
2015-01-08 10:00:00-05:00,0,1,10,3,0,2771,27142,29913
2015-01-08 11:00:00-05:00,0,1,11,3,0,2541,24633,27174
2015-01-08 12:00:00-05:00,0,1,12,3,0,2161,21183,23344
2015-01-08 13:00:00-05:00,0,1,13,3,0,1870,20198,22068
2015-01-08 14:00:00-05:00,0,1,14,3,0,1805,20955,22760
2015-01-08 15:00:00-05:00,0,1,15,3,0,1854,20408,22262
2015-01-08 16:00:00-05:00,0,1,16,3,0,2070,22304,24374
2015-01-08 17:00:00-05:00,0,1,17,3,0,2434,22869,25303
2015-01-08 18:00:00-05:00,0,1,18,3,0,2718,19145,21863
2015-01-08 19:00:00-05:00,0,1,19,3,0,3247,23738,26985
2015-01-08 20:00:00-05:00,0,1,20,3,0,3564,29732,33296
2015-01-08 21:00:00-05:00,0,1,21,3,0,3635,30515,34150
2015-01-08 22:00:00-05:00,0,1,22,3,0,3058,28953,32011
2015-01-08 23:00:00-05:00,0,1,23,3,0,2826,28159,30985
2015-01-09 00:00:00-05:00,0,1,0,4,0,2558,26724,29282
2015-01-09 01:00:00-05:00,0,1,1,4,0,2204,20853,23057
2015-01-09 02:00:00-05:00,0,1,2,4,0,1734,13948,15682
2015-01-09 03:00:00-05:00,0,1,3,4,0,1104,8392,9496
2015-01-09 04:00:00-05:00,0,1,4,4,0,764,5515,6279
2015-01-09 05:00:00-05:00,0,1,5,4,0,569,3713,4282
2015-01-09 06:00:00-05:00,0,1,6,4,0,483,3028,3511
2015-01-09 07:00:00-05:00,0.03,1,7,4,0,412,4201,4613
2015-01-09 08:00:00-05:00,0.03,1,8,4,0,697,11302,11999
2015-01-09 09:00:00-05:00,0,1,9,4,0,1320,18011,19331
2015-01-09 10:00:00-05:00,0,1,10,4,0,1970,18895,20865
2015-01-09 11:00:00-05:00,0,1,11,4,0,2089,20194,22283
2015-01-09 12:00:00-05:00,0,1,12,4,0,1957,19100,21057
2015-01-09 13:00:00-05:00,0,1,13,4,0,1745,18731,20476
2015-01-09 14:00:00-05:00,0,1,14,4,0,1694,19817,21511
2015-01-09 15:00:00-05:00,0,1,15,4,0,1717,19811,21528
2015-01-09 16:00:00-05:00,0,1,16,4,0,2021,21706,23727
2015-01-09 17:00:00-05:00,0,1,17,4,0,2563,21485,24048
2015-01-09 18:00:00-05:00,0,1,18,4,0,2847,18628,21475
2015-01-09 19:00:00-05:00,0,1,19,4,0,3282,24055,27337
2015-01-09 20:00:00-05:00,0,1,20,4,0,3965,30655,34620
2015-01-09 21:00:00-05:00,0,1,21,4,0,4512,32571,37083
2015-01-09 22:00:00-05:00,0,1,22,4,0,4393,29015,33408
2015-01-09 23:00:00-05:00,0,1,23,4,0,3827,27733,31560
2015-01-10 00:00:00-05:00,0,1,0,5,0,3888,28687,32575
2015-01-10 01:00:00-05:00,0,1,1,5,0,4038,28754,32792
2015-01-10 02:00:00-05:00,0,1,2,5,0,3650,26586,30236
2015-01-10 03:00:00-05:00,0,1,3,5,0,3405,21782,25187
2015-01-10 04:00:00-05:00,0,1,4,5,0,2639,17535,20174
2015-01-10 05:00:00-05:00,0,1,5,5,0,2131,12487,14618
2015-01-10 06:00:00-05:00,0,1,6,5,0,1569,7673,9242
2015-01-10 07:00:00-05:00,0,1,7,5,0,759,3856,4615
2015-01-10 08:00:00-05:00,0,1,8,5,0,547,4797,5344
2015-01-10 09:00:00-05:00,0,1,9,5,0,746,7676,8422
2015-01-10 10:00:00-05:00,0,1,10,5,0,1088,11425,12513
2015-01-10 11:00:00-05:00,0,1,11,5,0,1547,17546,19093
2015-01-10 12:00:00-05:00,0,1,12,5,0,1871,20906,22777
2015-01-10 13:00:00-05:00,0,1,13,5,0,2075,24645,26720
2015-01-10 14:00:00-05:00,0,1,14,5,0,2171,26936,29107
2015-01-10 15:00:00-05:00,0,1,15,5,0,2404,26292,28696
2015-01-10 16:00:00-05:00,0,1,16,5,0,2623,25200,27823
2015-01-10 17:00:00-05:00,0,1,17,5,0,2884,27145,30029
2015-01-10 18:00:00-05:00,0,1,18,5,0,3370,24870,28240
2015-01-10 19:00:00-05:00,0,1,19,5,0,3459,26401,29860
2015-01-10 20:00:00-05:00,0,1,20,5,0,3835,30966,34801
2015-01-10 21:00:00-05:00,0,1,21,5,0,4119,31396,35515
2015-01-10 22:00:00-05:00,0,1,22,5,0,4372,29979,34351
2015-01-10 23:00:00-05:00,0,1,23,5,0,4169,27413,31582
2015-01-11 00:00:00-05:00,0,1,0,6,0,4294,30186,34480
2015-01-11 01:00:00-05:00,0,1,1,6,0,4613,31842,36455
2015-01-11 02:00:00-05:00,0,1,2,6,0,4385,28873,33258
2015-01-11 03:00:00-05:00,0,1,3,6,0,3842,24937,28779
2015-01-11 04:00:00-05:00,0,1,4,6,0,3154,20440,23594
2015-01-11 05:00:00-05:00,0,1,5,6,0,2557,15274,17831
2015-01-11 06:00:00-05:00,0,1,6,6,0,1783,8943,10726
2015-01-11 07:00:00-05:00,0,1,7,6,0,846,4036,4882
2015-01-11 08:00:00-05:00,0,1,8,6,0,566,4174,4740
2015-01-11 09:00:00-05:00,0,1,9,6,0,577,5816,6393
2015-01-11 10:00:00-05:00,0,1,10,6,0,721,9165,9886
2015-01-11 11:00:00-05:00,0,1,11,6,0,1111,13808,14919
2015-01-11 12:00:00-05:00,0,1,12,6,0,1494,18480,19974
2015-01-11 13:00:00-05:00,0,1,13,6,0,1778,22110,23888
2015-01-11 14:00:00-05:00,0,1,14,6,0,1911,24286,26197
2015-01-11 15:00:00-05:00,0,1,15,6,0,2272,24336,26608
2015-01-11 16:00:00-05:00,0,1,16,6,0,2291,22636,24927
2015-01-11 17:00:00-05:00,0,1,17,6,0,2425,21937,24362
2015-01-11 18:00:00-05:00,0,1,18,6,0,2657,22216,24873
2015-01-11 19:00:00-05:00,0,1,19,6,0,2665,23176,25841
2015-01-11 20:00:00-05:00,0,1,20,6,0,2694,22971,25665
2015-01-11 21:00:00-05:00,0,1,21,6,0,2610,21060,23670
2015-01-11 22:00:00-05:00,0,1,22,6,0,2363,17356,19719
2015-01-11 23:00:00-05:00,0,1,23,6,0,2058,16315,18373
2015-01-12 00:00:00-05:00,0,1,0,0,0,1847,14489,16336
2015-01-12 01:00:00-05:00,0,1,1,0,0,1752,12795,14547
2015-01-12 02:00:00-05:00,0,1,2,0,0,1173,7691,8864
2015-01-12 03:00:00-05:00,0,1,3,0,0,792,4265,5057
2015-01-12 04:00:00-05:00,0,1,4,0,0,537,3040,3577
2015-01-12 05:00:00-05:00,0,1,5,0,0,443,2295,2738
2015-01-12 06:00:00-05:00,0,1,6,0,0,486,2319,2805
2015-01-12 07:00:00-05:00,0,1,7,0,0,424,4281,4705
2015-01-12 08:00:00-05:00,0.01,1,8,0,0,720,11556,12276
2015-01-12 09:00:00-05:00,0.04,1,9,0,0,1693,20218,21911
2015-01-12 10:00:00-05:00,0.04,1,10,0,0,2583,24227,26810
2015-01-12 11:00:00-05:00,0.04,1,11,0,0,2412,22719,25131
2015-01-12 12:00:00-05:00,0.07,1,12,0,0,2045,19871,21916
2015-01-12 13:00:00-05:00,0.07,1,13,0,0,1823,19553,21376
2015-01-12 14:00:00-05:00,0.06,1,14,0,0,1789,20790,22579
2015-01-12 15:00:00-05:00,0.07,1,15,0,0,1843,20182,22025
2015-01-12 16:00:00-05:00,0,1,16,0,0,2246,21747,23993
2015-01-12 17:00:00-05:00,0,1,17,0,0,2324,21430,23754
2015-01-12 18:00:00-05:00,0,1,18,0,0,2380,18041,20421
2015-01-12 19:00:00-05:00,0,1,19,0,0,2458,21610,24068
2015-01-12 20:00:00-05:00,0,1,20,0,0,2740,26327,29067
2015-01-12 21:00:00-05:00,0,1,21,0,0,2545,25520,28065
2015-01-12 22:00:00-05:00,0,1,22,0,0,2188,23628,25816
2015-01-12 23:00:00-05:00,0,1,23,0,0,1961,22215,24176
2015-01-13 00:00:00-05:00,0,1,0,1,0,1791,19296,21087
2015-01-13 01:00:00-05:00,0,1,1,1,0,1471,13546,15017
2015-01-13 02:00:00-05:00,0,1,2,1,0,1311,11061,12372
2015-01-13 03:00:00-05:00,0,1,3,1,0,932,5511,6443
2015-01-13 04:00:00-05:00,0,1,4,1,0,510,3448,3958
2015-01-13 05:00:00-05:00,0,1,5,1,0,359,2160,2519
2015-01-13 06:00:00-05:00,0,1,6,1,0,396,2251,2647
2015-01-13 07:00:00-05:00,0,1,7,1,0,361,4113,4474
2015-01-13 08:00:00-05:00,0,1,8,1,0,642,11627,12269
2015-01-13 09:00:00-05:00,0,1,9,1,0,1583,21863,23446
2015-01-13 10:00:00-05:00,0,1,10,1,0,2491,26062,28553
2015-01-13 11:00:00-05:00,0,1,11,1,0,2230,24479,26709
2015-01-13 12:00:00-05:00,0,1,12,1,0,2059,21986,24045
2015-01-13 13:00:00-05:00,0,1,13,1,0,1846,22052,23898
2015-01-13 14:00:00-05:00,0,1,14,1,0,1800,22747,24547
2015-01-13 15:00:00-05:00,0,1,15,1,0,1820,21910,23730
2015-01-13 16:00:00-05:00,0,1,16,1,0,2109,24020,26129
2015-01-13 17:00:00-05:00,0,1,17,1,0,2369,23270,25639
2015-01-13 18:00:00-05:00,0,1,18,1,0,2592,18907,21499
2015-01-13 19:00:00-05:00,0,1,19,1,0,2993,22734,25727
2015-01-13 20:00:00-05:00,0,1,20,1,0,3424,28884,32308
2015-01-13 21:00:00-05:00,0,1,21,1,0,3271,29790,33061
2015-01-13 22:00:00-05:00,0,1,22,1,0,2952,29236,32188
2015-01-13 23:00:00-05:00,0,1,23,1,0,2724,28619,31343
2015-01-14 00:00:00-05:00,0,1,0,2,0,2440,24574,27014
2015-01-14 01:00:00-05:00,0,1,1,2,0,2015,17213,19228
2015-01-14 02:00:00-05:00,0,1,2,2,0,1471,11076,12547
2015-01-14 03:00:00-05:00,0,1,3,2,0,981,6499,7480
2015-01-14 04:00:00-05:00,0,1,4,2,0,576,4133,4709
2015-01-14 05:00:00-05:00,0,1,5,2,0,379,2973,3352
2015-01-14 06:00:00-05:00,0,1,6,2,0,407,2739,3146
2015-01-14 07:00:00-05:00,0,1,7,2,0,374,4486,4860
2015-01-14 08:00:00-05:00,0,1,8,2,0,669,12082,12751
2015-01-14 09:00:00-05:00,0,1,9,2,0,1618,22311,23929
2015-01-14 10:00:00-05:00,0,1,10,2,0,2609,26221,28830
2015-01-14 11:00:00-05:00,0,1,11,2,0,2453,24625,27078
2015-01-14 12:00:00-05:00,0,1,12,2,0,1944,21281,23225
2015-01-14 13:00:00-05:00,0,1,13,2,0,1785,21003,22788
2015-01-14 14:00:00-05:00,0,1,14,2,0,1717,21599,23316
2015-01-14 15:00:00-05:00,0,1,15,2,0,1763,21099,22862
2015-01-14 16:00:00-05:00,0,1,16,2,0,2096,22582,24678
2015-01-14 17:00:00-05:00,0,1,17,2,0,2307,21614,23921
2015-01-14 18:00:00-05:00,0,1,18,2,0,2429,17849,20278
2015-01-14 19:00:00-05:00,0,1,19,2,0,2835,22232,25067
2015-01-14 20:00:00-05:00,0,1,20,2,0,3126,28517,31643
2015-01-14 21:00:00-05:00,0,1,21,2,0,3139,29482,32621
2015-01-14 22:00:00-05:00,0,1,22,2,0,2753,27266,30019
2015-01-14 23:00:00-05:00,0,1,23,2,0,2574,27429,30003
2015-01-15 00:00:00-05:00,0,1,0,3,0,2292,25341,27633
2015-01-15 01:00:00-05:00,0,1,1,3,0,2097,18217,20314
2015-01-15 02:00:00-05:00,0,1,2,3,0,1667,11389,13056
2015-01-15 03:00:00-05:00,0,1,3,3,0,1062,6785,7847
2015-01-15 04:00:00-05:00,0,1,4,3,0,665,4246,4911
2015-01-15 05:00:00-05:00,0,1,5,3,0,508,2901,3409
2015-01-15 06:00:00-05:00,0,1,6,3,0,462,2679,3141
2015-01-15 07:00:00-05:00,0,1,7,3,0,380,4380,4760
2015-01-15 08:00:00-05:00,0,1,8,3,0,705,12016,12721
2015-01-15 09:00:00-05:00,0,1,9,3,0,1681,21875,23556
2015-01-15 10:00:00-05:00,0,1,10,3,0,2618,26056,28674
2015-01-15 11:00:00-05:00,0,1,11,3,0,2374,24517,26891
2015-01-15 12:00:00-05:00,0,1,12,3,0,1985,21128,23113
2015-01-15 13:00:00-05:00,0,1,13,3,0,1794,20268,22062
2015-01-15 14:00:00-05:00,0,1,14,3,0,1787,21440,23227
2015-01-15 15:00:00-05:00,0,1,15,3,0,1912,20628,22540
2015-01-15 16:00:00-05:00,0,1,16,3,0,2096,22373,24469
2015-01-15 17:00:00-05:00,0,1,17,3,0,2416,21715,24131
2015-01-15 18:00:00-05:00,0,1,18,3,0,2640,17706,20346
2015-01-15 19:00:00-05:00,0,1,19,3,0,2986,21760,24746
2015-01-15 20:00:00-05:00,0,1,20,3,0,3397,28060,31457
2015-01-15 21:00:00-05:00,0,1,21,3,0,3486,29867,33353
2015-01-15 22:00:00-05:00,0,1,22,3,0,3089,29081,32170
2015-01-15 23:00:00-05:00,0,1,23,3,0,2908,29105,32013
2015-01-16 00:00:00-05:00,0,1,0,4,0,2815,27978,30793
2015-01-16 01:00:00-05:00,0,1,1,4,0,2529,23233,25762
2015-01-16 02:00:00-05:00,0,1,2,4,0,2222,15958,18180
2015-01-16 03:00:00-05:00,0,1,3,4,0,1598,9830,11428
2015-01-16 04:00:00-05:00,0,1,4,4,0,1199,6769,7968
2015-01-16 05:00:00-05:00,0,1,5,4,0,708,4418,5126
2015-01-16 06:00:00-05:00,0,1,6,4,0,582,3851,4433
2015-01-16 07:00:00-05:00,0,1,7,4,0,441,4765,5206
2015-01-16 08:00:00-05:00,0,1,8,4,0,776,11742,12518
2015-01-16 09:00:00-05:00,0,1,9,4,0,1703,21074,22777
2015-01-16 10:00:00-05:00,0,1,10,4,0,2615,24998,27613
2015-01-16 11:00:00-05:00,0,1,11,4,0,2451,23605,26056
2015-01-16 12:00:00-05:00,0,1,12,4,0,2008,20583,22591
2015-01-16 13:00:00-05:00,0,1,13,4,0,1841,20199,22040
2015-01-16 14:00:00-05:00,0,1,14,4,0,1836,21320,23156
2015-01-16 15:00:00-05:00,0,1,15,4,0,1798,20952,22750
2015-01-16 16:00:00-05:00,0,1,16,4,0,2310,23369,25679
2015-01-16 17:00:00-05:00,0,1,17,4,0,2751,21699,24450
2015-01-16 18:00:00-05:00,0,1,18,4,0,3048,18571,21619
2015-01-16 19:00:00-05:00,0,1,19,4,0,3828,23426,27254
2015-01-16 20:00:00-05:00,0,1,20,4,0,4384,29819,34203
2015-01-16 21:00:00-05:00,0,1,21,4,0,4602,32378,36980
2015-01-16 22:00:00-05:00,0,1,22,4,0,4359,30337,34696
2015-01-16 23:00:00-05:00,0,1,23,4,0,4351,29246,33597
2015-01-17 00:00:00-05:00,0,1,0,5,0,4178,29898,34076
2015-01-17 01:00:00-05:00,0,1,1,5,0,4337,29317,33654
2015-01-17 02:00:00-05:00,0,1,2,5,0,4020,26846,30866
2015-01-17 03:00:00-05:00,0,1,3,5,0,3646,21792,25438
2015-01-17 04:00:00-05:00,0,1,4,5,0,2798,17353,20151
2015-01-17 05:00:00-05:00,0,1,5,5,0,2199,12807,15006
2015-01-17 06:00:00-05:00,0,1,6,5,0,1762,8221,9983
2015-01-17 07:00:00-05:00,0,1,7,5,0,822,4113,4935
2015-01-17 08:00:00-05:00,0,1,8,5,0,685,4984,5669
2015-01-17 09:00:00-05:00,0,1,9,5,0,790,6922,7712
2015-01-17 10:00:00-05:00,0,1,10,5,0,1285,11841,13126
2015-01-17 11:00:00-05:00,0,1,11,5,0,1543,16425,17968
2015-01-17 12:00:00-05:00,0,1,12,5,0,1739,19177,20916
2015-01-17 13:00:00-05:00,0,1,13,5,0,2030,21593,23623
2015-01-17 14:00:00-05:00,0,1,14,5,0,2122,23480,25602
2015-01-17 15:00:00-05:00,0,1,15,5,0,2420,23780,26200
2015-01-17 16:00:00-05:00,0,1,16,5,0,2602,22696,25298
2015-01-17 17:00:00-05:00,0,1,17,5,0,2870,24031,26901
2015-01-17 18:00:00-05:00,0,1,18,5,0,3275,22596,25871
2015-01-17 19:00:00-05:00,0,1,19,5,0,3368,24966,28334
2015-01-17 20:00:00-05:00,0,1,20,5,0,3844,28426,32270
2015-01-17 21:00:00-05:00,0,1,21,5,0,4182,29724,33906
2015-01-17 22:00:00-05:00,0,1,22,5,0,3915,24934,28849
2015-01-17 23:00:00-05:00,0,1,23,5,0,4061,24786,28847
2015-01-18 00:00:00-05:00,0,1,0,6,0,4282,27271,31553
2015-01-18 01:00:00-05:00,0,1,1,6,0,4368,28063,32431
2015-01-18 02:00:00-05:00,0,1,2,6,0,4244,27343,31587
2015-01-18 03:00:00-05:00,0,1,3,6,0,3812,23852,27664
2015-01-18 04:00:00-05:00,0,1,4,6,0,3237,20765,24002
2015-01-18 05:00:00-05:00,0,1,5,6,0,2798,15849,18647
2015-01-18 06:00:00-05:00,0,1,6,6,0,2011,9510,11521
2015-01-18 07:00:00-05:00,0.02,1,7,6,0,955,4254,5209
2015-01-18 08:00:00-05:00,0.07,1,8,6,0,652,3930,4582
2015-01-18 09:00:00-05:00,0.08,1,9,6,0,722,5291,6013
2015-01-18 10:00:00-05:00,0.16,1,10,6,0,933,9027,9960
2015-01-18 11:00:00-05:00,0.22,1,11,6,0,1364,13916,15280
2015-01-18 12:00:00-05:00,0.25,1,12,6,0,1840,19858,21698
2015-01-18 13:00:00-05:00,0.21,1,13,6,0,2124,24424,26548
2015-01-18 14:00:00-05:00,0.19,1,14,6,0,2264,25810,28074
2015-01-18 15:00:00-05:00,0.41,1,15,6,0,2526,25864,28390
2015-01-18 16:00:00-05:00,0.17,1,16,6,0,2946,26234,29180
2015-01-18 17:00:00-05:00,0.11,1,17,6,0,3047,24110,27157
2015-01-18 18:00:00-05:00,0.08,1,18,6,0,2805,21062,23867
2015-01-18 19:00:00-05:00,0,1,19,6,0,2720,21010,23730
2015-01-18 20:00:00-05:00,0,1,20,6,0,2955,22489,25444
2015-01-18 21:00:00-05:00,0.01,1,21,6,0,2564,17979,20543
2015-01-18 22:00:00-05:00,0,1,22,6,0,2295,16615,18910
2015-01-18 23:00:00-05:00,0,1,23,6,0,2143,16345,18488
2015-01-19 00:00:00-05:00,0,1,0,0,1,2190,17246,19436
2015-01-19 01:00:00-05:00,0,1,1,0,1,1921,14259,16180
2015-01-19 02:00:00-05:00,0,1,2,0,1,1748,11666,13414
2015-01-19 03:00:00-05:00,0,1,3,0,1,1295,8059,9354
2015-01-19 04:00:00-05:00,0,1,4,0,1,1031,5727,6758
2015-01-19 05:00:00-05:00,0,1,5,0,1,779,4213,4992
2015-01-19 06:00:00-05:00,0,1,6,0,1,759,3441,4200
2015-01-19 07:00:00-05:00,0,1,7,0,1,446,3244,3690
2015-01-19 08:00:00-05:00,0,1,8,0,1,451,5791,6242
2015-01-19 09:00:00-05:00,0,1,9,0,1,674,8057,8731
2015-01-19 10:00:00-05:00,0,1,10,0,1,1058,12431,13489
2015-01-19 11:00:00-05:00,0,1,11,0,1,1369,15188,16557
2015-01-19 12:00:00-05:00,0,1,12,0,1,1338,16571,17909
2015-01-19 13:00:00-05:00,0,1,13,0,1,1468,17906,19374
2015-01-19 14:00:00-05:00,0,1,14,0,1,1571,20083,21654
2015-01-19 15:00:00-05:00,0,1,15,0,1,1752,20754,22506
2015-01-19 16:00:00-05:00,0,1,16,0,1,1770,20986,22756
2015-01-19 17:00:00-05:00,0,1,17,0,1,2029,21220,23249
2015-01-19 18:00:00-05:00,0,1,18,0,1,2117,20083,22200
2015-01-19 19:00:00-05:00,0,1,19,0,1,2219,21172,23391
2015-01-19 20:00:00-05:00,0,1,20,0,1,2431,22960,25391
2015-01-19 21:00:00-05:00,0,1,21,0,1,2392,21171,23563
2015-01-19 22:00:00-05:00,0,1,22,0,1,2102,18406,20508
2015-01-19 23:00:00-05:00,0,1,23,0,1,1940,16928,18868
2015-01-20 00:00:00-05:00,0,1,0,1,0,1642,15598,17240
2015-01-20 01:00:00-05:00,0,1,1,1,0,1396,11140,12536
2015-01-20 02:00:00-05:00,0,1,2,1,0,1056,7244,8300
2015-01-20 03:00:00-05:00,0,1,3,1,0,710,4297,5007
2015-01-20 04:00:00-05:00,0,1,4,1,0,461,2853,3314
2015-01-20 05:00:00-05:00,0,1,5,1,0,360,1866,2226
2015-01-20 06:00:00-05:00,0,1,6,1,0,379,2101,2480
2015-01-20 07:00:00-05:00,0,1,7,1,0,379,4390,4769
2015-01-20 08:00:00-05:00,0,1,8,1,0,708,11891,12599
2015-01-20 09:00:00-05:00,0,1,9,1,0,1647,21001,22648
2015-01-20 10:00:00-05:00,0,1,10,1,0,2472,24793,27265
2015-01-20 11:00:00-05:00,0,1,11,1,0,2349,23165,25514
2015-01-20 12:00:00-05:00,0,1,12,1,0,1885,19726,21611
2015-01-20 13:00:00-05:00,0,1,13,1,0,1707,19049,20756
2015-01-20 14:00:00-05:00,0,1,14,1,0,1662,19410,21072
2015-01-20 15:00:00-05:00,0,1,15,1,0,1745,19185,20930
2015-01-20 16:00:00-05:00,0,1,16,1,0,1986,20743,22729
2015-01-20 17:00:00-05:00,0,1,17,1,0,2100,20649,22749
2015-01-20 18:00:00-05:00,0,1,18,1,0,2433,18008,20441
2015-01-20 19:00:00-05:00,0,1,19,1,0,2610,21937,24547
2015-01-20 20:00:00-05:00,0,1,20,1,0,2938,27844,30782
2015-01-20 21:00:00-05:00,0,1,21,1,0,2812,26837,29649
2015-01-20 22:00:00-05:00,0,1,22,1,0,2500,25740,28240
2015-01-20 23:00:00-05:00,0,1,23,1,0,2313,25535,27848
2015-01-21 00:00:00-05:00,0,1,0,2,0,2046,22121,24167
2015-01-21 01:00:00-05:00,0,1,1,2,0,1656,15196,16852
2015-01-21 02:00:00-05:00,0,1,2,2,0,1196,9391,10587
2015-01-21 04:00:00-05:00,0,1,4,2,0,849,5787,6636
2015-01-21 05:00:00-05:00,0,1,5,2,0,542,3709,4251
2015-01-21 06:00:00-05:00,0,1,6,2,0,423,2455,2878
2015-01-21 07:00:00-05:00,0,1,7,2,0,391,2449,2840
2015-01-21 08:00:00-05:00,0,1,8,2,0,337,4169,4506
2015-01-21 09:00:00-05:00,0,1,9,2,0,646,11648,12294
2015-01-21 10:00:00-05:00,0,1,10,2,0,1634,21689,23323
2015-01-21 11:00:00-05:00,0,1,11,2,0,2558,25826,28384
2015-01-21 12:00:00-05:00,0,1,12,2,0,2378,23812,26190
2015-01-21 13:00:00-05:00,0,1,13,2,0,1933,21294,23227
2015-01-21 14:00:00-05:00,0,1,14,2,0,1794,19990,21784
2015-01-21 15:00:00-05:00,0,1,15,2,0,1706,20746,22452
2015-01-21 16:00:00-05:00,0,1,16,2,0,1747,20266,22013
2015-01-21 17:00:00-05:00,0,1,17,2,0,2116,21839,23955
2015-01-21 18:00:00-05:00,0,1,18,2,0,2259,21244,23503
2015-01-21 19:00:00-05:00,0,1,19,2,0,2525,18323,20848
2015-01-21 20:00:00-05:00,0,1,20,2,0,2838,23083,25921
2015-01-21 21:00:00-05:00,0,1,21,2,0,3126,28955,32081
2015-01-21 22:00:00-05:00,0,1,22,2,0,3072,28853,31925
2015-01-21 23:00:00-05:00,0,1,23,2,0,2778,27153,29931
2015-01-22 00:00:00-05:00,0,1,0,3,0,2376,26976,29352
2015-01-22 01:00:00-05:00,0,1,1,3,0,2243,24628,26871
2015-01-22 02:00:00-05:00,0,1,2,3,0,1809,17201,19010
2015-01-22 03:00:00-05:00,0,1,3,3,0,1380,10893,12273
2015-01-22 04:00:00-05:00,0,1,4,3,0,903,6695,7598
2015-01-22 05:00:00-05:00,0,1,5,3,0,596,3928,4524
2015-01-22 06:00:00-05:00,0,1,6,3,0,425,2833,3258
2015-01-22 07:00:00-05:00,0,1,7,3,0,401,2619,3020
2015-01-22 08:00:00-05:00,0,1,8,3,0,369,4200,4569
2015-01-22 09:00:00-05:00,0,1,9,3,0,720,11772,12492
2015-01-22 10:00:00-05:00,0,1,10,3,0,1706,21815,23521
2015-01-22 11:00:00-05:00,0,1,11,3,0,2617,25822,28439
2015-01-22 12:00:00-05:00,0,1,12,3,0,2389,23540,25929
2015-01-22 13:00:00-05:00,0,1,13,3,0,1974,20477,22451
2015-01-22 14:00:00-05:00,0,1,14,3,0,1831,19934,21765
2015-01-22 15:00:00-05:00,0,1,15,3,0,1768,21144,22912
2015-01-22 16:00:00-05:00,0,1,16,3,0,1828,20134,21962
2015-01-22 17:00:00-05:00,0,1,17,3,0,2025,22035,24060
2015-01-22 18:00:00-05:00,0,1,18,3,0,2244,21806,24050
2015-01-22 19:00:00-05:00,0,1,19,3,0,2544,18509,21053
2015-01-22 20:00:00-05:00,0,1,20,3,0,2846,23047,25893
2015-01-22 21:00:00-05:00,0,1,21,3,0,3326,29374,32700
2015-01-22 22:00:00-05:00,0,1,22,3,0,3377,31034,34411
2015-01-22 23:00:00-05:00,0,1,23,3,0,3094,29083,32177
2015-01-23 00:00:00-05:00,0,1,0,4,0,2893,29764,32657
2015-01-23 01:00:00-05:00,0,1,1,4,0,2721,28102,30823
2015-01-23 02:00:00-05:00,0,1,2,4,0,2283,23548,25831
2015-01-23 03:00:00-05:00,0,1,3,4,0,1839,15769,17608
2015-01-23 04:00:00-05:00,0,1,4,4,0,1398,9955,11353
2015-01-23 05:00:00-05:00,0,1,5,4,0,926,6751,7677
2015-01-23 06:00:00-05:00,0,1,6,4,0,692,4552,5244
2015-01-23 07:00:00-05:00,0,1,7,4,0,565,3687,4252
2015-01-23 08:00:00-05:00,0,1,8,4,0,369,4488,4857
2015-01-23 09:00:00-05:00,0,1,9,4,0,684,11580,12264
2015-01-23 10:00:00-05:00,0,1,10,4,0,1649,21412,23061
2015-01-23 11:00:00-05:00,0,1,11,4,0,2525,25072,27597
2015-01-23 12:00:00-05:00,0,1,12,4,0,2379,23542,25921
2015-01-23 13:00:00-05:00,0,1,13,4,0,2063,20552,22615
2015-01-23 14:00:00-05:00,0,1,14,4,0,1838,20511,22349
2015-01-23 15:00:00-05:00,0,1,15,4,0,1790,21470,23260
2015-01-23 16:00:00-05:00,0,1,16,4,0,1824,21258,23082
2015-01-23 17:00:00-05:00,0,1,17,4,0,2122,23087,25209
2015-01-23 18:00:00-05:00,0,1,18,4,0,2517,21905,24422
2015-01-23 19:00:00-05:00,0,1,19,4,0,2850,18369,21219
2015-01-23 20:00:00-05:00,0,1,20,4,0,3292,23276,26568
2015-01-23 21:00:00-05:00,0,1,21,4,0,3877,29362,33239
2015-01-23 22:00:00-05:00,0,1,22,4,0,4071,31422,35493
2015-01-23 23:00:00-05:00,0,1,23,4,0,3919,28929,32848
2015-01-24 00:00:00-05:00,0,1,0,5,0,3781,27820,31601
2015-01-24 01:00:00-05:00,0.04,1,1,5,0,3806,29128,32934
2015-01-24 02:00:00-05:00,0.19,1,2,5,0,4081,28543,32624
2015-01-24 03:00:00-05:00,0.12,1,3,5,0,4031,26312,30343
2015-01-24 04:00:00-05:00,0.11,1,4,5,0,3527,22178,25705
2015-01-24 05:00:00-05:00,0.11,1,5,5,0,2080,15023,17103
2015-01-24 06:00:00-05:00,0.09,1,6,5,0,1564,11081,12645
2015-01-24 07:00:00-05:00,0.02,1,7,5,0,1258,7181,8439
2015-01-24 08:00:00-05:00,0.02,1,8,5,0,757,3849,4606
2015-01-24 09:00:00-05:00,0.01,1,9,5,0,552,4788,5340
2015-01-24 10:00:00-05:00,0.01,1,10,5,0,698,7021,7719
2015-01-24 11:00:00-05:00,0,1,11,5,0,1015,10719,11734
2015-01-24 12:00:00-05:00,0,1,12,5,0,1404,15620,17024
2015-01-24 13:00:00-05:00,0,1,13,5,0,1710,18411,20121
2015-01-24 14:00:00-05:00,0,1,14,5,0,1938,21346,23284
2015-01-24 15:00:00-05:00,0,1,15,5,0,2029,23235,25264
2015-01-24 16:00:00-05:00,0,1,16,5,0,2166,22863,25029
2015-01-24 17:00:00-05:00,0.01,1,17,5,0,2329,21628,23957
2015-01-24 18:00:00-05:00,0,1,18,5,0,2553,22226,24779
2015-01-24 19:00:00-05:00,0,1,19,5,0,2858,22092,24950
2015-01-24 20:00:00-05:00,0,1,20,5,0,3119,24193,27312
2015-01-24 21:00:00-05:00,0,1,21,5,0,3561,27403,30964
2015-01-24 22:00:00-05:00,0,1,22,5,0,3842,29175,33017
2015-01-24 23:00:00-05:00,0,1,23,5,0,3640,23801,27441
2015-01-25 00:00:00-05:00,0,1,0,6,0,3780,23691,27471
2015-01-25 01:00:00-05:00,0,1,1,6,0,3890,27748,31638
2015-01-25 02:00:00-05:00,0,1,2,6,0,4330,28921,33251
2015-01-25 03:00:00-05:00,0,1,3,6,0,4111,27548,31659
2015-01-25 04:00:00-05:00,0,1,4,6,0,3771,24736,28507
2015-01-25 05:00:00-05:00,0,1,5,6,0,3080,20982,24062
2015-01-25 06:00:00-05:00,0,1,6,6,0,2491,15941,18432
2015-01-25 07:00:00-05:00,0,1,7,6,0,1986,9360,11346
2015-01-25 08:00:00-05:00,0,1,8,6,0,976,4078,5054
2015-01-25 09:00:00-05:00,0,1,9,6,0,653,4205,4858
2015-01-25 10:00:00-05:00,0,1,10,6,0,654,5907,6561
2015-01-25 11:00:00-05:00,0,1,11,6,0,829,8209,9038
2015-01-25 12:00:00-05:00,0,1,12,6,0,1227,12961,14188
2015-01-25 13:00:00-05:00,0,1,13,6,0,1520,17851,19371
2015-01-25 14:00:00-05:00,0,1,14,6,0,1848,20868,22716
2015-01-25 15:00:00-05:00,0,1,15,6,0,1984,22991,24975
2015-01-25 16:00:00-05:00,0,1,16,6,0,2051,23335,25386
2015-01-25 17:00:00-05:00,0,1,17,6,0,2368,22813,25181
2015-01-25 18:00:00-05:00,0,1,18,6,0,2582,21363,23945
2015-01-25 19:00:00-05:00,0,1,19,6,0,2812,20990,23802
2015-01-25 20:00:00-05:00,0,1,20,6,0,2870,21770,24640
2015-01-25 21:00:00-05:00,0,1,21,6,0,3063,22895,25958
2015-01-25 22:00:00-05:00,0,1,22,6,0,2956,20049,23005
2015-01-25 23:00:00-05:00,0,1,23,6,0,2634,17603,20237
2015-01-26 00:00:00-05:00,0,1,0,0,0,2414,16393,18807
2015-01-26 01:00:00-05:00,0,1,1,0,0,2208,13739,15947
2015-01-26 02:00:00-05:00,0,1,2,0,0,1862,10992,12854
2015-01-26 03:00:00-05:00,0,1,3,0,0,1358,7201,8559
2015-01-26 04:00:00-05:00,0,1,4,0,0,942,4433,5375
2015-01-26 05:00:00-05:00,0,1,5,0,0,571,2858,3429
2015-01-26 06:00:00-05:00,0,1,6,0,0,518,2341,2859
2015-01-26 07:00:00-05:00,0,1,7,0,0,604,2695,3299
2015-01-26 08:00:00-05:00,0,1,8,0,0,523,4794,5317
2015-01-26 09:00:00-05:00,0,1,9,0,0,795,11819,12614
2015-01-26 10:00:00-05:00,0,1,10,0,0,1668,20082,21750
2015-01-26 11:00:00-05:00,0,1,11,0,0,2601,23177,25778
2015-01-26 12:00:00-05:00,0,1,12,0,0,2491,20586,23077
2015-01-26 13:00:00-05:00,0.01,1,13,0,0,2158,17156,19314
2015-01-26 14:00:00-05:00,0.04,1,14,0,0,1927,16859,18786
2015-01-26 15:00:00-05:00,0.08,1,15,0,0,1908,17687,19595
2015-01-26 16:00:00-05:00,0.06,1,16,0,0,2066,17905,19971
2015-01-26 17:00:00-05:00,0.01,1,17,0,0,1890,15296,17186
2015-01-26 18:00:00-05:00,0,1,18,0,0,1535,10237,11772
2015-01-26 19:00:00-05:00,0,1,19,0,0,1413,6928,8341
2015-01-26 20:00:00-05:00,0,1,20,0,0,1251,6292,7543
2015-01-26 21:00:00-05:00,0,1,21,0,0,1252,6805,8057
2015-01-26 22:00:00-05:00,0.02,1,22,0,0,952,5537,6489
2015-01-26 23:00:00-05:00,0.02,1,23,0,0,696,4314,5010
2015-01-27 00:00:00-05:00,0.08,1,0,1,0,489,3437,3926
2015-01-27 01:00:00-05:00,0.06,1,1,1,0,219,1519,1738
2015-01-27 02:00:00-05:00,0.03,1,2,1,0,42,297,339
2015-01-27 03:00:00-05:00,0.02,1,3,1,0,14,115,129
2015-01-27 04:00:00-05:00,0.02,1,4,1,0,5,52,57
2015-01-27 05:00:00-05:00,0,1,5,1,0,4,39,43
2015-01-27 06:00:00-05:00,0,1,6,1,0,12,14,26
2015-01-27 07:00:00-05:00,0,1,7,1,0,1,24,25
2015-01-27 08:00:00-05:00,0,1,8,1,0,2,50,52
2015-01-27 09:00:00-05:00,0.01,1,9,1,0,5,145,150
2015-01-27 10:00:00-05:00,0,1,10,1,0,17,374,391
2015-01-27 11:00:00-05:00,0,1,11,1,0,88,1003,1091
2015-01-27 12:00:00-05:00,0,1,12,1,0,236,2279,2515
2015-01-27 13:00:00-05:00,0,1,13,1,0,382,3748,4130
2015-01-27 14:00:00-05:00,0,1,14,1,0,530,4857,5387
2015-01-27 15:00:00-05:00,0,1,15,1,0,627,5798,6425
2015-01-27 16:00:00-05:00,0,1,16,1,0,738,6271,7009
2015-01-27 17:00:00-05:00,0,1,17,1,0,912,7119,8031
2015-01-27 18:00:00-05:00,0,1,18,1,0,1057,8306,9363
2015-01-27 19:00:00-05:00,0,1,19,1,0,1194,9683,10877
2015-01-27 20:00:00-05:00,0,1,20,1,0,1333,12193,13526
2015-01-27 21:00:00-05:00,0,1,21,1,0,1575,14974,16549
2015-01-27 22:00:00-05:00,0,1,22,1,0,1503,13395,14898
2015-01-27 23:00:00-05:00,0,1,23,1,0,1436,12064,13500
2015-01-28 00:00:00-05:00,0,1,0,2,0,1339,12545,13884
2015-01-28 01:00:00-05:00,0,1,1,2,0,1304,11382,12686
2015-01-28 02:00:00-05:00,0,1,2,2,0,1092,9070,10162
2015-01-28 03:00:00-05:00,0,1,3,2,0,813,5491,6304
2015-01-28 04:00:00-05:00,0,1,4,2,0,532,3267,3799
2015-01-28 05:00:00-05:00,0,1,5,2,0,309,2178,2487
2015-01-28 06:00:00-05:00,0,1,6,2,0,252,1518,1770
2015-01-28 07:00:00-05:00,0,1,7,2,0,251,1705,1956
2015-01-28 08:00:00-05:00,0,1,8,2,0,307,3676,3983
2015-01-28 09:00:00-05:00,0,1,9,2,0,710,11160,11870
2015-01-28 10:00:00-05:00,0,1,10,2,0,1728,19889,21617
2015-01-28 11:00:00-05:00,0,1,11,2,0,2689,23070,25759
2015-01-28 12:00:00-05:00,0,1,12,2,0,2376,21000,23376
2015-01-28 13:00:00-05:00,0,1,13,2,0,1964,17453,19417
2015-01-28 14:00:00-05:00,0,1,14,2,0,1739,16929,18668
2015-01-28 15:00:00-05:00,0,1,15,2,0,1687,17196,18883
2015-01-28 16:00:00-05:00,0,1,16,2,0,1785,16989,18774
2015-01-28 17:00:00-05:00,0,1,17,2,0,1926,18450,20376
2015-01-28 18:00:00-05:00,0,1,18,2,0,2239,18891,21130
2015-01-28 19:00:00-05:00,0,1,19,2,0,2466,16780,19246
2015-01-28 20:00:00-05:00,0,1,20,2,0,2800,20853,23653
2015-01-28 21:00:00-05:00,0,1,21,2,0,3208,26448,29656
2015-01-28 22:00:00-05:00,0,1,22,2,0,3241,27252,30493
2015-01-28 23:00:00-05:00,0,1,23,2,0,2964,25293,28257
2015-01-29 00:00:00-05:00,0,1,0,3,0,2473,24635,27108
2015-01-29 01:00:00-05:00,0,1,1,3,0,2187,23451,25638
2015-01-29 02:00:00-05:00,0,1,2,3,0,1862,16618,18480
2015-01-29 03:00:00-05:00,0,1,3,3,0,1426,10608,12034
2015-01-29 04:00:00-05:00,0,1,4,3,0,915,5981,6896
2015-01-29 05:00:00-05:00,0,1,5,3,0,577,3920,4497
2015-01-29 06:00:00-05:00,0,1,6,3,0,379,2685,3064
2015-01-29 07:00:00-05:00,0,1,7,3,0,436,2579,3015
2015-01-29 08:00:00-05:00,0,1,8,3,0,342,4283,4625
2015-01-29 09:00:00-05:00,0,1,9,3,0,781,12121,12902
2015-01-29 10:00:00-05:00,0,1,10,3,0,1718,21535,23253
2015-01-29 11:00:00-05:00,0,1,11,3,0,2586,24504,27090
2015-01-29 12:00:00-05:00,0,1,12,3,0,2460,22595,25055
2015-01-29 13:00:00-05:00,0,1,13,3,0,2068,19828,21896
2015-01-29 14:00:00-05:00,0,1,14,3,0,1887,19009,20896
2015-01-29 15:00:00-05:00,0,1,15,3,0,1870,19940,21810
2015-01-29 16:00:00-05:00,0,1,16,3,0,2008,19710,21718
2015-01-29 17:00:00-05:00,0,1,17,3,0,2201,21245,23446
2015-01-29 18:00:00-05:00,0,1,18,3,0,2536,20932,23468
2015-01-29 19:00:00-05:00,0,1,19,3,0,2786,17403,20189
2015-01-29 20:00:00-05:00,0,1,20,3,0,3118,21413,24531
2015-01-29 21:00:00-05:00,0,1,21,3,0,3361,27437,30798
2015-01-29 22:00:00-05:00,0,1,22,3,0,3386,28562,31948
2015-01-29 23:00:00-05:00,0.01,1,23,3,0,3224,28124,31348
2015-01-30 00:00:00-05:00,0.03,1,0,4,0,2813,28043,30856
2015-01-30 01:00:00-05:00,0.02,1,1,4,0,2614,26452,29066
2015-01-30 02:00:00-05:00,0.01,1,2,4,0,2473,23076,25549
2015-01-30 03:00:00-05:00,0,1,3,4,0,1793,15208,17001
2015-01-30 04:00:00-05:00,0,1,4,4,0,1220,9460,10680
2015-01-30 05:00:00-05:00,0,1,5,4,0,767,6222,6989
2015-01-30 06:00:00-05:00,0,1,6,4,0,568,4155,4723
2015-01-30 07:00:00-05:00,0,1,7,4,0,557,3517,4074
2015-01-30 08:00:00-05:00,0.01,1,8,4,0,418,4541,4959
2015-01-30 09:00:00-05:00,0,1,9,4,0,783,11945,12728
2015-01-30 10:00:00-05:00,0,1,10,4,0,1810,22220,24030
2015-01-30 11:00:00-05:00,0,1,11,4,0,2739,25798,28537
2015-01-30 12:00:00-05:00,0,1,12,4,0,2640,23722,26362
2015-01-30 13:00:00-05:00,0,1,13,4,0,2289,20829,23118
2015-01-30 14:00:00-05:00,0,1,14,4,0,2123,20868,22991
2015-01-30 15:00:00-05:00,0,1,15,4,0,2027,20665,22692
2015-01-30 16:00:00-05:00,0,1,16,4,0,1983,21060,23043
2015-01-30 17:00:00-05:00,0,1,17,4,0,2358,22605,24963
2015-01-30 18:00:00-05:00,0,1,18,4,0,2850,21340,24190
2015-01-30 19:00:00-05:00,0,1,19,4,0,3311,18463,21774
2015-01-30 20:00:00-05:00,0,1,20,4,0,3927,23457,27384
2015-01-30 21:00:00-05:00,0,1,21,4,0,4639,30001,34640
2015-01-30 22:00:00-05:00,0,1,22,4,0,4990,33159,38149
2015-01-30 23:00:00-05:00,0,1,23,4,0,4854,31946,36800
2015-01-31 00:00:00-05:00,0,1,0,5,0,4819,30811,35630
2015-01-31 01:00:00-05:00,0,1,1,5,0,4703,31060,35763
2015-01-31 02:00:00-05:00,0,1,2,5,0,4776,30328,35104
2015-01-31 03:00:00-05:00,0,1,3,5,0,4318,28225,32543
2015-01-31 04:00:00-05:00,0,1,4,5,0,3748,23181,26929
2015-01-31 05:00:00-05:00,0,1,5,5,0,2969,18392,21361
2015-01-31 06:00:00-05:00,0,1,6,5,0,2353,13565,15918
2015-01-31 07:00:00-05:00,0,1,7,5,0,1751,8516,10267
2015-01-31 08:00:00-05:00,0,1,8,5,0,932,4229,5161
2015-01-31 09:00:00-05:00,0,1,9,5,0,739,5189,5928
2015-01-31 10:00:00-05:00,0,1,10,5,0,988,7499,8487
2015-01-31 11:00:00-05:00,0,1,11,5,0,1444,12428,13872
2015-01-31 12:00:00-05:00,0,1,12,5,0,1904,19003,20907
2015-01-31 13:00:00-05:00,0,1,13,5,0,2255,22230,24485
2015-01-31 14:00:00-05:00,0,1,14,5,0,2348,25331,27679
2015-01-31 15:00:00-05:00,0,1,15,5,0,2423,27021,29444
2015-01-31 16:00:00-05:00,0,1,16,5,0,2693,26707,29400
2015-01-31 17:00:00-05:00,0,1,17,5,0,2856,25059,27915
2015-01-31 18:00:00-05:00,0,1,18,5,0,3115,25886,29001
2015-01-31 19:00:00-05:00,0,1,19,5,0,3419,23822,27241
2015-01-31 20:00:00-05:00,0,1,20,5,0,3745,25794,29539
2015-01-31 21:00:00-05:00,0,1,21,5,0,4254,30804,35058
2015-01-31 22:00:00-05:00,0,1,22,5,0,4563,32436,36999
2015-01-31 23:00:00-05:00,0,1,23,5,0,4333,27555,31888
2015-02-01 00:00:00-05:00,0,2,0,6,0,4457,27477,31934
2015-02-01 01:00:00-05:00,0,2,1,6,0,4527,29862,34389
2015-02-01 02:00:00-05:00,0,2,2,6,0,4663,29856,34519
2015-02-01 03:00:00-05:00,0,2,3,6,0,4475,28739,33214
2015-02-01 04:00:00-05:00,0,2,4,6,0,3881,25245,29126
2015-02-01 05:00:00-05:00,0,2,5,6,0,3272,21251,24523
2015-02-01 06:00:00-05:00,0,2,6,6,0,2663,15702,18365
2015-02-01 07:00:00-05:00,0,2,7,6,0,1957,9596,11553
2015-02-01 08:00:00-05:00,0,2,8,6,0,917,4077,4994
2015-02-01 09:00:00-05:00,0,2,9,6,0,629,4249,4878
2015-02-01 10:00:00-05:00,0,2,10,6,0,657,5443,6100
2015-02-01 11:00:00-05:00,0,2,11,6,0,853,9574,10427
2015-02-01 12:00:00-05:00,0,2,12,6,0,1288,13453,14741
2015-02-01 13:00:00-05:00,0,2,13,6,0,1701,17993,19694
2015-02-01 14:00:00-05:00,0,2,14,6,0,1928,20243,22171
2015-02-01 15:00:00-05:00,0,2,15,6,0,2053,22322,24375
2015-02-01 16:00:00-05:00,0,2,16,6,0,2229,22622,24851
2015-02-01 17:00:00-05:00,0,2,17,6,0,2578,22079,24657
2015-02-01 18:00:00-05:00,0,2,18,6,0,2806,21849,24655
2015-02-01 19:00:00-05:00,0,2,19,6,0,3187,22454,25641
2015-02-01 20:00:00-05:00,0,2,20,6,0,3709,26920,30629
2015-02-01 21:00:00-05:00,0,2,21,6,0,3740,25253,28993
2015-02-01 22:00:00-05:00,0.01,2,22,6,0,2763,15251,18014
2015-02-01 23:00:00-05:00,0.01,2,23,6,0,2505,15144,17649
2015-02-02 00:00:00-05:00,0.03,2,0,0,0,2159,14019,16178
2015-02-02 01:00:00-05:00,0.06,2,1,0,0,3445,23381,26826
2015-02-02 02:00:00-05:00,0.1,2,2,0,0,2762,16254,19016
2015-02-02 03:00:00-05:00,0.14,2,3,0,0,1928,9086,11014
2015-02-02 04:00:00-05:00,0.21,2,4,0,0,1092,5179,6271
2015-02-02 05:00:00-05:00,0.13,2,5,0,0,628,3080,3708
2015-02-02 06:00:00-05:00,0.15,2,6,0,0,392,1969,2361
2015-02-02 07:00:00-05:00,0.07,2,7,0,0,360,1922,2282
2015-02-02 08:00:00-05:00,0.03,2,8,0,0,290,3407,3697
2015-02-02 09:00:00-05:00,0.02,2,9,0,0,471,8323,8794
2015-02-02 10:00:00-05:00,0.03,2,10,0,0,1210,15656,16866
2015-02-02 11:00:00-05:00,0.02,2,11,0,0,2041,18875,20916
2015-02-02 12:00:00-05:00,0.01,2,12,0,0,2303,18845,21148
2015-02-02 13:00:00-05:00,0,2,13,0,0,2338,18231,20569
2015-02-02 14:00:00-05:00,0.04,2,14,0,0,2128,17197,19325
2015-02-02 15:00:00-05:00,0.03,2,15,0,0,2129,17271,19400
2015-02-02 16:00:00-05:00,0.01,2,16,0,0,2206,17394,19600
2015-02-02 17:00:00-05:00,0,2,17,0,0,2195,18252,20447
2015-02-02 18:00:00-05:00,0,2,18,0,0,2202,16392,18594
2015-02-02 19:00:00-05:00,0,2,19,0,0,2334,15142,17476
2015-02-02 20:00:00-05:00,0,2,20,0,0,2475,17909,20384
2015-02-02 21:00:00-05:00,0,2,21,0,0,2716,21888,24604
2015-02-02 22:00:00-05:00,0,2,22,0,0,2810,22090,24900
2015-02-02 23:00:00-05:00,0,2,23,0,0,2503,20528,23031
2015-02-03 00:00:00-05:00,0,2,0,1,0,2181,19146,21327
2015-02-03 01:00:00-05:00,0,2,1,1,0,1854,16733,18587
2015-02-03 02:00:00-05:00,0,2,2,1,0,1424,12334,13758
2015-02-03 03:00:00-05:00,0,2,3,1,0,1078,8063,9141
2015-02-03 04:00:00-05:00,0,2,4,1,0,688,4685,5373
2015-02-03 05:00:00-05:00,0,2,5,1,0,419,2860,3279
2015-02-03 06:00:00-05:00,0,2,6,1,0,287,2020,2307
2015-02-03 07:00:00-05:00,0,2,7,1,0,302,2268,2570
2015-02-03 08:00:00-05:00,0,2,8,1,0,313,4453,4766
2015-02-03 09:00:00-05:00,0,2,9,1,0,601,11345,11946
2015-02-03 10:00:00-05:00,0,2,10,1,0,1583,19813,21396
2015-02-03 11:00:00-05:00,0,2,11,1,0,2519,23594,26113
2015-02-03 12:00:00-05:00,0,2,12,1,0,2764,23695,26459
2015-02-03 13:00:00-05:00,0,2,13,1,0,2536,22318,24854
2015-02-03 14:00:00-05:00,0,2,14,1,0,2241,21478,23719
2015-02-03 15:00:00-05:00,0,2,15,1,0,2119,20489,22608
2015-02-03 16:00:00-05:00,0,2,16,1,0,2072,20098,22170
2015-02-03 17:00:00-05:00,0,2,17,1,0,2301,21267,23568
2015-02-03 18:00:00-05:00,0,2,18,1,0,2593,21429,24022
2015-02-03 19:00:00-05:00,0,2,19,1,0,2885,17955,20840
2015-02-03 20:00:00-05:00,0,2,20,1,0,3297,22173,25470
2015-02-03 21:00:00-05:00,0,2,21,1,0,3705,27499,31204
2015-02-03 22:00:00-05:00,0,2,22,1,0,3644,27601,31245
2015-02-03 23:00:00-05:00,0,2,23,1,0,3246,27484,30730
2015-02-04 00:00:00-05:00,0,2,0,2,0,2734,26890,29624
2015-02-04 01:00:00-05:00,0,2,1,2,0,2440,23968,26408
2015-02-04 02:00:00-05:00,0,2,2,2,0,1924,17683,19607
2015-02-04 03:00:00-05:00,0,2,3,2,0,1355,10345,11700
2015-02-04 04:00:00-05:00,0,2,4,2,0,877,6103,6980
2015-02-04 05:00:00-05:00,0,2,5,2,0,521,3666,4187
2015-02-04 06:00:00-05:00,0,2,6,2,0,379,2570,2949
2015-02-04 07:00:00-05:00,0,2,7,2,0,368,2487,2855
2015-02-04 08:00:00-05:00,0,2,8,2,0,359,4194,4553
2015-02-04 09:00:00-05:00,0,2,9,2,0,694,11987,12681
2015-02-04 10:00:00-05:00,0,2,10,2,0,1723,21600,23323
2015-02-04 11:00:00-05:00,0,2,11,2,0,2491,24988,27479
2015-02-04 12:00:00-05:00,0,2,12,2,0,2483,23603,26086
2015-02-04 13:00:00-05:00,0,2,13,2,0,2131,20634,22765
2015-02-04 14:00:00-05:00,0,2,14,2,0,1998,20265,22263
2015-02-04 15:00:00-05:00,0,2,15,2,0,2054,20523,22577
2015-02-04 16:00:00-05:00,0,2,16,2,0,2089,20612,22701
2015-02-04 17:00:00-05:00,0,2,17,2,0,2340,21279,23619
2015-02-04 18:00:00-05:00,0,2,18,2,0,2571,19306,21877
2015-02-04 19:00:00-05:00,0,2,19,2,0,2794,15106,17900
2015-02-04 20:00:00-05:00,0,2,20,2,0,3100,18797,21897
2015-02-04 21:00:00-05:00,0,2,21,2,0,3488,24072,27560
2015-02-04 22:00:00-05:00,0,2,22,2,0,3416,27116,30532
2015-02-04 23:00:00-05:00,0,2,23,2,0,3164,26619,29783
2015-02-05 00:00:00-05:00,0,2,0,3,0,2686,26408,29094
2015-02-05 01:00:00-05:00,0,2,1,3,0,2314,24696,27010
2015-02-05 02:00:00-05:00,0,2,2,3,0,1973,18648,20621
2015-02-05 03:00:00-05:00,0,2,3,3,0,1417,12095,13512
2015-02-05 04:00:00-05:00,0,2,4,3,0,978,7010,7988
2015-02-05 05:00:00-05:00,0,2,5,3,0,625,4338,4963
2015-02-05 06:00:00-05:00,0,2,6,3,0,375,2880,3255
2015-02-05 07:00:00-05:00,0,2,7,3,0,396,2688,3084
2015-02-05 08:00:00-05:00,0,2,8,3,0,373,4438,4811
2015-02-05 09:00:00-05:00,0,2,9,3,0,698,12243,12941
2015-02-05 10:00:00-05:00,0,2,10,3,0,1743,21817,23560
2015-02-05 11:00:00-05:00,0,2,11,3,0,2754,25191,27945
2015-02-05 12:00:00-05:00,0,2,12,3,0,2565,23794,26359
2015-02-05 13:00:00-05:00,0,2,13,3,0,2284,21176,23460
2015-02-05 14:00:00-05:00,0,2,14,3,0,2155,20959,23114
2015-02-05 15:00:00-05:00,0,2,15,3,0,2055,21696,23751
2015-02-05 16:00:00-05:00,0,2,16,3,0,2032,21259,23291
2015-02-05 17:00:00-05:00,0,2,17,3,0,2507,22809,25316
2015-02-05 18:00:00-05:00,0,2,18,3,0,2686,22037,24723
2015-02-05 19:00:00-05:00,0,2,19,3,0,3073,17745,20818
2015-02-05 20:00:00-05:00,0,2,20,3,0,3649,22204,25853
2015-02-05 21:00:00-05:00,0,2,21,3,0,4354,28861,33215
2015-02-05 22:00:00-05:00,0,2,22,3,0,4392,30824,35216
2015-02-05 23:00:00-05:00,0,2,23,3,0,4240,30953,35193
2015-02-06 00:00:00-05:00,0,2,0,4,0,3691,30614,34305
2015-02-06 01:00:00-05:00,0,2,1,4,0,3290,28111,31401
2015-02-06 02:00:00-05:00,0,2,2,4,0,2676,23975,26651
2015-02-06 03:00:00-05:00,0,2,3,4,0,2040,16156,18196
2015-02-06 04:00:00-05:00,0,2,4,4,0,1351,9815,11166
2015-02-06 05:00:00-05:00,0,2,5,4,0,1001,6444,7445
2015-02-06 06:00:00-05:00,0,2,6,4,0,731,4262,4993
2015-02-06 07:00:00-05:00,0,2,7,4,0,588,3568,4156
2015-02-06 08:00:00-05:00,0,2,8,4,0,449,4772,5221
2015-02-06 09:00:00-05:00,0,2,9,4,0,789,12579,13368
2015-02-06 10:00:00-05:00,0,2,10,4,0,1848,22309,24157
2015-02-06 11:00:00-05:00,0,2,11,4,0,2664,25275,27939
2015-02-06 12:00:00-05:00,0,2,12,4,0,2581,23995,26576
2015-02-06 13:00:00-05:00,0,2,13,4,0,2162,21595,23757
2015-02-06 14:00:00-05:00,0,2,14,4,0,2199,22037,24236
2015-02-06 15:00:00-05:00,0,2,15,4,0,2137,22136,24273
2015-02-06 16:00:00-05:00,0,2,16,4,0,2063,21944,24007
2015-02-06 17:00:00-05:00,0,2,17,4,0,2583,23071,25654
2015-02-06 18:00:00-05:00,0,2,18,4,0,2833,21102,23935
2015-02-06 19:00:00-05:00,0,2,19,4,0,3463,17534,20997
2015-02-06 20:00:00-05:00,0,2,20,4,0,3839,22635,26474
2015-02-06 21:00:00-05:00,0,2,21,4,0,4674,28969,33643
2015-02-06 22:00:00-05:00,0,2,22,4,0,4868,31151,36019
2015-02-06 23:00:00-05:00,0,2,23,4,0,4570,29768,34338
2015-02-07 00:00:00-05:00,0,2,0,5,0,4323,28665,32988
2015-02-07 01:00:00-05:00,0,2,1,5,0,4196,28797,32993
2015-02-07 02:00:00-05:00,0,2,2,5,0,4183,28416,32599
2015-02-07 03:00:00-05:00,0,2,3,5,0,4054,26197,30251
2015-02-07 04:00:00-05:00,0,2,4,5,0,3353,21976,25329
2015-02-07 05:00:00-05:00,0,2,5,5,0,2904,17844,20748
2015-02-07 06:00:00-05:00,0,2,6,5,0,2160,13208,15368
2015-02-07 07:00:00-05:00,0,2,7,5,0,1618,8372,9990
2015-02-07 08:00:00-05:00,0,2,8,5,0,789,4091,4880
2015-02-07 09:00:00-05:00,0,2,9,5,0,676,5006,5682
2015-02-07 10:00:00-05:00,0,2,10,5,0,924,7283,8207
2015-02-07 11:00:00-05:00,0,2,11,5,0,1355,11647,13002
2015-02-07 12:00:00-05:00,0.01,2,12,5,0,1784,16801,18585
2015-02-07 13:00:00-05:00,0,2,13,5,0,1961,20329,22290
2015-02-07 14:00:00-05:00,0,2,14,5,0,2364,24513,26877
2015-02-07 15:00:00-05:00,0,2,15,5,0,2392,24776,27168
2015-02-07 16:00:00-05:00,0,2,16,5,0,2480,24650,27130
2015-02-07 17:00:00-05:00,0,2,17,5,0,2660,23122,25782
2015-02-07 18:00:00-05:00,0,2,18,5,0,2946,22624,25570
2015-02-07 19:00:00-05:00,0,2,19,5,0,3119,21437,24556
2015-02-07 20:00:00-05:00,0,2,20,5,0,3552,24165,27717
2015-02-07 21:00:00-05:00,0,2,21,5,0,3985,28929,32914
2015-02-07 22:00:00-05:00,0,2,22,5,0,4429,29896,34325
2015-02-07 23:00:00-05:00,0,2,23,5,0,4270,25596,29866
2015-02-08 00:00:00-05:00,0,2,0,6,0,4163,25022,29185
2015-02-08 01:00:00-05:00,0,2,1,6,0,4463,28099,32562
2015-02-08 02:00:00-05:00,0,2,2,6,0,4781,29921,34702
2015-02-08 03:00:00-05:00,0,2,3,6,0,4542,28692,33234
2015-02-08 04:00:00-05:00,0,2,4,6,0,4196,25891,30087
2015-02-08 05:00:00-05:00,0,2,5,6,0,3547,22391,25938
2015-02-08 06:00:00-05:00,0,2,6,6,0,2932,17054,19986
2015-02-08 07:00:00-05:00,0,2,7,6,0,2191,10749,12940
2015-02-08 08:00:00-05:00,0,2,8,6,0,1034,4507,5541
2015-02-08 09:00:00-05:00,0,2,9,6,0,713,4431,5144
2015-02-08 10:00:00-05:00,0,2,10,6,0,701,5122,5823
2015-02-08 11:00:00-05:00,0,2,11,6,0,890,7948,8838
2015-02-08 12:00:00-05:00,0,2,12,6,0,1274,12386,13660
2015-02-08 13:00:00-05:00,0,2,13,6,0,1644,17009,18653
2015-02-08 14:00:00-05:00,0,2,14,6,0,2019,20312,22331
2015-02-08 15:00:00-05:00,0,2,15,6,0,2110,22953,25063
2015-02-08 16:00:00-05:00,0,2,16,6,0,2428,24032,26460
2015-02-08 17:00:00-05:00,0,2,17,6,0,2652,23408,26060
2015-02-08 18:00:00-05:00,0,2,18,6,0,2754,22840,25594
2015-02-08 19:00:00-05:00,0,2,19,6,0,2964,21420,24384
2015-02-08 20:00:00-05:00,0,2,20,6,0,2931,21523,24454
2015-02-08 21:00:00-05:00,0,2,21,6,0,3033,22029,25062
2015-02-08 22:00:00-05:00,0,2,22,6,0,2937,19648,22585
2015-02-08 23:00:00-05:00,0,2,23,6,0,2483,16717,19200
2015-02-09 00:00:00-05:00,0,2,0,0,0,2329,15416,17745
2015-02-09 01:00:00-05:00,0,2,1,0,0,2127,12993,15120
2015-02-09 02:00:00-05:00,0,2,2,0,0,1910,11006,12916
2015-02-09 03:00:00-05:00,0,2,3,0,0,1398,7118,8516
2015-02-09 04:00:00-05:00,0,2,4,0,0,959,4037,4996
2015-02-09 05:00:00-05:00,0,2,5,0,0,599,2764,3363
2015-02-09 06:00:00-05:00,0.03,2,6,0,0,426,1864,2290
2015-02-09 07:00:00-05:00,0.02,2,7,0,0,444,2153,2597
2015-02-09 08:00:00-05:00,0.01,2,8,0,0,382,3972,4354
2015-02-09 09:00:00-05:00,0,2,9,0,0,683,11754,12437
2015-02-09 10:00:00-05:00,0,2,10,0,0,1710,19795,21505
2015-02-09 11:00:00-05:00,0.01,2,11,0,0,2608,22522,25130
2015-02-09 12:00:00-05:00,0,2,12,0,0,2448,21056,23504
2015-02-09 13:00:00-05:00,0,2,13,0,0,2196,18960,21156
2015-02-09 14:00:00-05:00,0,2,14,0,0,1853,17155,19008
2015-02-09 15:00:00-05:00,0,2,15,0,0,1831,18088,19919
2015-02-09 16:00:00-05:00,0,2,16,0,0,1799,17797,19596
2015-02-09 17:00:00-05:00,0,2,17,0,0,2167,19066,21233
2015-02-09 18:00:00-05:00,0,2,18,0,0,2356,19612,21968
2015-02-09 19:00:00-05:00,0,2,19,0,0,2623,18049,20672
2015-02-09 20:00:00-05:00,0,2,20,0,0,2944,21944,24888
2015-02-09 21:00:00-05:00,0,2,21,0,0,3143,26848,29991
2015-02-09 22:00:00-05:00,0,2,22,0,0,2899,26267,29166
2015-02-09 23:00:00-05:00,0,2,23,0,0,2590,24773,27363
2015-02-10 00:00:00-05:00,0,2,0,1,0,2168,23000,25168
2015-02-10 01:00:00-05:00,0,2,1,1,0,1822,19085,20907
2015-02-10 02:00:00-05:00,0,2,2,1,0,1457,13435,14892
2015-02-10 03:00:00-05:00,0,2,3,1,0,1028,8114,9142
2015-02-10 04:00:00-05:00,0,2,4,1,0,723,4613,5336
2015-02-10 05:00:00-05:00,0,2,5,1,0,395,3078,3473
2015-02-10 06:00:00-05:00,0,2,6,1,0,332,2112,2444
2015-02-10 07:00:00-05:00,0,2,7,1,0,358,2215,2573
2015-02-10 08:00:00-05:00,0,2,8,1,0,340,4322,4662
2015-02-10 09:00:00-05:00,0,2,9,1,0,720,12286,13006
2015-02-10 10:00:00-05:00,0,2,10,1,0,1726,21592,23318
2015-02-10 11:00:00-05:00,0,2,11,1,0,2663,25148,27811
2015-02-10 12:00:00-05:00,0,2,12,1,0,2461,23350,25811
2015-02-10 13:00:00-05:00,0,2,13,1,0,2152,20546,22698
2015-02-10 14:00:00-05:00,0,2,14,1,0,1899,19758,21657
2015-02-10 15:00:00-05:00,0,2,15,1,0,1782,20064,21846
2015-02-10 16:00:00-05:00,0,2,16,1,0,1856,19368,21224
2015-02-10 17:00:00-05:00,0,2,17,1,0,2123,20702,22825
2015-02-10 18:00:00-05:00,0,2,18,1,0,2310,20677,22987
2015-02-10 19:00:00-05:00,0,2,19,1,0,2523,18011,20534
2015-02-10 20:00:00-05:00,0,2,20,1,0,2978,22733,25711
2015-02-10 21:00:00-05:00,0,2,21,1,0,3683,28514,32197
2015-02-10 22:00:00-05:00,0,2,22,1,0,3656,28998,32654
2015-02-10 23:00:00-05:00,0,2,23,1,0,3143,28062,31205
2015-02-11 00:00:00-05:00,0,2,0,2,0,2697,27902,30599
2015-02-11 01:00:00-05:00,0,2,1,2,0,2250,24448,26698
2015-02-11 02:00:00-05:00,0,2,2,2,0,1913,17951,19864
2015-02-11 03:00:00-05:00,0,2,3,2,0,1417,10912,12329
2015-02-11 04:00:00-05:00,0,2,4,2,0,932,6209,7141
2015-02-11 05:00:00-05:00,0,2,5,2,0,587,4045,4632
2015-02-11 06:00:00-05:00,0,2,6,2,0,371,2696,3067
2015-02-11 07:00:00-05:00,0,2,7,2,0,391,2527,2918
2015-02-11 08:00:00-05:00,0,2,8,2,0,349,4513,4862
2015-02-11 09:00:00-05:00,0,2,9,2,0,726,12544,13270
2015-02-11 10:00:00-05:00,0,2,10,2,0,1814,22775,24589
2015-02-11 11:00:00-05:00,0,2,11,2,0,2643,25976,28619
2015-02-11 12:00:00-05:00,0,2,12,2,0,2577,24584,27161
2015-02-11 13:00:00-05:00,0,2,13,2,0,2284,21313,23597
2015-02-11 14:00:00-05:00,0,2,14,2,0,2064,21100,23164
2015-02-11 15:00:00-05:00,0,2,15,2,0,1923,21787,23710
2015-02-11 16:00:00-05:00,0,2,16,2,0,2048,20646,22694
2015-02-11 17:00:00-05:00,0,2,17,2,0,2288,22541,24829
2015-02-11 18:00:00-05:00,0,2,18,2,0,2499,21604,24103
2015-02-11 19:00:00-05:00,0,2,19,2,0,2713,17531,20244
2015-02-11 20:00:00-05:00,0,2,20,2,0,3184,21873,25057
2015-02-11 21:00:00-05:00,0,2,21,2,0,3692,27696,31388
2015-02-11 22:00:00-05:00,0,2,22,2,0,3675,29652,33327
2015-02-11 23:00:00-05:00,0,2,23,2,0,3325,28984,32309
2015-02-12 00:00:00-05:00,0,2,0,3,0,2883,28875,31758
2015-02-12 01:00:00-05:00,0,2,1,3,0,2540,26397,28937
2015-02-12 02:00:00-05:00,0,2,2,3,0,2084,20478,22562
2015-02-12 03:00:00-05:00,0,2,3,3,0,1564,12969,14533
2015-02-12 04:00:00-05:00,0,2,4,3,0,1086,7616,8702
2015-02-12 05:00:00-05:00,0,2,5,3,0,619,4824,5443
2015-02-12 06:00:00-05:00,0,2,6,3,0,430,3173,3603
2015-02-12 07:00:00-05:00,0,2,7,3,0,440,2933,3373
2015-02-12 08:00:00-05:00,0,2,8,3,0,384,4404,4788
2015-02-12 09:00:00-05:00,0,2,9,3,0,797,12365,13162
2015-02-12 10:00:00-05:00,0,2,10,3,0,1867,22645,24512
2015-02-12 11:00:00-05:00,0,2,11,3,0,2697,26258,28955
2015-02-12 12:00:00-05:00,0,2,12,3,0,2478,24205,26683
2015-02-12 13:00:00-05:00,0,2,13,3,0,2130,21167,23297
2015-02-12 14:00:00-05:00,0,2,14,3,0,2111,21472,23583
2015-02-12 15:00:00-05:00,0,2,15,3,0,2039,21925,23964
2015-02-12 16:00:00-05:00,0,2,16,3,0,2188,20822,23010
2015-02-12 17:00:00-05:00,0,2,17,3,0,2486,22940,25426
2015-02-12 18:00:00-05:00,0,2,18,3,0,2785,21686,24471
2015-02-12 19:00:00-05:00,0,2,19,3,0,2974,17465,20439
2015-02-12 20:00:00-05:00,0,2,20,3,0,3395,22388,25783
2015-02-12 21:00:00-05:00,0,2,21,3,0,4017,27732,31749
2015-02-12 22:00:00-05:00,0,2,22,3,0,4142,29841,33983
2015-02-12 23:00:00-05:00,0,2,23,3,0,4006,29724,33730
2015-02-13 00:00:00-05:00,0,2,0,4,0,3591,29961,33552
2015-02-13 01:00:00-05:00,0,2,1,4,0,3450,29015,32465
2015-02-13 02:00:00-05:00,0,2,2,4,0,3044,26152,29196
2015-02-13 03:00:00-05:00,0,2,3,4,0,2351,20059,22410
2015-02-13 04:00:00-05:00,0,2,4,4,0,1678,12921,14599
2015-02-13 05:00:00-05:00,0,2,5,4,0,1023,8396,9419
2015-02-13 06:00:00-05:00,0,2,6,4,0,746,5992,6738
2015-02-13 07:00:00-05:00,0,2,7,4,0,608,4608,5216
2015-02-13 08:00:00-05:00,0,2,8,4,0,474,5338,5812
2015-02-13 09:00:00-05:00,0,2,9,4,0,843,13230,14073
2015-02-13 10:00:00-05:00,0,2,10,4,0,2024,23172,25196
2015-02-13 11:00:00-05:00,0,2,11,4,0,3030,26795,29825
2015-02-13 12:00:00-05:00,0,2,12,4,0,2885,26077,28962
2015-02-13 13:00:00-05:00,0,2,13,4,0,2575,23298,25873
2015-02-13 14:00:00-05:00,0,2,14,4,0,2666,23889,26555
2015-02-13 15:00:00-05:00,0,2,15,4,0,2291,22652,24943
2015-02-13 16:00:00-05:00,0,2,16,4,0,2385,22378,24763
2015-02-13 17:00:00-05:00,0,2,17,4,0,2878,23067,25945
2015-02-13 18:00:00-05:00,0,2,18,4,0,3177,20472,23649
2015-02-13 19:00:00-05:00,0,2,19,4,0,3762,16394,20156
2015-02-13 20:00:00-05:00,0,2,20,4,0,4328,20452,24780
2015-02-13 21:00:00-05:00,0,2,21,4,0,4826,25451,30277
2015-02-13 22:00:00-05:00,0,2,22,4,0,5322,28336,33658
2015-02-13 23:00:00-05:00,0,2,23,4,0,5332,28588,33920
2015-02-14 00:00:00-05:00,0,2,0,5,0,5107,28065,33172
2015-02-14 01:00:00-05:00,0,2,1,5,0,4968,28593,33561
2015-02-14 02:00:00-05:00,0,2,2,5,0,4912,28018,32930
2015-02-14 03:00:00-05:00,0,2,3,5,0,4485,26255,30740
2015-02-14 04:00:00-05:00,0,2,4,5,0,3777,22848,26625
2015-02-14 05:00:00-05:00,0,2,5,5,0,3082,18817,21899
2015-02-14 06:00:00-05:00,0,2,6,5,0,2526,15000,17526
2015-02-14 07:00:00-05:00,0,2,7,5,0,1833,9906,11739
2015-02-14 08:00:00-05:00,0,2,8,5,0,929,4846,5775
2015-02-14 09:00:00-05:00,0,2,9,5,0,760,5695,6455
2015-02-14 10:00:00-05:00,0,2,10,5,0,919,8180,9099
2015-02-14 11:00:00-05:00,0,2,11,5,0,1373,12608,13981
2015-02-14 12:00:00-05:00,0,2,12,5,0,1798,17755,19553
2015-02-14 13:00:00-05:00,0,2,13,5,0,2235,21096,23331
2015-02-14 14:00:00-05:00,0,2,14,5,0,2480,24214,26694
2015-02-14 15:00:00-05:00,0,2,15,5,0,2638,25706,28344
2015-02-14 16:00:00-05:00,0,2,16,5,0,2879,26674,29553
2015-02-14 17:00:00-05:00,0.01,2,17,5,0,3245,26212,29457
2015-02-14 18:00:00-05:00,0,2,18,5,0,3777,25220,28997
2015-02-14 19:00:00-05:00,0,2,19,5,0,4136,21339,25475
2015-02-14 20:00:00-05:00,0,2,20,5,0,4268,22905,27173
2015-02-14 21:00:00-05:00,0,2,21,5,0,4865,27614,32479
2015-02-14 22:00:00-05:00,0,2,22,5,0,5049,29082,34131
2015-02-14 23:00:00-05:00,0,2,23,5,0,4911,27106,32017
2015-02-15 00:00:00-05:00,0,2,0,6,0,4826,26540,31366
2015-02-15 01:00:00-05:00,0,2,1,6,0,4711,27867,32578
2015-02-15 02:00:00-05:00,0,2,2,6,0,4924,27912,32836
2015-02-15 03:00:00-05:00,0,2,3,6,0,4516,25499,30015
2015-02-15 04:00:00-05:00,0,2,4,6,0,4017,22523,26540
2015-02-15 05:00:00-05:00,0,2,5,6,0,3447,19548,22995
2015-02-15 06:00:00-05:00,0,2,6,6,0,2801,15832,18633
2015-02-15 07:00:00-05:00,0,2,7,6,0,2071,10106,12177
2015-02-15 08:00:00-05:00,0,2,8,6,0,1037,4742,5779
2015-02-15 09:00:00-05:00,0,2,9,6,0,649,4253,4902
2015-02-15 10:00:00-05:00,0,2,10,6,0,679,5456,6135
2015-02-15 11:00:00-05:00,0,2,11,6,0,925,9277,10202
2015-02-15 12:00:00-05:00,0,2,12,6,0,1346,13356,14702
2015-02-15 13:00:00-05:00,0,2,13,6,0,1741,18637,20378
2015-02-15 14:00:00-05:00,0,2,14,6,0,2002,23086,25088
2015-02-15 15:00:00-05:00,0,2,15,6,0,2357,25937,28294
2015-02-15 16:00:00-05:00,0,2,16,6,0,2586,26499,29085
2015-02-15 17:00:00-05:00,0,2,17,6,0,2870,25841,28711
2015-02-15 18:00:00-05:00,0,2,18,6,0,3061,24756,27817
2015-02-15 19:00:00-05:00,0,2,19,6,0,3389,23175,26564
2015-02-15 20:00:00-05:00,0,2,20,6,0,3626,23539,27165
2015-02-15 21:00:00-05:00,0,2,21,6,0,3902,26115,30017
2015-02-15 22:00:00-05:00,0,2,22,6,0,3960,26006,29966
2015-02-15 23:00:00-05:00,0,2,23,6,0,3715,22641,26356
2015-02-16 00:00:00-05:00,0,2,0,0,1,3468,21774,25242
2015-02-16 01:00:00-05:00,0,2,1,0,1,3132,20888,24020
2015-02-16 02:00:00-05:00,0,2,2,0,1,3065,19608,22673
2015-02-16 03:00:00-05:00,0,2,3,0,1,2375,14578,16953
2015-02-16 04:00:00-05:00,0,2,4,0,1,1621,9825,11446
2015-02-16 05:00:00-05:00,0,2,5,0,1,1032,7063,8095
2015-02-16 06:00:00-05:00,0,2,6,0,1,710,5315,6025
2015-02-16 07:00:00-05:00,0,2,7,0,1,704,4249,4953
2015-02-16 08:00:00-05:00,0,2,8,0,1,530,3905,4435
2015-02-16 09:00:00-05:00,0,2,9,0,1,678,6799,7477
2015-02-16 10:00:00-05:00,0,2,10,0,1,1143,10237,11380
2015-02-16 11:00:00-05:00,0,2,11,0,1,1684,16431,18115
2015-02-16 12:00:00-05:00,0,2,12,0,1,1935,19327,21262
2015-02-16 13:00:00-05:00,0,2,13,0,1,1917,20341,22258
2015-02-16 14:00:00-05:00,0,2,14,0,1,2026,21897,23923
2015-02-16 15:00:00-05:00,0,2,15,0,1,2036,24300,26336
2015-02-16 16:00:00-05:00,0,2,16,0,1,2113,23171,25284
2015-02-16 17:00:00-05:00,0,2,17,0,1,2248,24121,26369
2015-02-16 18:00:00-05:00,0,2,18,0,1,2584,23887,26471
2015-02-16 19:00:00-05:00,0,2,19,0,1,2886,22076,24962
2015-02-16 20:00:00-05:00,0,2,20,0,1,3020,24414,27434
2015-02-16 21:00:00-05:00,0,2,21,0,1,3302,27913,31215
2015-02-16 22:00:00-05:00,0,2,22,0,1,3220,25977,29197
2015-02-16 23:00:00-05:00,0,2,23,0,1,2702,21920,24622
2015-02-17 00:00:00-05:00,0,2,0,1,0,2431,20703,23134
2015-02-17 01:00:00-05:00,0,2,1,1,0,2186,19173,21359
2015-02-17 02:00:00-05:00,0,2,2,1,0,1850,15213,17063
2015-02-17 03:00:00-05:00,0.03,2,3,1,0,1363,9753,11116
2015-02-17 04:00:00-05:00,0.04,2,4,1,0,735,5842,6577
2015-02-17 05:00:00-05:00,0.02,2,5,1,0,495,3769,4264
2015-02-17 06:00:00-05:00,0.02,2,6,1,0,330,2338,2668
2015-02-17 07:00:00-05:00,0.01,2,7,1,0,345,2188,2533
2015-02-17 08:00:00-05:00,0.01,2,8,1,0,247,3439,3686
2015-02-17 09:00:00-05:00,0,2,9,1,0,469,8296,8765
2015-02-17 10:00:00-05:00,0,2,10,1,0,1061,13854,14915
2015-02-17 11:00:00-05:00,0,2,11,1,0,1756,18273,20029
2015-02-17 12:00:00-05:00,0,2,12,1,0,2084,19725,21809
2015-02-17 13:00:00-05:00,0,2,13,1,0,1979,19376,21355
2015-02-17 14:00:00-05:00,0,2,14,1,0,1831,19459,21290
2015-02-17 15:00:00-05:00,0,2,15,1,0,1766,20141,21907
2015-02-17 16:00:00-05:00,0,2,16,1,0,1846,19782,21628
2015-02-17 17:00:00-05:00,0,2,17,1,0,1991,20661,22652
2015-02-17 18:00:00-05:00,0,2,18,1,0,2255,20184,22439
2015-02-17 19:00:00-05:00,0,2,19,1,0,2519,17823,20342
2015-02-17 20:00:00-05:00,0,2,20,1,0,2803,21520,24323
2015-02-17 21:00:00-05:00,0,2,21,1,0,3341,26698,30039
2015-02-17 22:00:00-05:00,0,2,22,1,0,3257,27199,30456
2015-02-17 23:00:00-05:00,0,2,23,1,0,2844,26949,29793
2015-02-18 00:00:00-05:00,0,2,0,2,0,2506,26044,28550
2015-02-18 01:00:00-05:00,0,2,1,2,0,2185,22904,25089
2015-02-18 02:00:00-05:00,0,2,2,2,0,1792,18146,19938
2015-02-18 03:00:00-05:00,0,2,3,2,0,1396,11424,12820
2015-02-18 04:00:00-05:00,0,2,4,2,0,891,6855,7746
2015-02-18 05:00:00-05:00,0,2,5,2,0,620,4317,4937
2015-02-18 06:00:00-05:00,0,2,6,2,0,398,2913,3311
2015-02-18 07:00:00-05:00,0,2,7,2,0,397,2731,3128
2015-02-18 08:00:00-05:00,0,2,8,2,0,378,4241,4619
2015-02-18 09:00:00-05:00,0,2,9,2,0,670,11736,12406
2015-02-18 10:00:00-05:00,0,2,10,2,0,1487,20586,22073
2015-02-18 11:00:00-05:00,0,2,11,2,0,2406,24318,26724
2015-02-18 12:00:00-05:00,0,2,12,2,0,2482,23558,26040
2015-02-18 13:00:00-05:00,0,2,13,2,0,2146,20963,23109
2015-02-18 14:00:00-05:00,0,2,14,2,0,2059,20931,22990
2015-02-18 15:00:00-05:00,0,2,15,2,0,1972,21501,23473
2015-02-18 16:00:00-05:00,0,2,16,2,0,1935,20831,22766
2015-02-18 17:00:00-05:00,0,2,17,2,0,2259,21617,23876
2015-02-18 18:00:00-05:00,0,2,18,2,0,2495,21067,23562
2015-02-18 19:00:00-05:00,0,2,19,2,0,2856,17458,20314
2015-02-18 20:00:00-05:00,0,2,20,2,0,3180,21050,24230
2015-02-18 21:00:00-05:00,0,2,21,2,0,3667,26897,30564
2015-02-18 22:00:00-05:00,0,2,22,2,0,3744,29374,33118
2015-02-18 23:00:00-05:00,0,2,23,2,0,3334,28018,31352
2015-02-19 00:00:00-05:00,0,2,0,3,0,2874,27777,30651
2015-02-19 01:00:00-05:00,0,2,1,3,0,2522,25704,28226
2015-02-19 02:00:00-05:00,0,2,2,3,0,2194,20740,22934
2015-02-19 03:00:00-05:00,0,2,3,3,0,1583,12947,14530
2015-02-19 04:00:00-05:00,0,2,4,3,0,1145,7879,9024
2015-02-19 05:00:00-05:00,0,2,5,3,0,718,4979,5697
2015-02-19 06:00:00-05:00,0,2,6,3,0,521,3341,3862
2015-02-19 07:00:00-05:00,0,2,7,3,0,428,2814,3242
2015-02-19 08:00:00-05:00,0,2,8,3,0,414,4421,4835
2015-02-19 09:00:00-05:00,0,2,9,3,0,702,11925,12627
2015-02-19 10:00:00-05:00,0,2,10,3,0,1563,21423,22986
2015-02-19 11:00:00-05:00,0,2,11,3,0,2563,25634,28197
2015-02-19 12:00:00-05:00,0,2,12,3,0,2758,24655,27413
2015-02-19 13:00:00-05:00,0,2,13,3,0,2527,22520,25047
2015-02-19 14:00:00-05:00,0,2,14,3,0,2359,22651,25010
2015-02-19 15:00:00-05:00,0,2,15,3,0,2276,23290,25566
2015-02-19 16:00:00-05:00,0,2,16,3,0,2295,22839,25134
2015-02-19 17:00:00-05:00,0,2,17,3,0,2464,23718,26182
2015-02-19 18:00:00-05:00,0,2,18,3,0,2932,23074,26006
2015-02-19 19:00:00-05:00,0,2,19,3,0,3312,18909,22221
2015-02-19 20:00:00-05:00,0,2,20,3,0,3903,23505,27408
2015-02-19 21:00:00-05:00,0,2,21,3,0,4554,29128,33682
2015-02-19 22:00:00-05:00,0,2,22,3,0,4813,30894,35707
2015-02-19 23:00:00-05:00,0,2,23,3,0,4437,31635,36072
2015-02-20 00:00:00-05:00,0,2,0,4,0,4072,31196,35268
2015-02-20 01:00:00-05:00,0,2,1,4,0,3670,29379,33049
2015-02-20 02:00:00-05:00,0,2,2,4,0,3121,24922,28043
2015-02-20 03:00:00-05:00,0,2,3,4,0,2223,17193,19416
2015-02-20 04:00:00-05:00,0,2,4,4,0,1569,10434,12003
2015-02-20 05:00:00-05:00,0,2,5,4,0,952,6688,7640
2015-02-20 06:00:00-05:00,0,2,6,4,0,682,4558,5240
2015-02-20 07:00:00-05:00,0,2,7,4,0,570,3729,4299
2015-02-20 08:00:00-05:00,0,2,8,4,0,463,4891,5354
2015-02-20 09:00:00-05:00,0,2,9,4,0,779,12507,13286
2015-02-20 10:00:00-05:00,0,2,10,4,0,1688,22594,24282
2015-02-20 11:00:00-05:00,0,2,11,4,0,2609,26644,29253
2015-02-20 12:00:00-05:00,0,2,12,4,0,2809,25468,28277
2015-02-20 13:00:00-05:00,0,2,13,4,0,2532,23245,25777
2015-02-20 14:00:00-05:00,0,2,14,4,0,2347,23136,25483
2015-02-20 15:00:00-05:00,0,2,15,4,0,2220,23358,25578
2015-02-20 16:00:00-05:00,0,2,16,4,0,2207,22602,24809
2015-02-20 17:00:00-05:00,0,2,17,4,0,2569,24246,26815
2015-02-20 18:00:00-05:00,0,2,18,4,0,2999,22719,25718
2015-02-20 19:00:00-05:00,0,2,19,4,0,3520,18928,22448
2015-02-20 20:00:00-05:00,0,2,20,4,0,4040,24192,28232
2015-02-20 21:00:00-05:00,0,2,21,4,0,4798,30422,35220
2015-02-20 22:00:00-05:00,0,2,22,4,0,5046,32711,37757
2015-02-20 23:00:00-05:00,0,2,23,4,0,4751,31045,35796
2015-02-21 00:00:00-05:00,0,2,0,5,0,4472,29287,33759
2015-02-21 01:00:00-05:00,0,2,1,5,0,4398,29737,34135
2015-02-21 02:00:00-05:00,0,2,2,5,0,4478,28623,33101
2015-02-21 03:00:00-05:00,0,2,3,5,0,4118,26461,30579
2015-02-21 04:00:00-05:00,0,2,4,5,0,3521,21475,24996
2015-02-21 05:00:00-05:00,0,2,5,5,0,2715,17620,20335
2015-02-21 06:00:00-05:00,0,2,6,5,0,2169,12987,15156
2015-02-21 07:00:00-05:00,0,2,7,5,0,1594,8184,9778
2015-02-21 08:00:00-05:00,0,2,8,5,0,769,4062,4831
2015-02-21 09:00:00-05:00,0,2,9,5,0,742,5337,6079
2015-02-21 10:00:00-05:00,0,2,10,5,0,895,7101,7996
2015-02-21 11:00:00-05:00,0,2,11,5,0,1317,11338,12655
2015-02-21 12:00:00-05:00,0,2,12,5,0,1739,16814,18553
2015-02-21 13:00:00-05:00,0,2,13,5,0,2093,20577,22670
2015-02-21 14:00:00-05:00,0.03,2,14,5,0,2424,23549,25973
2015-02-21 15:00:00-05:00,0.05,2,15,5,0,2603,25173,27776
2015-02-21 16:00:00-05:00,0.02,2,16,5,0,2829,27152,29981
2015-02-21 17:00:00-05:00,0.03,2,17,5,0,3184,24883,28067
2015-02-21 18:00:00-05:00,0.04,2,18,5,0,3087,20192,23279
2015-02-21 19:00:00-05:00,0.1,2,19,5,0,3319,17000,20319
2015-02-21 20:00:00-05:00,0.08,2,20,5,0,3418,19768,23186
2015-02-21 21:00:00-05:00,0.09,2,21,5,0,3777,25051,28828
2015-02-21 22:00:00-05:00,0.07,2,22,5,0,3723,25087,28810
2015-02-21 23:00:00-05:00,0.08,2,23,5,0,3351,22121,25472
2015-02-22 00:00:00-05:00,0.03,2,0,6,0,3501,23148,26649
2015-02-22 01:00:00-05:00,0.01,2,1,6,0,3572,24788,28360
2015-02-22 02:00:00-05:00,0.01,2,2,6,0,3676,25429,29105
2015-02-22 03:00:00-05:00,0.01,2,3,6,0,3462,23461,26923
2015-02-22 04:00:00-05:00,0.02,2,4,6,0,3096,20679,23775
2015-02-22 05:00:00-05:00,0.02,2,5,6,0,2678,18142,20820
2015-02-22 06:00:00-05:00,0.02,2,6,6,0,2115,14073,16188
2015-02-22 07:00:00-05:00,0,2,7,6,0,1653,8715,10368
2015-02-22 08:00:00-05:00,0,2,8,6,0,820,3935,4755
2015-02-22 09:00:00-05:00,0,2,9,6,0,540,4338,4878
2015-02-22 10:00:00-05:00,0,2,10,6,0,655,5817,6472
2015-02-22 11:00:00-05:00,0,2,11,6,0,849,9172,10021
2015-02-22 12:00:00-05:00,0,2,12,6,0,1245,13484,14729
2015-02-22 13:00:00-05:00,0,2,13,6,0,1737,18616,20353
2015-02-22 14:00:00-05:00,0,2,14,6,0,2087,22192,24279
2015-02-22 15:00:00-05:00,0,2,15,6,0,2315,23273,25588
2015-02-22 16:00:00-05:00,0,2,16,6,0,2428,22778,25206
2015-02-22 17:00:00-05:00,0,2,17,6,0,2621,22749,25370
2015-02-22 18:00:00-05:00,0,2,18,6,0,2719,21088,23807
2015-02-22 19:00:00-05:00,0,2,19,6,0,2986,19779,22765
2015-02-22 20:00:00-05:00,0,2,20,6,0,3158,21705,24863
2015-02-22 21:00:00-05:00,0,2,21,6,0,3594,24155,27749
2015-02-22 22:00:00-05:00,0,2,22,6,0,3333,22153,25486
2015-02-22 23:00:00-05:00,0,2,23,6,0,2930,16553,19483
2015-02-23 00:00:00-05:00,0,2,0,0,0,2441,14721,17162
2015-02-23 01:00:00-05:00,0,2,1,0,0,2428,15717,18145
2015-02-23 02:00:00-05:00,0,2,2,0,0,1971,11764,13735
2015-02-23 03:00:00-05:00,0,2,3,0,0,2019,13814,15833
2015-02-23 04:00:00-05:00,0,2,4,0,0,1042,4998,6040
2015-02-23 05:00:00-05:00,0,2,5,0,0,653,3185,3838
2015-02-23 06:00:00-05:00,0,2,6,0,0,483,2274,2757
2015-02-23 07:00:00-05:00,0,2,7,0,0,467,2356,2823
2015-02-23 08:00:00-05:00,0,2,8,0,0,382,4626,5008
2015-02-23 09:00:00-05:00,0,2,9,0,0,845,11990,12835
2015-02-23 10:00:00-05:00,0,2,10,0,0,1901,20612,22513
2015-02-23 11:00:00-05:00,0,2,11,0,0,2915,24189,27104
2015-02-23 12:00:00-05:00,0,2,12,0,0,2722,22809,25531
2015-02-23 13:00:00-05:00,0,2,13,0,0,2295,19722,22017
2015-02-23 14:00:00-05:00,0,2,14,0,0,1992,19632,21624
2015-02-23 15:00:00-05:00,0,2,15,0,0,2003,20491,22494
2015-02-23 16:00:00-05:00,0,2,16,0,0,2031,19986,22017
2015-02-23 17:00:00-05:00,0,2,17,0,0,2319,21747,24066
2015-02-23 18:00:00-05:00,0,2,18,0,0,2630,22584,25214
2015-02-23 19:00:00-05:00,0,2,19,0,0,3080,20463,23543
2015-02-23 20:00:00-05:00,0,2,20,0,0,3566,24792,28358
2015-02-23 21:00:00-05:00,0,2,21,0,0,4164,29425,33589
2015-02-23 22:00:00-05:00,0,2,22,0,0,4065,29610,33675
2015-02-23 23:00:00-05:00,0,2,23,0,0,3705,27990,31695
2015-02-24 00:00:00-05:00,0,2,0,1,0,3188,26266,29454
2015-02-24 01:00:00-05:00,0,2,1,1,0,2592,22997,25589
2015-02-24 02:00:00-05:00,0,2,2,1,0,1952,15273,17225
2015-02-24 03:00:00-05:00,0,2,3,1,0,1322,9835,11157
2015-02-24 04:00:00-05:00,0,2,4,1,0,819,5441,6260
2015-02-24 05:00:00-05:00,0,2,5,1,0,484,3311,3795
2015-02-24 06:00:00-05:00,0,2,6,1,0,347,2181,2528
2015-02-24 07:00:00-05:00,0,2,7,1,0,366,2120,2486
2015-02-24 08:00:00-05:00,0,2,8,1,0,358,4313,4671
2015-02-24 09:00:00-05:00,0,2,9,1,0,783,13205,13988
2015-02-24 10:00:00-05:00,0,2,10,1,0,1976,23319,25295
2015-02-24 11:00:00-05:00,0,2,11,1,0,2944,26644,29588
2015-02-24 12:00:00-05:00,0,2,12,1,0,2750,25084,27834
2015-02-24 13:00:00-05:00,0,2,13,1,0,2218,21984,24202
2015-02-24 14:00:00-05:00,0,2,14,1,0,2042,21305,23347
2015-02-24 15:00:00-05:00,0,2,15,1,0,2018,22068,24086
2015-02-24 16:00:00-05:00,0,2,16,1,0,2135,21046,23181
2015-02-24 17:00:00-05:00,0,2,17,1,0,2424,23146,25570
2015-02-24 18:00:00-05:00,0,2,18,1,0,2596,22591,25187
2015-02-24 19:00:00-05:00,0,2,19,1,0,2930,18829,21759
2015-02-24 20:00:00-05:00,0,2,20,1,0,3401,23153,26554
2015-02-24 21:00:00-05:00,0,2,21,1,0,3741,28645,32386
2015-02-24 22:00:00-05:00,0,2,22,1,0,3737,28966,32703
2015-02-24 23:00:00-05:00,0,2,23,1,0,3273,28829,32102
2015-02-25 00:00:00-05:00,0,2,0,2,0,2910,28561,31471
2015-02-25 01:00:00-05:00,0,2,1,2,0,2491,25115,27606
2015-02-25 02:00:00-05:00,0,2,2,2,0,2096,18822,20918
2015-02-25 03:00:00-05:00,0,2,3,2,0,1557,11720,13277
2015-02-25 04:00:00-05:00,0,2,4,2,0,938,6391,7329
2015-02-25 05:00:00-05:00,0,2,5,2,0,581,4101,4682
2015-02-25 06:00:00-05:00,0,2,6,2,0,396,2721,3117
2015-02-25 07:00:00-05:00,0,2,7,2,0,378,2526,2904
2015-02-25 08:00:00-05:00,0,2,8,2,0,368,4409,4777
2015-02-25 09:00:00-05:00,0,2,9,2,0,821,12716,13537
2015-02-25 10:00:00-05:00,0,2,10,2,0,1934,22514,24448
2015-02-25 11:00:00-05:00,0,2,11,2,0,2733,25777,28510
2015-02-25 12:00:00-05:00,0,2,12,2,0,2532,24031,26563
2015-02-25 13:00:00-05:00,0,2,13,2,0,2263,21328,23591
2015-02-25 14:00:00-05:00,0,2,14,2,0,1984,20762,22746
2015-02-25 15:00:00-05:00,0,2,15,2,0,2061,21465,23526
2015-02-25 16:00:00-05:00,0,2,16,2,0,2131,21151,23282
2015-02-25 17:00:00-05:00,0,2,17,2,0,2575,22560,25135
2015-02-25 18:00:00-05:00,0,2,18,2,0,2686,21503,24189
2015-02-25 19:00:00-05:00,0,2,19,2,0,3000,17436,20436
2015-02-25 20:00:00-05:00,0,2,20,2,0,3359,21824,25183
2015-02-25 21:00:00-05:00,0,2,21,2,0,3750,27209,30959
2015-02-25 22:00:00-05:00,0,2,22,2,0,3779,29026,32805
2015-02-25 23:00:00-05:00,0,2,23,2,0,3388,28197,31585
2015-02-26 00:00:00-05:00,0,2,0,3,0,2923,28163,31086
2015-02-26 01:00:00-05:00,0,2,1,3,0,2540,26145,28685
2015-02-26 02:00:00-05:00,0,2,2,3,0,2281,20558,22839
2015-02-26 03:00:00-05:00,0,2,3,3,0,1765,13321,15086
2015-02-26 04:00:00-05:00,0,2,4,3,0,1198,7672,8870
2015-02-26 05:00:00-05:00,0,2,5,3,0,750,4773,5523
2015-02-26 06:00:00-05:00,0,2,6,3,0,466,3223,3689
2015-02-26 07:00:00-05:00,0,2,7,3,0,426,2801,3227
2015-02-26 08:00:00-05:00,0,2,8,3,0,394,4560,4954
2015-02-26 09:00:00-05:00,0,2,9,3,0,867,12901,13768
2015-02-26 10:00:00-05:00,0,2,10,3,0,2104,23333,25437
2015-02-26 11:00:00-05:00,0,2,11,3,0,3010,26604,29614
2015-02-26 12:00:00-05:00,0,2,12,3,0,2838,25160,27998
2015-02-26 13:00:00-05:00,0,2,13,3,0,2487,21886,24373
2015-02-26 14:00:00-05:00,0,2,14,3,0,2226,21592,23818
2015-02-26 15:00:00-05:00,0,2,15,3,0,2140,22459,24599
2015-02-26 16:00:00-05:00,0,2,16,3,0,2160,22901,25061
2015-02-26 17:00:00-05:00,0,2,17,3,0,2532,23575,26107
2015-02-26 18:00:00-05:00,0,2,18,3,0,2867,22219,25086
2015-02-26 19:00:00-05:00,0,2,19,3,0,3215,17847,21062
2015-02-26 20:00:00-05:00,0,2,20,3,0,3708,22633,26341
2015-02-26 21:00:00-05:00,0,2,21,3,0,4131,28161,32292
2015-02-26 22:00:00-05:00,0,2,22,3,0,4172,30389,34561
2015-02-26 23:00:00-05:00,0,2,23,3,0,3892,30419,34311
2015-02-27 00:00:00-05:00,0,2,0,4,0,3468,29840,33308
2015-02-27 01:00:00-05:00,0,2,1,4,0,3180,28184,31364
2015-02-27 02:00:00-05:00,0,2,2,4,0,2721,25279,28000
2015-02-27 03:00:00-05:00,0,2,3,4,0,2173,17371,19544
2015-02-27 04:00:00-05:00,0,2,4,4,0,1521,11160,12681
2015-02-27 05:00:00-05:00,0,2,5,4,0,981,7087,8068
2015-02-27 06:00:00-05:00,0,2,6,4,0,786,4897,5683
2015-02-27 07:00:00-05:00,0,2,7,4,0,612,3925,4537
2015-02-27 08:00:00-05:00,0,2,8,4,0,503,5192,5695
2015-02-27 09:00:00-05:00,0,2,9,4,0,869,12397,13266
2015-02-27 10:00:00-05:00,0,2,10,4,0,1963,22016,23979
2015-02-27 11:00:00-05:00,0,2,11,4,0,2928,25409,28337
2015-02-27 12:00:00-05:00,0,2,12,4,0,2888,24419,27307
2015-02-27 13:00:00-05:00,0,2,13,4,0,2483,21170,23653
2015-02-27 14:00:00-05:00,0,2,14,4,0,2353,21485,23838
2015-02-27 15:00:00-05:00,0,2,15,4,0,2087,22317,24404
2015-02-27 16:00:00-05:00,0,2,16,4,0,2185,21868,24053
2015-02-27 17:00:00-05:00,0,2,17,4,0,2838,23050,25888
2015-02-27 18:00:00-05:00,0,2,18,4,0,3132,21214,24346
2015-02-27 19:00:00-05:00,0,2,19,4,0,3626,17561,21187
2015-02-27 20:00:00-05:00,0,2,20,4,0,4118,22576,26694
2015-02-27 21:00:00-05:00,0,2,21,4,0,5030,28192,33222
2015-02-27 22:00:00-05:00,0,2,22,4,0,5310,31768,37078
2015-02-27 23:00:00-05:00,0,2,23,4,0,5290,30834,36124
2015-02-28 00:00:00-05:00,0,2,0,5,0,5077,30062,35139
2015-02-28 01:00:00-05:00,0,2,1,5,0,4863,31007,35870
2015-02-28 02:00:00-05:00,0,2,2,5,0,4969,30045,35014
2015-02-28 03:00:00-05:00,0,2,3,5,0,4476,27103,31579
2015-02-28 04:00:00-05:00,0,2,4,5,0,3806,22850,26656
2015-02-28 05:00:00-05:00,0,2,5,5,0,3089,18455,21544
2015-02-28 06:00:00-05:00,0,2,6,5,0,2439,13803,16242
2015-02-28 07:00:00-05:00,0,2,7,5,0,1848,8720,10568
2015-02-28 08:00:00-05:00,0,2,8,5,0,920,4452,5372
2015-02-28 09:00:00-05:00,0,2,9,5,0,800,5439,6239
2015-02-28 10:00:00-05:00,0,2,10,5,0,975,7317,8292
2015-02-28 11:00:00-05:00,0,2,11,5,0,1330,11891,13221
2015-02-28 12:00:00-05:00,0,2,12,5,0,1916,17186,19102
2015-02-28 13:00:00-05:00,0,2,13,5,0,2133,20669,22802
2015-02-28 14:00:00-05:00,0,2,14,5,0,2388,23673,26061
2015-02-28 15:00:00-05:00,0,2,15,5,0,2594,25215,27809
2015-02-28 16:00:00-05:00,0,2,16,5,0,2715,25028,27743
2015-02-28 17:00:00-05:00,0,2,17,5,0,3076,24292,27368
2015-02-28 18:00:00-05:00,0,2,18,5,0,3283,24039,27322
2015-02-28 19:00:00-05:00,0,2,19,5,0,3672,21363,25035
2015-02-28 20:00:00-05:00,0,2,20,5,0,4065,23930,27995
2015-02-28 21:00:00-05:00,0,2,21,5,0,4648,29674,34322
2015-02-28 22:00:00-05:00,0,2,22,5,0,5045,31065,36110
2015-02-28 23:00:00-05:00,0,2,23,5,0,5064,27218,32282
2015-03-01 00:00:00-05:00,0,3,0,6,0,5240,26702,31942
2015-03-01 01:00:00-05:00,0,3,1,6,0,5111,29202,34313
2015-03-01 02:00:00-05:00,0,3,2,6,0,5206,30351,35557
2015-03-01 03:00:00-05:00,0,3,3,6,0,4820,28858,33678
2015-03-01 04:00:00-05:00,0,3,4,6,0,4407,25471,29878
2015-03-01 05:00:00-05:00,0,3,5,6,0,3629,21871,25500
2015-03-01 06:00:00-05:00,0,3,6,6,0,2934,16537,19471
2015-03-01 07:00:00-05:00,0,3,7,6,0,2271,10644,12915
2015-03-01 08:00:00-05:00,0,3,8,6,0,1145,4755,5900
2015-03-01 09:00:00-05:00,0,3,9,6,0,747,4782,5529
2015-03-01 10:00:00-05:00,0,3,10,6,0,736,5675,6411
2015-03-01 11:00:00-05:00,0,3,11,6,0,926,8816,9742
2015-03-01 12:00:00-05:00,0,3,12,6,0,1470,13707,15177
2015-03-01 13:00:00-05:00,0.04,3,13,6,0,1808,18406,20214
2015-03-01 14:00:00-05:00,0.06,3,14,6,0,2139,21870,24009
2015-03-01 15:00:00-05:00,0.1,3,15,6,0,2293,24781,27074
2015-03-01 16:00:00-05:00,0.09,3,16,6,0,2693,26039,28732
2015-03-01 17:00:00-05:00,0.06,3,17,6,0,2580,21962,24542
2015-03-01 18:00:00-05:00,0.05,3,18,6,0,2174,16763,18937
2015-03-01 19:00:00-05:00,0.04,3,19,6,0,2101,13833,15934
2015-03-01 20:00:00-05:00,0.04,3,20,6,0,2165,15322,17487
2015-03-01 21:00:00-05:00,0,3,21,6,0,2249,17594,19843
2015-03-01 22:00:00-05:00,0,3,22,6,0,2353,16624,18977
2015-03-01 23:00:00-05:00,0,3,23,6,0,2219,15013,17232
2015-03-02 00:00:00-05:00,0,3,0,0,0,2065,13821,15886
2015-03-02 01:00:00-05:00,0,3,1,0,0,1846,12450,14296
2015-03-02 02:00:00-05:00,0,3,2,0,0,1584,9673,11257
2015-03-02 03:00:00-05:00,0,3,3,0,0,1154,7294,8448
2015-03-02 04:00:00-05:00,0,3,4,0,0,772,4445,5217
2015-03-02 05:00:00-05:00,0,3,5,0,0,488,2904,3392
2015-03-02 06:00:00-05:00,0,3,6,0,0,351,1994,2345
2015-03-02 07:00:00-05:00,0,3,7,0,0,373,2367,2740
2015-03-02 08:00:00-05:00,0,3,8,0,0,360,4593,4953
2015-03-02 09:00:00-05:00,0,3,9,0,0,734,11283,12017
2015-03-02 10:00:00-05:00,0,3,10,0,0,1719,18432,20151
2015-03-02 11:00:00-05:00,0,3,11,0,0,2559,20983,23542
2015-03-02 13:00:00-05:00,0,3,13,0,0,2523,20436,22959
2015-03-02 14:00:00-05:00,0,3,14,0,0,2192,19549,21741
2015-03-02 15:00:00-05:00,0,3,15,0,0,2090,20076,22166
2015-03-02 16:00:00-05:00,0,3,16,0,0,1926,18704,20630
2015-03-02 17:00:00-05:00,0,3,17,0,0,2024,17943,19967
2015-03-02 18:00:00-05:00,0,3,18,0,0,2227,19148,21375
2015-03-02 19:00:00-05:00,0,3,19,0,0,2434,20009,22443
2015-03-02 20:00:00-05:00,0,3,20,0,0,2733,18050,20783
2015-03-02 21:00:00-05:00,0,3,21,0,0,3093,22282,25375
2015-03-02 22:00:00-05:00,0,3,22,0,0,3475,26994,30469
2015-03-02 23:00:00-05:00,0,3,23,0,0,3473,26506,29979
2015-03-03 00:00:00-05:00,0,3,0,1,0,3063,25001,28064
2015-03-03 01:00:00-05:00,0,3,1,1,0,2651,24033,26684
2015-03-03 02:00:00-05:00,0,3,2,1,0,2389,20726,23115
2015-03-03 03:00:00-05:00,0,3,3,1,0,1850,14796,16646
2015-03-03 04:00:00-05:00,0,3,4,1,0,1377,9140,10517
2015-03-03 05:00:00-05:00,0,3,5,1,0,879,5258,6137
2015-03-03 06:00:00-05:00,0,3,6,1,0,532,3330,3862
2015-03-03 07:00:00-05:00,0,3,7,1,0,408,2145,2553
2015-03-03 08:00:00-05:00,0,3,8,1,0,382,2115,2497
2015-03-03 09:00:00-05:00,0,3,9,1,0,379,3978,4357
2015-03-03 10:00:00-05:00,0,3,10,1,0,781,11917,12698
2015-03-03 11:00:00-05:00,0,3,11,1,0,1803,21283,23086
2015-03-03 12:00:00-05:00,0,3,12,1,0,2595,24497,27092
2015-03-03 13:00:00-05:00,0,3,13,1,0,2564,22694,25258
2015-03-03 14:00:00-05:00,0,3,14,1,0,2345,19963,22308
2015-03-03 15:00:00-05:00,0,3,15,1,0,2091,19897,21988
2015-03-03 16:00:00-05:00,0.05,3,16,1,0,2179,20772,22951
2015-03-03 17:00:00-05:00,0.1,3,17,1,0,2252,20223,22475
2015-03-03 18:00:00-05:00,0.1,3,18,1,0,2654,22120,24774
2015-03-03 19:00:00-05:00,0.12,3,19,1,0,3051,21066,24117
2015-03-03 20:00:00-05:00,0.14,3,20,1,0,3370,15880,19250
2015-03-03 21:00:00-05:00,0.12,3,21,1,0,3233,17589,20822
2015-03-03 22:00:00-05:00,0.08,3,22,1,0,3379,20860,24239
2015-03-03 23:00:00-05:00,0.01,3,23,1,0,3472,22700,26172
2015-03-04 00:00:00-05:00,0,3,0,2,0,3668,25009,28677
2015-03-04 01:00:00-05:00,0,3,1,2,0,3251,25152,28403
2015-03-04 02:00:00-05:00,0,3,2,2,0,2666,22682,25348
2015-03-04 03:00:00-05:00,0,3,3,2,0,1912,17421,19333
2015-03-04 04:00:00-05:00,0,3,4,2,0,1367,10729,12096
2015-03-04 05:00:00-05:00,0,3,5,2,0,815,5815,6630
2015-03-04 06:00:00-05:00,0.01,3,6,2,0,520,3574,4094
2015-03-04 07:00:00-05:00,0.01,3,7,2,0,353,2337,2690
2015-03-04 08:00:00-05:00,0.01,3,8,2,0,322,2370,2692
2015-03-04 09:00:00-05:00,0.01,3,9,2,0,349,4371,4720
2015-03-04 10:00:00-05:00,0,3,10,2,0,812,12576,13388
2015-03-04 11:00:00-05:00,0,3,11,2,0,1856,22239,24095
2015-03-04 12:00:00-05:00,0,3,12,2,0,2726,25591,28317
2015-03-04 13:00:00-05:00,0,3,13,2,0,2824,24757,27581
2015-03-04 14:00:00-05:00,0,3,14,2,0,2446,21526,23972
2015-03-04 15:00:00-05:00,0,3,15,2,0,2090,20007,22097
2015-03-04 16:00:00-05:00,0,3,16,2,0,2096,20617,22713
2015-03-04 17:00:00-05:00,0,3,17,2,0,2122,20189,22311
2015-03-04 18:00:00-05:00,0,3,18,2,0,2459,21953,24412
2015-03-04 19:00:00-05:00,0,3,19,2,0,2763,20334,23097
2015-03-04 20:00:00-05:00,0.02,3,20,2,0,3017,16257,19274
2015-03-04 21:00:00-05:00,0.07,3,21,2,0,3359,20648,24007
2015-03-04 22:00:00-05:00,0.05,3,22,2,0,3776,26542,30318
2015-03-04 23:00:00-05:00,0.06,3,23,2,0,3625,28484,32109
2015-03-05 00:00:00-05:00,0.07,3,0,3,0,3667,30006,33673
2015-03-05 01:00:00-05:00,0.04,3,1,3,0,3363,28830,32193
2015-03-05 02:00:00-05:00,0.03,3,2,3,0,2831,25832,28663
2015-03-05 03:00:00-05:00,0.04,3,3,3,0,2261,20175,22436
2015-03-05 04:00:00-05:00,0.02,3,4,3,0,1696,13091,14787
2015-03-05 05:00:00-05:00,0.01,3,5,3,0,1029,7657,8686
2015-03-05 06:00:00-05:00,0.02,3,6,3,0,649,4792,5441
2015-03-05 07:00:00-05:00,0.05,3,7,3,0,493,3082,3575
2015-03-05 08:00:00-05:00,0.05,3,8,3,0,510,2807,3317
2015-03-05 09:00:00-05:00,0.03,3,9,3,0,439,4201,4640
2015-03-05 10:00:00-05:00,0.06,3,10,3,0,785,11383,12168
2015-03-05 11:00:00-05:00,0.05,3,11,3,0,1785,20515,22300
2015-03-05 12:00:00-05:00,0.04,3,12,3,0,2514,21902,24416
2015-03-05 13:00:00-05:00,0.04,3,13,3,0,2386,19827,22213
2015-03-05 14:00:00-05:00,0,3,14,3,0,1934,17577,19511
2015-03-05 15:00:00-05:00,0.01,3,15,3,0,1878,17026,18904
2015-03-05 16:00:00-05:00,0.03,3,16,3,0,1770,17291,19061
2015-03-05 17:00:00-05:00,0.02,3,17,3,0,1621,15259,16880
2015-03-05 18:00:00-05:00,0,3,18,3,0,1792,16180,17972
2015-03-05 19:00:00-05:00,0,3,19,3,0,2087,17106,19193
2015-03-05 20:00:00-05:00,0,3,20,3,0,2202,13316,15518
2015-03-05 21:00:00-05:00,0,3,21,3,0,2245,16191,18436
2015-03-05 22:00:00-05:00,0,3,22,3,0,2462,21089,23551
2015-03-05 23:00:00-05:00,0,3,23,3,0,2732,23119,25851
2015-03-06 00:00:00-05:00,0,3,0,4,0,2659,22519,25178
2015-03-06 01:00:00-05:00,0,3,1,4,0,2359,21422,23781
2015-03-06 02:00:00-05:00,0,3,2,4,0,2176,20324,22500
2015-03-06 03:00:00-05:00,0,3,3,4,0,2004,18759,20763
2015-03-06 04:00:00-05:00,0,3,4,4,0,1581,14568,16149
2015-03-06 05:00:00-05:00,0,3,5,4,0,1093,9440,10533
2015-03-06 06:00:00-05:00,0,3,6,4,0,714,6725,7439
2015-03-06 07:00:00-05:00,0,3,7,4,0,506,4392,4898
2015-03-06 08:00:00-05:00,0,3,8,4,0,485,3819,4304
2015-03-06 09:00:00-05:00,0,3,9,4,0,356,4934,5290
2015-03-06 10:00:00-05:00,0,3,10,4,0,763,11422,12185
2015-03-06 11:00:00-05:00,0,3,11,4,0,1645,18646,20291
2015-03-06 12:00:00-05:00,0,3,12,4,0,2593,22093,24686
2015-03-06 13:00:00-05:00,0,3,13,4,0,2566,22400,24966
2015-03-06 14:00:00-05:00,0,3,14,4,0,2378,21180,23558
2015-03-06 15:00:00-05:00,0,3,15,4,0,2174,21183,23357
2015-03-06 16:00:00-05:00,0,3,16,4,0,2066,20299,22365
2015-03-06 17:00:00-05:00,0,3,17,4,0,2009,19928,21937
2015-03-06 18:00:00-05:00,0,3,18,4,0,2632,21202,23834
2015-03-06 19:00:00-05:00,0,3,19,4,0,3005,18836,21841
2015-03-06 20:00:00-05:00,0,3,20,4,0,3477,14788,18265
2015-03-06 21:00:00-05:00,0,3,21,4,0,4038,18630,22668
2015-03-06 22:00:00-05:00,0,3,22,4,0,4684,24702,29386
2015-03-06 23:00:00-05:00,0,3,23,4,0,5226,28951,34177
2015-03-07 00:00:00-05:00,0,3,0,5,0,5170,29857,35027
2015-03-07 01:00:00-05:00,0,3,1,5,0,4920,29580,34500
2015-03-07 02:00:00-05:00,0,3,2,5,0,4925,29960,34885
2015-03-07 03:00:00-05:00,0,3,3,5,0,4903,29307,34210
2015-03-07 04:00:00-05:00,0,3,4,5,0,4416,27086,31502
2015-03-07 05:00:00-05:00,0,3,5,5,0,3748,22728,26476
2015-03-07 06:00:00-05:00,0,3,6,5,0,2961,18716,21677
2015-03-07 07:00:00-05:00,0,3,7,5,0,2331,14274,16605
2015-03-07 08:00:00-05:00,0,3,8,5,0,1750,9277,11027
2015-03-07 09:00:00-05:00,0,3,9,5,0,911,4587,5498
2015-03-07 10:00:00-05:00,0,3,10,5,0,720,5799,6519
2015-03-07 11:00:00-05:00,0,3,11,5,0,878,7871,8749
2015-03-07 12:00:00-05:00,0,3,12,5,0,1373,12697,14070
2015-03-07 13:00:00-05:00,0,3,13,5,0,1841,18058,19899
2015-03-07 14:00:00-05:00,0,3,14,5,0,2171,21610,23781
2015-03-07 15:00:00-05:00,0,3,15,5,0,2326,23935,26261
2015-03-07 16:00:00-05:00,0,3,16,5,0,2516,25291,27807
2015-03-07 17:00:00-05:00,0,3,17,5,0,2675,25983,28658
2015-03-07 18:00:00-05:00,0,3,18,5,0,3055,25321,28376
2015-03-07 19:00:00-05:00,0,3,19,5,0,3333,24333,27666
2015-03-07 20:00:00-05:00,0,3,20,5,0,3606,21639,25245
2015-03-07 21:00:00-05:00,0,3,21,5,0,3939,24236,28175
2015-03-07 22:00:00-05:00,0,3,22,5,0,4434,29548,33982
2015-03-07 23:00:00-05:00,0,3,23,5,0,4899,30915,35814
2015-03-08 00:00:00-05:00,0,3,0,6,0,4801,26733,31534
2015-03-08 01:00:00-05:00,0,3,1,6,0,4856,25698,30554
2015-03-08 03:00:00-04:00,0,3,3,6,0,4919,28330,33249
2015-03-08 04:00:00-04:00,0,3,4,6,0,4838,29581,34419
2015-03-08 05:00:00-04:00,0,3,5,6,0,4716,27604,32320
2015-03-08 06:00:00-04:00,0,3,6,6,0,4088,24813,28901
2015-03-08 07:00:00-04:00,0,3,7,6,0,20,157,177
2015-03-08 08:00:00-04:00,0,3,8,6,0,3723,22170,25893
2015-03-08 09:00:00-04:00,0,3,9,6,0,2975,15534,18509
2015-03-08 10:00:00-04:00,0,3,10,6,0,1766,7586,9352
2015-03-08 11:00:00-04:00,0,3,11,6,0,900,5265,6165
2015-03-08 12:00:00-04:00,0,3,12,6,0,751,6364,7115
2015-03-08 13:00:00-04:00,0,3,13,6,0,861,8874,9735
2015-03-08 14:00:00-04:00,0,3,14,6,0,1222,13281,14503
2015-03-08 15:00:00-04:00,0,3,15,6,0,1649,18096,19745
2015-03-08 16:00:00-04:00,0,3,16,6,0,1952,20980,22932
2015-03-08 17:00:00-04:00,0,3,17,6,0,2085,23180,25265
2015-03-08 18:00:00-04:00,0,3,18,6,0,2256,23747,26003
2015-03-08 19:00:00-04:00,0,3,19,6,0,2627,23302,25929
2015-03-08 20:00:00-04:00,0,3,20,6,0,2710,21290,24000
2015-03-08 21:00:00-04:00,0,3,21,6,0,2941,19147,22088
2015-03-08 22:00:00-04:00,0,3,22,6,0,2985,20694,23679
2015-03-08 23:00:00-04:00,0,3,23,6,0,3231,22033,25264
2015-03-09 00:00:00-04:00,0,3,0,0,0,3319,21830,25149
2015-03-09 01:00:00-04:00,0,3,1,0,0,3140,19018,22158
2015-03-09 02:00:00-04:00,0,3,2,0,0,2778,17962,20740
2015-03-09 03:00:00-04:00,0,3,3,0,0,2620,16188,18808
2015-03-09 04:00:00-04:00,0,3,4,0,0,2062,12802,14864
2015-03-09 05:00:00-04:00,0,3,5,0,0,1473,8538,10011
2015-03-09 06:00:00-04:00,0.01,3,6,0,0,984,5177,6161
2015-03-09 07:00:00-04:00,0.01,3,7,0,0,704,3302,4006
2015-03-09 08:00:00-04:00,0,3,8,0,0,476,2272,2748
2015-03-09 09:00:00-04:00,0,3,9,0,0,574,2727,3301
2015-03-09 10:00:00-04:00,0,3,10,0,0,482,4675,5157
2015-03-09 11:00:00-04:00,0,3,11,0,0,717,11784,12501
2015-03-09 12:00:00-04:00,0,3,12,0,0,1719,19757,21476
2015-03-09 13:00:00-04:00,0,3,13,0,0,2844,23391,26235
2015-03-09 14:00:00-04:00,0,3,14,0,0,2584,22241,24825
2015-03-09 15:00:00-04:00,0,3,15,0,0,2113,19006,21119
2015-03-09 16:00:00-04:00,0,3,16,0,0,1761,18495,20256
2015-03-09 17:00:00-04:00,0,3,17,0,0,1808,18876,20684
2015-03-09 18:00:00-04:00,0,3,18,0,0,1842,18525,20367
2015-03-09 19:00:00-04:00,0,3,19,0,0,2048,19619,21667
2015-03-09 20:00:00-04:00,0,3,20,0,0,2315,19975,22290
2015-03-09 21:00:00-04:00,0,3,21,0,0,2518,17419,19937
2015-03-09 22:00:00-04:00,0,3,22,0,0,2799,20654,23453
2015-03-09 23:00:00-04:00,0,3,23,0,0,3073,25613,28686
2015-03-10 00:00:00-04:00,0,3,0,1,0,3096,25878,28974
2015-03-10 01:00:00-04:00,0,3,1,1,0,2743,24296,27039
2015-03-10 02:00:00-04:00,0,3,2,1,0,2477,23196,25673
2015-03-10 03:00:00-04:00,0,3,3,1,0,2065,19775,21840
2015-03-10 04:00:00-04:00,0,3,4,1,0,1617,16818,18435
2015-03-10 05:00:00-04:00,0,3,5,1,0,1306,9593,10899
2015-03-10 06:00:00-04:00,0,3,6,1,0,849,5932,6781
2015-03-10 07:00:00-04:00,0,3,7,1,0,569,3656,4225
2015-03-10 08:00:00-04:00,0,3,8,1,0,391,2531,2922
2015-03-10 09:00:00-04:00,0,3,9,1,0,410,2388,2798
2015-03-10 10:00:00-04:00,0,3,10,1,0,365,4125,4490
2015-03-10 11:00:00-04:00,0,3,11,1,0,664,11331,11995
2015-03-10 12:00:00-04:00,0,3,12,1,0,1737,20705,22442
2015-03-10 13:00:00-04:00,0,3,13,1,0,2551,24299,26850
2015-03-10 14:00:00-04:00,0,3,14,1,0,2537,22982,25519
2015-03-10 15:00:00-04:00,0,3,15,1,0,2134,20437,22571
2015-03-10 16:00:00-04:00,0,3,16,1,0,1872,19460,21332
2015-03-10 17:00:00-04:00,0.02,3,17,1,0,1816,20478,22294
2015-03-10 18:00:00-04:00,0.05,3,18,1,0,1902,19276,21178
2015-03-10 19:00:00-04:00,0.04,3,19,1,0,2217,21430,23647
2015-03-10 20:00:00-04:00,0.07,3,20,1,0,2505,20109,22614
2015-03-10 21:00:00-04:00,0.07,3,21,1,0,2951,16186,19137
2015-03-10 22:00:00-04:00,0.09,3,22,1,0,3745,19582,23327
2015-03-10 23:00:00-04:00,0.05,3,23,1,0,4065,24602,28667
2015-03-11 00:00:00-04:00,0.03,3,0,2,0,3949,26368,30317
2015-03-11 01:00:00-04:00,0.02,3,1,2,0,3897,27674,31571
2015-03-11 02:00:00-04:00,0,3,2,2,0,3495,27340,30835
2015-03-11 03:00:00-04:00,0,3,3,2,0,3029,24585,27614
2015-03-11 04:00:00-04:00,0,3,4,2,0,2223,18880,21103
2015-03-11 05:00:00-04:00,0,3,5,2,0,1529,11753,13282
2015-03-11 06:00:00-04:00,0,3,6,2,0,938,6583,7521
2015-03-11 07:00:00-04:00,0,3,7,2,0,525,3992,4517
2015-03-11 08:00:00-04:00,0,3,8,2,0,368,2733,3101
2015-03-11 09:00:00-04:00,0,3,9,2,0,340,2672,3012
2015-03-11 10:00:00-04:00,0,3,10,2,0,346,4303,4649
2015-03-11 11:00:00-04:00,0,3,11,2,0,723,11570,12293
2015-03-11 12:00:00-04:00,0,3,12,2,0,1823,21496,23319
2015-03-11 13:00:00-04:00,0,3,13,2,0,2681,24721,27402
2015-03-11 14:00:00-04:00,0,3,14,2,0,2601,23328,25929
2015-03-11 15:00:00-04:00,0,3,15,2,0,2201,20328,22529
2015-03-11 16:00:00-04:00,0,3,16,2,0,2024,20207,22231
2015-03-11 17:00:00-04:00,0,3,17,2,0,2044,20582,22626
2015-03-11 18:00:00-04:00,0,3,18,2,0,2081,19898,21979
2015-03-11 19:00:00-04:00,0,3,19,2,0,2302,20893,23195
2015-03-11 20:00:00-04:00,0,3,20,2,0,2635,20109,22744
2015-03-11 21:00:00-04:00,0,3,21,2,0,2833,16535,19368
2015-03-11 22:00:00-04:00,0,3,22,2,0,3206,20938,24144
2015-03-11 23:00:00-04:00,0,3,23,2,0,3684,24942,28626
2015-03-12 00:00:00-04:00,0,3,0,3,0,3862,27481,31343
2015-03-12 01:00:00-04:00,0,3,1,3,0,3438,27893,31331
2015-03-12 02:00:00-04:00,0,3,2,3,0,2953,27701,30654
2015-03-12 03:00:00-04:00,0,3,3,3,0,2761,26320,29081
2015-03-12 04:00:00-04:00,0,3,4,3,0,2354,21388,23742
2015-03-12 05:00:00-04:00,0,3,5,3,0,1795,14685,16480
2015-03-12 06:00:00-04:00,0,3,6,3,0,1221,8398,9619
2015-03-12 07:00:00-04:00,0,3,7,3,0,797,5313,6110
2015-03-12 08:00:00-04:00,0,3,8,3,0,513,3537,4050
2015-03-12 09:00:00-04:00,0,3,9,3,0,475,3210,3685
2015-03-12 10:00:00-04:00,0,3,10,3,0,427,4629,5056
2015-03-12 11:00:00-04:00,0,3,11,3,0,738,11761,12499
2015-03-12 12:00:00-04:00,0,3,12,3,0,1872,21834,23706
2015-03-12 13:00:00-04:00,0,3,13,3,0,2801,25335,28136
2015-03-12 14:00:00-04:00,0,3,14,3,0,2638,23656,26294
2015-03-12 15:00:00-04:00,0,3,15,3,0,2243,21706,23949
2015-03-12 16:00:00-04:00,0,3,16,3,0,2058,21626,23684
2015-03-12 17:00:00-04:00,0,3,17,3,0,2014,22821,24835
2015-03-12 18:00:00-04:00,0,3,18,3,0,2063,21694,23757
2015-03-12 19:00:00-04:00,0,3,19,3,0,2395,22745,25140
2015-03-12 20:00:00-04:00,0,3,20,3,0,2689,20690,23379
2015-03-12 21:00:00-04:00,0,3,21,3,0,2910,16547,19457
2015-03-12 22:00:00-04:00,0,3,22,3,0,3425,20801,24226
2015-03-12 23:00:00-04:00,0,3,23,3,0,3891,27190,31081
2015-03-13 00:00:00-04:00,0,3,0,4,0,3887,29737,33624
2015-03-13 01:00:00-04:00,0,3,1,4,0,3801,29928,33729
2015-03-13 02:00:00-04:00,0,3,2,4,0,3563,29555,33118
2015-03-13 03:00:00-04:00,0,3,3,4,0,3230,28556,31786
2015-03-13 04:00:00-04:00,0,3,4,4,0,2720,25765,28485
2015-03-13 05:00:00-04:00,0,3,5,4,0,2241,19189,21430
2015-03-13 06:00:00-04:00,0,3,6,4,0,1588,12124,13712
2015-03-13 07:00:00-04:00,0,3,7,4,0,1074,7908,8982
2015-03-13 08:00:00-04:00,0,3,8,4,0,773,5584,6357
2015-03-13 09:00:00-04:00,0,3,9,4,0,640,4430,5070
2015-03-13 10:00:00-04:00,0,3,10,4,0,478,5324,5802
2015-03-13 11:00:00-04:00,0,3,11,4,0,772,11850,12622
2015-03-13 12:00:00-04:00,0,3,12,4,0,1869,21290,23159
2015-03-13 13:00:00-04:00,0,3,13,4,0,2771,24688,27459
2015-03-13 14:00:00-04:00,0,3,14,4,0,2661,22970,25631
2015-03-13 15:00:00-04:00,0,3,15,4,0,2298,20900,23198
2015-03-13 16:00:00-04:00,0,3,16,4,0,2067,21166,23233
2015-03-13 17:00:00-04:00,0,3,17,4,0,2021,21858,23879
2015-03-13 18:00:00-04:00,0,3,18,4,0,1995,20304,22299
2015-03-13 19:00:00-04:00,0,3,19,4,0,2478,22324,24802
2015-03-13 20:00:00-04:00,0,3,20,4,0,2822,20321,23143
2015-03-13 21:00:00-04:00,0,3,21,4,0,3264,16777,20041
2015-03-13 22:00:00-04:00,0,3,22,4,0,3869,22030,25899
2015-03-13 23:00:00-04:00,0,3,23,4,0,4672,28452,33124
2015-03-14 00:00:00-04:00,0,3,0,5,0,4942,30852,35794
2015-03-14 01:00:00-04:00,0,3,1,5,0,4871,29739,34610
2015-03-14 02:00:00-04:00,0,3,2,5,0,4738,29039,33777
2015-03-14 03:00:00-04:00,0,3,3,5,0,4571,29138,33709
2015-03-14 04:00:00-04:00,0.03,3,4,5,0,4703,28679,33382
2015-03-14 05:00:00-04:00,0.06,3,5,5,0,4214,26602,30816
2015-03-14 06:00:00-04:00,0.06,3,6,5,0,3658,22811,26469
2015-03-14 07:00:00-04:00,0.06,3,7,5,0,2975,18799,21774
2015-03-14 08:00:00-04:00,0.15,3,8,5,0,2420,14566,16986
2015-03-14 09:00:00-04:00,0.19,3,9,5,0,1901,9476,11377
2015-03-14 10:00:00-04:00,0.14,3,10,5,0,1003,4564,5567
2015-03-14 11:00:00-04:00,0.1,3,11,5,0,720,5447,6167
2015-03-14 12:00:00-04:00,0.08,3,12,5,0,954,8013,8967
2015-03-14 13:00:00-04:00,0.03,3,13,5,0,1477,12672,14149
2015-03-14 14:00:00-04:00,0,3,14,5,0,1938,18190,20128
2015-03-14 15:00:00-04:00,0,3,15,5,0,2167,21428,23595
2015-03-14 16:00:00-04:00,0.01,3,16,5,0,2377,23957,26334
2015-03-14 17:00:00-04:00,0.01,3,17,5,0,2666,26502,29168
2015-03-14 18:00:00-04:00,0,3,18,5,0,2600,24889,27489
2015-03-14 19:00:00-04:00,0.01,3,19,5,0,2802,23310,26112
2015-03-14 20:00:00-04:00,0.02,3,20,5,0,3058,22361,25419
2015-03-14 21:00:00-04:00,0.05,3,21,5,0,3357,20886,24243
2015-03-14 22:00:00-04:00,0.02,3,22,5,0,3694,23796,27490
2015-03-14 23:00:00-04:00,0,3,23,5,0,4080,27229,31309
2015-03-15 00:00:00-04:00,0,3,0,6,0,4407,29803,34210
2015-03-15 01:00:00-04:00,0,3,1,6,0,4712,27976,32688
2015-03-15 02:00:00-04:00,0,3,2,6,0,4863,27486,32349
2015-03-15 03:00:00-04:00,0,3,3,6,0,4657,27888,32545
2015-03-15 04:00:00-04:00,0,3,4,6,0,4614,27874,32488
2015-03-15 05:00:00-04:00,0,3,5,6,0,4460,27343,31803
2015-03-15 06:00:00-04:00,0,3,6,6,0,4159,24145,28304
2015-03-15 07:00:00-04:00,0,3,7,6,0,3475,20551,24026
2015-03-15 08:00:00-04:00,0,3,8,6,0,2891,15519,18410
2015-03-15 09:00:00-04:00,0,3,9,6,0,2246,10085,12331
2015-03-15 10:00:00-04:00,0,3,10,6,0,1142,4793,5935
2015-03-15 14:00:00-04:00,0,3,14,6,0,765,6235,7000
2015-03-15 15:00:00-04:00,0,3,15,6,0,785,6697,7482
2015-03-15 16:00:00-04:00,0,3,16,6,0,923,8366,9289
2015-03-15 17:00:00-04:00,0,3,17,6,0,1262,12540,13802
2015-03-15 18:00:00-04:00,0,3,18,6,0,1718,16882,18600
2015-03-15 19:00:00-04:00,0,3,19,6,0,2066,20608,22674
2015-03-15 20:00:00-04:00,0,3,20,6,0,2263,23393,25656
2015-03-15 21:00:00-04:00,0,3,21,6,0,2380,23743,26123
2015-03-15 22:00:00-04:00,0,3,22,6,0,2677,23243,25920
2015-03-15 23:00:00-04:00,0,3,23,6,0,3061,22268,25329
2015-03-16 00:00:00-04:00,0,3,0,0,0,3167,21007,24174
2015-03-16 01:00:00-04:00,0,3,1,0,0,3411,22039,25450
2015-03-16 02:00:00-04:00,0,3,2,0,0,3403,22471,25874
2015-03-16 03:00:00-04:00,0,3,3,0,0,3457,21497,24954
2015-03-16 04:00:00-04:00,0,3,4,0,0,3183,19763,22946
2015-03-16 05:00:00-04:00,0,3,5,0,0,2857,17772,20629
2015-03-16 06:00:00-04:00,0,3,6,0,0,2514,15646,18160
2015-03-16 07:00:00-04:00,0,3,7,0,0,2041,12172,14213
2015-03-16 08:00:00-04:00,0,3,8,0,0,1535,8839,10374
2015-03-16 09:00:00-04:00,0,3,9,0,0,1000,5422,6422
2015-03-16 10:00:00-04:00,0,3,10,0,0,674,3763,4437
2015-03-16 11:00:00-04:00,0,3,11,0,0,515,2904,3419
2015-03-16 12:00:00-04:00,0,3,12,0,0,563,2952,3515
2015-03-16 13:00:00-04:00,0,3,13,0,0,441,4488,4929
2015-03-16 14:00:00-04:00,0,3,14,0,0,756,11184,11940
2015-03-16 15:00:00-04:00,0,3,15,0,0,1827,18349,20176
2015-03-16 16:00:00-04:00,0,3,16,0,0,2777,21906,24683
2015-03-16 17:00:00-04:00,0,3,17,0,0,2469,21306,23775
2015-03-16 18:00:00-04:00,0,3,18,0,0,2162,18314,20476
2015-03-16 19:00:00-04:00,0,3,19,0,0,2017,18027,20044
2015-03-16 20:00:00-04:00,0,3,20,0,0,1868,18254,20122
2015-03-16 21:00:00-04:00,0,3,21,0,0,1909,17994,19903
2015-03-16 22:00:00-04:00,0,3,22,0,0,2068,18753,20821
2015-03-16 23:00:00-04:00,0,3,23,0,0,2218,18163,20381
2015-03-17 00:00:00-04:00,0,3,0,1,0,2322,16653,18975
2015-03-17 01:00:00-04:00,0,3,1,1,0,2812,19679,22491
2015-03-17 02:00:00-04:00,0,3,2,1,0,3108,24353,27461
2015-03-17 03:00:00-04:00,0,3,3,1,0,2917,24721,27638
2015-03-17 04:00:00-04:00,0,3,4,1,0,2639,23761,26400
2015-03-17 05:00:00-04:00,0,3,5,1,0,2294,21809,24103
2015-03-17 06:00:00-04:00,0,3,6,1,0,1956,18807,20763
2015-03-17 07:00:00-04:00,0,3,7,1,0,1603,14419,16022
2015-03-17 08:00:00-04:00,0.01,3,8,1,0,1277,9283,10560
2015-03-17 09:00:00-04:00,0,3,9,1,0,908,5587,6495
2015-03-17 10:00:00-04:00,0,3,10,1,0,560,3445,4005
2015-03-17 11:00:00-04:00,0,3,11,1,0,399,2211,2610
2015-03-17 12:00:00-04:00,0,3,12,1,0,418,2316,2734
2015-03-17 13:00:00-04:00,0,3,13,1,0,364,3959,4323
2015-03-17 14:00:00-04:00,0,3,14,1,0,712,10789,11501
2015-03-17 15:00:00-04:00,0,3,15,1,0,1718,19161,20879
2015-03-17 16:00:00-04:00,0,3,16,1,0,2818,22584,25402
2015-03-17 17:00:00-04:00,0,3,17,1,0,2607,20977,23584
2015-03-17 18:00:00-04:00,0,3,18,1,0,2131,17395,19526
2015-03-17 19:00:00-04:00,0,3,19,1,0,1919,16235,18154
2015-03-17 20:00:00-04:00,0,3,20,1,0,1832,16753,18585
2015-03-17 21:00:00-04:00,0,3,21,1,0,1839,17195,19034
2015-03-17 22:00:00-04:00,0,3,22,1,0,2155,18612,20767
2015-03-17 23:00:00-04:00,0,3,23,1,0,2440,18261,20701
2015-03-18 00:00:00-04:00,0,3,0,2,0,2587,16185,18772
2015-03-18 01:00:00-04:00,0,3,1,2,0,3186,22322,25508
2015-03-18 02:00:00-04:00,0,3,2,2,0,3696,28525,32221
2015-03-18 03:00:00-04:00,0,3,3,2,0,3823,30351,34174
2015-03-18 04:00:00-04:00,0,3,4,2,0,3712,30483,34195
2015-03-18 05:00:00-04:00,0,3,5,2,0,3431,29580,33011
2015-03-18 06:00:00-04:00,0,3,6,2,0,3191,27951,31142
2015-03-18 07:00:00-04:00,0,3,7,2,0,2623,23216,25839
2015-03-18 08:00:00-04:00,0,3,8,2,0,2006,15734,17740
2015-03-18 09:00:00-04:00,0,3,9,2,0,1334,9259,10593
2015-03-18 10:00:00-04:00,0,3,10,2,0,790,5901,6691
2015-03-18 11:00:00-04:00,0,3,11,2,0,552,4110,4662
2015-03-18 12:00:00-04:00,0,3,12,2,0,522,3426,3948
2015-03-18 13:00:00-04:00,0,3,13,2,0,398,4581,4979
2015-03-18 14:00:00-04:00,0,3,14,2,0,761,11777,12538
2015-03-18 15:00:00-04:00,0,3,15,2,0,1815,20933,22748
2015-03-18 16:00:00-04:00,0,3,16,2,0,2744,25387,28131
2015-03-18 17:00:00-04:00,0,3,17,2,0,2665,24284,26949
2015-03-18 18:00:00-04:00,0,3,18,2,0,2162,21702,23864
2015-03-18 19:00:00-04:00,0,3,19,2,0,1987,21332,23319
2015-03-18 20:00:00-04:00,0,3,20,2,0,1959,21647,23606
2015-03-18 21:00:00-04:00,0,3,21,2,0,2077,21227,23304
2015-03-18 22:00:00-04:00,0,3,22,2,0,2348,21589,23937
2015-03-18 23:00:00-04:00,0,3,23,2,0,2599,20016,22615
2015-03-19 00:00:00-04:00,0,3,0,3,0,2778,17085,19863
2015-03-19 01:00:00-04:00,0,3,1,3,0,3287,21756,25043
2015-03-19 02:00:00-04:00,0,3,2,3,0,3620,27433,31053
2015-03-19 03:00:00-04:00,0,3,3,3,0,3935,29853,33788
2015-03-19 04:00:00-04:00,0,3,4,3,0,3453,28895,32348
2015-03-19 05:00:00-04:00,0,3,5,3,0,2961,28126,31087
2015-03-19 06:00:00-04:00,0,3,6,3,0,2703,26141,28844
2015-03-19 07:00:00-04:00,0,3,7,3,0,2179,20787,22966
2015-03-19 08:00:00-04:00,0,3,8,3,0,1696,13171,14867
2015-03-19 09:00:00-04:00,0,3,9,3,0,1096,7725,8821
2015-03-19 10:00:00-04:00,0,3,10,3,0,666,4654,5320
2015-03-19 11:00:00-04:00,0,3,11,3,0,433,2948,3381
2015-03-19 12:00:00-04:00,0,3,12,3,0,452,2824,3276
2015-03-19 13:00:00-04:00,0,3,13,3,0,394,4424,4818
2015-03-19 14:00:00-04:00,0,3,14,3,0,734,11705,12439
2015-03-19 15:00:00-04:00,0,3,15,3,0,1808,20603,22411
2015-03-19 16:00:00-04:00,0,3,16,3,0,2657,24453,27110
2015-03-19 17:00:00-04:00,0,3,17,3,0,2552,23528,26080
2015-03-19 18:00:00-04:00,0,3,18,3,0,2319,21607,23926
2015-03-19 19:00:00-04:00,0,3,19,3,0,2192,21936,24128
2015-03-19 20:00:00-04:00,0,3,20,3,0,2199,22194,24393
2015-03-19 21:00:00-04:00,0,3,21,3,0,2154,21974,24128
2015-03-19 22:00:00-04:00,0,3,22,3,0,2350,22361,24711
2015-03-19 23:00:00-04:00,0,3,23,3,0,2610,20431,23041
2015-03-20 00:00:00-04:00,0,3,0,4,0,2779,16553,19332
2015-03-20 01:00:00-04:00,0,3,1,4,0,3395,21686,25081
2015-03-20 02:00:00-04:00,0,3,2,4,0,3941,27195,31136
2015-03-20 03:00:00-04:00,0,3,3,4,0,3813,29285,33098
2015-03-20 04:00:00-04:00,0,3,4,4,0,3545,29112,32657
2015-03-20 05:00:00-04:00,0,3,5,4,0,3289,29271,32560
2015-03-20 06:00:00-04:00,0,3,6,4,0,3097,27441,30538
2015-03-20 07:00:00-04:00,0,3,7,4,0,2764,24823,27587
2015-03-20 08:00:00-04:00,0,3,8,4,0,2133,17782,19915
2015-03-20 09:00:00-04:00,0,3,9,4,0,1599,11136,12735
2015-03-20 10:00:00-04:00,0,3,10,4,0,980,7133,8113
2015-03-20 11:00:00-04:00,0,3,11,4,0,764,4851,5615
2015-03-20 12:00:00-04:00,0,3,12,4,0,706,4139,4845
2015-03-20 13:00:00-04:00,0.02,3,13,4,0,504,4837,5341
2015-03-20 14:00:00-04:00,0.04,3,14,4,0,764,11428,12192
2015-03-20 15:00:00-04:00,0.05,3,15,4,0,1824,19629,21453
2015-03-20 16:00:00-04:00,0.05,3,16,4,0,2712,23950,26662
2015-03-20 17:00:00-04:00,0.03,3,17,4,0,2642,23049,25691
2015-03-20 18:00:00-04:00,0.03,3,18,4,0,2254,20674,22928
2015-03-20 19:00:00-04:00,0.03,3,19,4,0,2093,20544,22637
2015-03-20 20:00:00-04:00,0.01,3,20,4,0,2052,21874,23926
2015-03-20 21:00:00-04:00,0.01,3,21,4,0,2078,21625,23703
2015-03-20 22:00:00-04:00,0.01,3,22,4,0,2676,22308,24984
2015-03-20 23:00:00-04:00,0,3,23,4,0,3153,20288,23441
2015-03-21 00:00:00-04:00,0,3,0,5,0,3534,16772,20306
2015-03-21 01:00:00-04:00,0,3,1,5,0,4122,21849,25971
2015-03-21 02:00:00-04:00,0,3,2,5,0,4625,27712,32337
2015-03-21 03:00:00-04:00,0,3,3,5,0,4403,29728,34131
2015-03-21 04:00:00-04:00,0.01,3,4,5,0,4357,26961,31318
2015-03-21 05:00:00-04:00,0,3,5,5,0,3967,26455,30422
2015-03-21 06:00:00-04:00,0,3,6,5,0,4017,26890,30907
2015-03-21 07:00:00-04:00,0,3,7,5,0,4009,26611,30620
2015-03-21 08:00:00-04:00,0,3,8,5,0,3595,23780,27375
2015-03-21 09:00:00-04:00,0,3,9,5,0,3076,19485,22561
2015-03-21 10:00:00-04:00,0,3,10,5,0,2440,15756,18196
2015-03-21 11:00:00-04:00,0,3,11,5,0,1963,11444,13407
2015-03-21 12:00:00-04:00,0,3,12,5,0,1620,7757,9377
2015-03-21 13:00:00-04:00,0,3,13,5,0,902,4252,5154
2015-03-21 14:00:00-04:00,0,3,14,5,0,700,5324,6024
2015-03-21 15:00:00-04:00,0,3,15,5,0,911,7521,8432
2015-03-21 16:00:00-04:00,0,3,16,5,0,1352,12052,13404
2015-03-21 17:00:00-04:00,0,3,17,5,0,1757,16301,18058
2015-03-21 18:00:00-04:00,0,3,18,5,0,2115,18955,21070
2015-03-21 19:00:00-04:00,0,3,19,5,0,2300,21381,23681
2015-03-21 20:00:00-04:00,0,3,20,5,0,2455,23384,25839
2015-03-21 21:00:00-04:00,0,3,21,5,0,2604,23367,25971
2015-03-21 22:00:00-04:00,0,3,22,5,0,2949,22922,25871
2015-03-21 23:00:00-04:00,0,3,23,5,0,3331,22755,26086
2015-03-22 00:00:00-04:00,0,3,0,6,0,3423,20985,24408
2015-03-22 01:00:00-04:00,0,3,1,6,0,3661,23667,27328
2015-03-22 02:00:00-04:00,0,3,2,6,0,4201,27615,31816
2015-03-22 03:00:00-04:00,0,3,3,6,0,4604,29868,34472
2015-03-22 04:00:00-04:00,0,3,4,6,0,4584,26399,30983
2015-03-22 05:00:00-04:00,0,3,5,6,0,4672,25221,29893
2015-03-22 06:00:00-04:00,0,3,6,6,0,4836,28333,33169
2015-03-22 07:00:00-04:00,0,3,7,6,0,5180,29584,34764
2015-03-22 08:00:00-04:00,0,3,8,6,0,4937,27775,32712
2015-03-22 09:00:00-04:00,0,3,9,6,0,4445,25445,29890
2015-03-22 10:00:00-04:00,0,3,10,6,0,3976,22003,25979
2015-03-22 11:00:00-04:00,0,3,11,6,0,3159,17161,20320
2015-03-22 12:00:00-04:00,0,3,12,6,0,2411,10764,13175
2015-03-22 13:00:00-04:00,0,3,13,6,0,1201,4872,6073
2015-03-22 14:00:00-04:00,0,3,14,6,0,797,4844,5641
2015-03-22 15:00:00-04:00,0,3,15,6,0,773,5888,6661
2015-03-22 16:00:00-04:00,0,3,16,6,0,951,9049,10000
2015-03-22 17:00:00-04:00,0,3,17,6,0,1360,13359,14719
2015-03-22 18:00:00-04:00,0,3,18,6,0,1722,18146,19868
2015-03-22 19:00:00-04:00,0,3,19,6,0,2026,21028,23054
2015-03-22 20:00:00-04:00,0,3,20,6,0,2272,22699,24971
2015-03-22 21:00:00-04:00,0,3,21,6,0,2359,22605,24964
2015-03-22 22:00:00-04:00,0,3,22,6,0,2639,22765,25404
2015-03-22 23:00:00-04:00,0,3,23,6,0,2959,22166,25125
2015-03-23 00:00:00-04:00,0,3,0,0,0,2930,20631,23561
2015-03-23 01:00:00-04:00,0,3,1,0,0,3101,21412,24513
2015-03-23 02:00:00-04:00,0,3,2,0,0,3361,23058,26419
2015-03-23 03:00:00-04:00,0,3,3,0,0,3429,22061,25490
2015-03-23 04:00:00-04:00,0,3,4,0,0,3265,20575,23840
2015-03-23 05:00:00-04:00,0,3,5,0,0,2969,19434,22403
2015-03-23 06:00:00-04:00,0,3,6,0,0,2711,17793,20504
2015-03-23 07:00:00-04:00,0,3,7,0,0,2304,13483,15787
2015-03-23 08:00:00-04:00,0,3,8,0,0,1665,8636,10301
2015-03-23 09:00:00-04:00,0,3,9,0,0,1076,5179,6255
2015-03-23 10:00:00-04:00,0,3,10,0,0,728,3324,4052
2015-03-23 11:00:00-04:00,0,3,11,0,0,533,2103,2636
2015-03-23 12:00:00-04:00,0,3,12,0,0,601,2692,3293
2015-03-23 13:00:00-04:00,0,3,13,0,0,480,4703,5183
2015-03-23 14:00:00-04:00,0,3,14,0,0,817,11496,12313
2015-03-23 15:00:00-04:00,0,3,15,0,0,1880,19612,21492
2015-03-23 16:00:00-04:00,0,3,16,0,0,2744,22825,25569
2015-03-23 17:00:00-04:00,0,3,17,0,0,2567,21450,24017
2015-03-23 18:00:00-04:00,0,3,18,0,0,2098,18758,20856
2015-03-23 19:00:00-04:00,0,3,19,0,0,1971,18403,20374
2015-03-23 20:00:00-04:00,0,3,20,0,0,1925,18902,20827
2015-03-23 21:00:00-04:00,0,3,21,0,0,1825,18685,20510
2015-03-23 22:00:00-04:00,0,3,22,0,0,2154,19390,21544
2015-03-23 23:00:00-04:00,0,3,23,0,0,2359,18966,21325
2015-03-24 00:00:00-04:00,0,3,0,1,0,2472,17166,19638
2015-03-24 01:00:00-04:00,0,3,1,1,0,2827,21167,23994
2015-03-24 02:00:00-04:00,0,3,2,1,0,3100,25659,28759
2015-03-24 03:00:00-04:00,0,3,3,1,0,3179,25965,29144
2015-03-24 04:00:00-04:00,0,3,4,1,0,2981,24777,27758
2015-03-24 05:00:00-04:00,0,3,5,1,0,2582,24294,26876
2015-03-24 06:00:00-04:00,0,3,6,1,0,2293,21186,23479
2015-03-24 07:00:00-04:00,0,3,7,1,0,1860,15015,16875
2015-03-24 08:00:00-04:00,0,3,8,1,0,1244,10046,11290
2015-03-24 09:00:00-04:00,0,3,9,1,0,856,5536,6392
2015-03-24 10:00:00-04:00,0,3,10,1,0,566,3630,4196
2015-03-24 11:00:00-04:00,0,3,11,1,0,401,2347,2748
2015-03-24 12:00:00-04:00,0,3,12,1,0,426,2245,2671
2015-03-24 13:00:00-04:00,0,3,13,1,0,382,4106,4488
2015-03-24 14:00:00-04:00,0,3,14,1,0,696,11364,12060
2015-03-24 15:00:00-04:00,0,3,15,1,0,1848,20101,21949
2015-03-24 16:00:00-04:00,0,3,16,1,0,2772,24733,27505
2015-03-24 17:00:00-04:00,0,3,17,1,0,2578,22699,25277
2015-03-24 18:00:00-04:00,0,3,18,1,0,2080,19855,21935
2015-03-24 19:00:00-04:00,0,3,19,1,0,1880,19257,21137
2015-03-24 20:00:00-04:00,0,3,20,1,0,1904,20053,21957
2015-03-24 21:00:00-04:00,0,3,21,1,0,1885,19306,21191
2015-03-24 22:00:00-04:00,0,3,22,1,0,2208,20196,22404
2015-03-24 23:00:00-04:00,0,3,23,1,0,2347,19008,21355
2015-03-25 00:00:00-04:00,0,3,0,2,0,2417,16726,19143
2015-03-25 01:00:00-04:00,0,3,1,2,0,2811,20666,23477
2015-03-25 02:00:00-04:00,0,3,2,2,0,3209,25946,29155
2015-03-25 03:00:00-04:00,0,3,3,2,0,3137,26843,29980
2015-03-25 04:00:00-04:00,0,3,4,2,0,2958,27181,30139
2015-03-25 05:00:00-04:00,0,3,5,2,0,2779,26847,29626
2015-03-25 06:00:00-04:00,0,3,6,2,0,2413,24717,27130
2015-03-25 07:00:00-04:00,0,3,7,2,0,2014,18744,20758
2015-03-25 08:00:00-04:00,0,3,8,2,0,1407,11740,13147
2015-03-25 09:00:00-04:00,0,3,9,2,0,947,6774,7721
2015-03-25 10:00:00-04:00,0,3,10,2,0,621,4164,4785
2015-03-25 11:00:00-04:00,0,3,11,2,0,431,2952,3383
2015-03-25 12:00:00-04:00,0,3,12,2,0,380,2679,3059
2015-03-25 13:00:00-04:00,0,3,13,2,0,397,4286,4683
2015-03-25 14:00:00-04:00,0,3,14,2,0,761,11296,12057
2015-03-25 15:00:00-04:00,0.01,3,15,2,0,1791,20058,21849
2015-03-25 16:00:00-04:00,0.02,3,16,2,0,2649,23713,26362
2015-03-25 17:00:00-04:00,0,3,17,2,0,2543,22260,24803
2015-03-25 18:00:00-04:00,0,3,18,2,0,2024,19458,21482
2015-03-25 19:00:00-04:00,0,3,19,2,0,1921,19340,21261
2015-03-25 20:00:00-04:00,0.02,3,20,2,0,1908,19935,21843
2015-03-25 21:00:00-04:00,0,3,21,2,0,2045,20206,22251
2015-03-25 22:00:00-04:00,0,3,22,2,0,2591,22439,25030
2015-03-25 23:00:00-04:00,0,3,23,2,0,3009,22096,25105
2015-03-26 00:00:00-04:00,0,3,0,3,0,3208,17089,20297
2015-03-26 01:00:00-04:00,0,3,1,3,0,3339,20734,24073
2015-03-26 02:00:00-04:00,0,3,2,3,0,3590,26054,29644
2015-03-26 03:00:00-04:00,0,3,3,3,0,3765,29255,33020
2015-03-26 04:00:00-04:00,0,3,4,3,0,3480,28275,31755
2015-03-26 05:00:00-04:00,0,3,5,3,0,2814,27192,30006
2015-03-26 06:00:00-04:00,0,3,6,3,0,2593,25205,27798
2015-03-26 07:00:00-04:00,0,3,7,3,0,2156,19826,21982
2015-03-26 08:00:00-04:00,0,3,8,3,0,1545,12735,14280
2015-03-26 09:00:00-04:00,0,3,9,3,0,1025,7377,8402
2015-03-26 10:00:00-04:00,0,3,10,3,0,653,4736,5389
2015-03-26 11:00:00-04:00,0,3,11,3,0,472,3060,3532
2015-03-26 12:00:00-04:00,0.02,3,12,3,0,419,2777,3196
2015-03-26 13:00:00-04:00,0,3,13,3,0,405,4291,4696
2015-03-26 14:00:00-04:00,0.03,3,14,3,0,755,11311,12066
2015-03-26 15:00:00-04:00,0,3,15,3,0,1826,20023,21849
2015-03-26 16:00:00-04:00,0,3,16,3,0,2719,24276,26995
2015-03-26 17:00:00-04:00,0,3,17,3,0,2680,23148,25828
2015-03-26 18:00:00-04:00,0,3,18,3,0,2208,20313,22521
2015-03-26 19:00:00-04:00,0,3,19,3,0,2063,20554,22617
2015-03-26 20:00:00-04:00,0,3,20,3,0,2192,21522,23714
2015-03-26 21:00:00-04:00,0,3,21,3,0,2081,19993,22074
2015-03-26 22:00:00-04:00,0.13,3,22,3,0,2564,21294,23858
2015-03-26 23:00:00-04:00,0.05,3,23,3,0,2632,18813,21445
2015-03-27 00:00:00-04:00,0.01,3,0,4,0,2829,15106,17935
2015-03-27 01:00:00-04:00,0,3,1,4,0,3353,19735,23088
2015-03-27 02:00:00-04:00,0.02,3,2,4,0,3716,25250,28966
2015-03-27 03:00:00-04:00,0.05,3,3,4,0,3643,26228,29871
2015-03-27 04:00:00-04:00,0.04,3,4,4,0,3377,26094,29471
2015-03-27 05:00:00-04:00,0.09,3,5,4,0,3348,27147,30495
2015-03-27 06:00:00-04:00,0.06,3,6,4,0,3702,27627,31329
2015-03-27 07:00:00-04:00,0.02,3,7,4,0,3047,24222,27269
2015-03-27 08:00:00-04:00,0,3,8,4,0,2287,19315,21602
2015-03-27 09:00:00-04:00,0,3,9,4,0,1561,12344,13905
2015-03-27 10:00:00-04:00,0,3,10,4,0,1065,7870,8935
2015-03-27 11:00:00-04:00,0,3,11,4,0,757,5291,6048
2015-03-27 12:00:00-04:00,0,3,12,4,0,652,4169,4821
2015-03-27 13:00:00-04:00,0,3,13,4,0,509,4973,5482
2015-03-27 14:00:00-04:00,0,3,14,4,0,830,12004,12834
2015-03-27 15:00:00-04:00,0,3,15,4,0,1883,20351,22234
2015-03-27 16:00:00-04:00,0,3,16,4,0,2787,23463,26250
2015-03-27 17:00:00-04:00,0,3,17,4,0,2712,22721,25433
2015-03-27 18:00:00-04:00,0,3,18,4,0,2340,20340,22680
2015-03-27 19:00:00-04:00,0,3,19,4,0,2141,20413,22554
2015-03-27 20:00:00-04:00,0,3,20,4,0,2051,21239,23290
2015-03-27 21:00:00-04:00,0,3,21,4,0,2036,20361,22397
2015-03-27 22:00:00-04:00,0,3,22,4,0,2579,21855,24434
2015-03-27 23:00:00-04:00,0,3,23,4,0,3018,20029,23047
2015-03-28 00:00:00-04:00,0,3,0,5,0,3181,16729,19910
2015-03-28 01:00:00-04:00,0,3,1,5,0,3754,21167,24921
2015-03-28 02:00:00-04:00,0,3,2,5,0,4373,27563,31936
2015-03-28 03:00:00-04:00,0,3,3,5,0,4493,29944,34437
2015-03-28 04:00:00-04:00,0,3,4,5,0,4462,28082,32544
2015-03-28 05:00:00-04:00,0,3,5,5,0,4402,27859,32261
2015-03-28 06:00:00-04:00,0,3,6,5,0,4684,28675,33359
2015-03-28 07:00:00-04:00,0,3,7,5,0,4762,28736,33498
2015-03-28 08:00:00-04:00,0,3,8,5,0,4391,27465,31856
2015-03-28 09:00:00-04:00,0,3,9,5,0,3829,23091,26920
2015-03-28 10:00:00-04:00,0,3,10,5,0,3150,19654,22804
2015-03-28 11:00:00-04:00,0,3,11,5,0,2589,14743,17332
2015-03-28 12:00:00-04:00,0,3,12,5,0,1939,9462,11401
2015-03-28 13:00:00-04:00,0,3,13,5,0,941,4366,5307
2015-03-28 14:00:00-04:00,0,3,14,5,0,727,5429,6156
2015-03-28 15:00:00-04:00,0,3,15,5,0,912,7828,8740
2015-03-28 16:00:00-04:00,0,3,16,5,0,1395,11807,13202
2015-03-28 17:00:00-04:00,0,3,17,5,0,1885,16918,18803
2015-03-28 18:00:00-04:00,0,3,18,5,0,2244,20280,22524
2015-03-28 19:00:00-04:00,0,3,19,5,0,2440,23959,26399
2015-03-28 20:00:00-04:00,0,3,20,5,0,2779,25897,28676
2015-03-28 21:00:00-04:00,0,3,21,5,0,2776,25489,28265
2015-03-28 22:00:00-04:00,0,3,22,5,0,2780,23799,26579
2015-03-28 23:00:00-04:00,0,3,23,5,0,3232,23567,26799
2015-03-29 00:00:00-04:00,0,3,0,6,0,3418,21470,24888
2015-03-29 01:00:00-04:00,0,3,1,6,0,3804,24815,28619
2015-03-29 02:00:00-04:00,0,3,2,6,0,4500,29496,33996
2015-03-29 03:00:00-04:00,0,3,3,6,0,4949,31232,36181
2015-03-29 04:00:00-04:00,0,3,4,6,0,5161,29071,34232
2015-03-29 05:00:00-04:00,0,3,5,6,0,5436,28226,33662
2015-03-29 06:00:00-04:00,0,3,6,6,0,5255,30138,35393
2015-03-29 07:00:00-04:00,0,3,7,6,0,5694,32149,37843
2015-03-29 08:00:00-04:00,0,3,8,6,0,5266,28792,34058
2015-03-29 09:00:00-04:00,0,3,9,6,0,4502,25149,29651
2015-03-29 10:00:00-04:00,0,3,10,6,0,3937,21465,25402
2015-03-29 11:00:00-04:00,0,3,11,6,0,3269,17116,20385
2015-03-29 12:00:00-04:00,0,3,12,6,0,2482,10810,13292
2015-03-29 13:00:00-04:00,0,3,13,6,0,1168,4686,5854
2015-03-29 14:00:00-04:00,0,3,14,6,0,755,4604,5359
2015-03-29 15:00:00-04:00,0,3,15,6,0,752,6046,6798
2015-03-29 16:00:00-04:00,0,3,16,6,0,883,9339,10222
2015-03-29 17:00:00-04:00,0,3,17,6,0,1326,13902,15228
2015-03-29 18:00:00-04:00,0,3,18,6,0,1830,19142,20972
2015-03-29 19:00:00-04:00,0,3,19,6,0,2190,22118,24308
2015-03-29 20:00:00-04:00,0,3,20,6,0,2290,23426,25716
2015-03-29 21:00:00-04:00,0,3,21,6,0,2367,22945,25312
2015-03-29 22:00:00-04:00,0,3,22,6,0,2695,22458,25153
2015-03-29 23:00:00-04:00,0,3,23,6,0,2730,20737,23467
2015-03-30 00:00:00-04:00,0,3,0,0,0,2908,19332,22240
2015-03-30 01:00:00-04:00,0,3,1,0,0,3090,20972,24062
2015-03-30 02:00:00-04:00,0,3,2,0,0,3320,22092,25412
2015-03-30 03:00:00-04:00,0,3,3,0,0,3313,21453,24766
2015-03-30 04:00:00-04:00,0,3,4,0,0,3243,19792,23035
2015-03-30 05:00:00-04:00,0,3,5,0,0,2860,18478,21338
2015-03-30 06:00:00-04:00,0,3,6,0,0,2604,16518,19122
2015-03-30 07:00:00-04:00,0,3,7,0,0,2204,12895,15099
2015-03-30 08:00:00-04:00,0,3,8,0,0,1582,8102,9684
2015-03-30 09:00:00-04:00,0,3,9,0,0,1014,5020,6034
2015-03-30 10:00:00-04:00,0,3,10,0,0,689,3219,3908
2015-03-30 11:00:00-04:00,0,3,11,0,0,532,2304,2836
2015-03-30 12:00:00-04:00,0,3,12,0,0,524,2514,3038
2015-03-30 13:00:00-04:00,0,3,13,0,0,444,4483,4927
2015-03-30 14:00:00-04:00,0,3,14,0,0,790,11817,12607
2015-03-30 15:00:00-04:00,0,3,15,0,0,1786,19973,21759
2015-03-30 16:00:00-04:00,0,3,16,0,0,2718,23030,25748
2015-03-30 17:00:00-04:00,0,3,17,0,0,2593,21769,24362
2015-03-30 18:00:00-04:00,0,3,18,0,0,2205,19351,21556
2015-03-30 19:00:00-04:00,0,3,19,0,0,1977,19041,21018
2015-03-30 20:00:00-04:00,0,3,20,0,0,1836,18927,20763
2015-03-30 21:00:00-04:00,0,3,21,0,0,1790,18451,20241
2015-03-30 22:00:00-04:00,0,3,22,0,0,2059,19698,21757
2015-03-30 23:00:00-04:00,0,3,23,0,0,2244,19834,22078
2015-03-31 00:00:00-04:00,0,3,0,1,0,2515,17486,20001
2015-03-31 01:00:00-04:00,0,3,1,1,0,2876,21271,24147
2015-03-31 02:00:00-04:00,0,3,2,1,0,3016,25166,28182
2015-03-31 03:00:00-04:00,0,3,3,1,0,2828,24932,27760
2015-03-31 04:00:00-04:00,0,3,4,1,0,2762,24720,27482
2015-03-31 05:00:00-04:00,0,3,5,1,0,2346,23406,25752
2015-03-31 06:00:00-04:00,0,3,6,1,0,2153,20646,22799
2015-03-31 07:00:00-04:00,0,3,7,1,0,1791,15844,17635
2015-03-31 08:00:00-04:00,0,3,8,1,0,1320,10441,11761
2015-03-31 09:00:00-04:00,0,3,9,1,0,849,5857,6706
2015-03-31 10:00:00-04:00,0,3,10,1,0,459,3617,4076
2015-03-31 11:00:00-04:00,0,3,11,1,0,399,2510,2909
2015-03-31 12:00:00-04:00,0,3,12,1,0,428,2328,2756
2015-03-31 13:00:00-04:00,0,3,13,1,0,377,4123,4500
2015-03-31 14:00:00-04:00,0.02,3,14,1,0,772,11708,12480
2015-03-31 15:00:00-04:00,0.05,3,15,1,0,1833,21396,23229
2015-03-31 16:00:00-04:00,0,3,16,1,0,2739,24144,26883
2015-03-31 17:00:00-04:00,0,3,17,1,0,2424,22284,24708
2015-03-31 18:00:00-04:00,0.01,3,18,1,0,2056,20213,22269
2015-03-31 19:00:00-04:00,0.01,3,19,1,0,1929,19962,21891
2015-03-31 20:00:00-04:00,0.04,3,20,1,0,1929,20479,22408
2015-03-31 21:00:00-04:00,0.01,3,21,1,0,2143,22289,24432
2015-03-31 22:00:00-04:00,0,3,22,1,0,2526,23628,26154
2015-03-31 23:00:00-04:00,0,3,23,1,0,3045,22345,25390
2015-04-01 00:00:00-04:00,0,4,0,2,0,2943,17239,20182
2015-04-01 01:00:00-04:00,0,4,1,2,0,3165,21536,24701
2015-04-01 02:00:00-04:00,0,4,2,2,0,3900,26972,30872
2015-04-01 03:00:00-04:00,0,4,3,2,0,3898,28162,32060
2015-04-01 04:00:00-04:00,0,4,4,2,0,3917,28638,32555
2015-04-01 05:00:00-04:00,0,4,5,2,0,3075,26625,29700
2015-04-01 06:00:00-04:00,0,4,6,2,0,2717,24394,27111
2015-04-01 07:00:00-04:00,0,4,7,2,0,2292,19024,21316
2015-04-01 08:00:00-04:00,0,4,8,2,0,1665,12326,13991
2015-04-01 09:00:00-04:00,0,4,9,2,0,1027,7214,8241
2015-04-01 10:00:00-04:00,0,4,10,2,0,645,4451,5096
2015-04-01 11:00:00-04:00,0,4,11,2,0,458,2965,3423
2015-04-01 12:00:00-04:00,0,4,12,2,0,478,2853,3331
2015-04-01 13:00:00-04:00,0,4,13,2,0,371,4533,4904
2015-04-01 14:00:00-04:00,0,4,14,2,0,761,12547,13308
2015-04-01 15:00:00-04:00,0,4,15,2,0,1861,22313,24174
2015-04-01 16:00:00-04:00,0,4,16,2,0,2859,25628,28487
2015-04-01 17:00:00-04:00,0,4,17,2,0,2645,23677,26322
2015-04-01 18:00:00-04:00,0,4,18,2,0,2216,20902,23118
2015-04-01 19:00:00-04:00,0,4,19,2,0,2064,20523,22587
2015-04-01 20:00:00-04:00,0,4,20,2,0,2096,21266,23362
2015-04-01 21:00:00-04:00,0,4,21,2,0,2155,20828,22983
2015-04-01 22:00:00-04:00,0,4,22,2,0,2463,22102,24565
2015-04-01 23:00:00-04:00,0,4,23,2,0,2622,20427,23049
2015-04-02 00:00:00-04:00,0,4,0,3,0,2793,16467,19260
2015-04-02 01:00:00-04:00,0,4,1,3,0,3145,20762,23907
2015-04-02 02:00:00-04:00,0,4,2,3,0,3647,26533,30180
2015-04-02 03:00:00-04:00,0,4,3,3,0,3595,28586,32181
2015-04-02 04:00:00-04:00,0,4,4,3,0,3630,28359,31989
2015-04-02 05:00:00-04:00,0,4,5,3,0,3329,27822,31151
2015-04-02 06:00:00-04:00,0,4,6,3,0,2980,25988,28968
2015-04-02 07:00:00-04:00,0,4,7,3,0,2438,21174,23612
2015-04-02 08:00:00-04:00,0,4,8,3,0,1860,14333,16193
2015-04-02 09:00:00-04:00,0,4,9,3,0,1242,8372,9614
2015-04-02 10:00:00-04:00,0,4,10,3,0,756,5320,6076
2015-04-02 11:00:00-04:00,0,4,11,3,0,510,3386,3896
2015-04-02 12:00:00-04:00,0,4,12,3,0,518,3184,3702
2015-04-02 13:00:00-04:00,0,4,13,3,0,446,4500,4946
2015-04-02 14:00:00-04:00,0,4,14,3,0,818,11725,12543
2015-04-02 15:00:00-04:00,0,4,15,3,0,1830,21771,23601
2015-04-02 16:00:00-04:00,0,4,16,3,0,2668,25299,27967
2015-04-02 17:00:00-04:00,0,4,17,3,0,2646,22901,25547
2015-04-02 18:00:00-04:00,0,4,18,3,0,2277,20724,23001
2015-04-02 19:00:00-04:00,0,4,19,3,0,2089,21168,23257
2015-04-02 20:00:00-04:00,0,4,20,3,0,2167,21688,23855
2015-04-02 21:00:00-04:00,0,4,21,3,0,2142,21146,23288
2015-04-02 22:00:00-04:00,0,4,22,3,0,2453,22533,24986
2015-04-02 23:00:00-04:00,0,4,23,3,0,2614,20501,23115
2015-04-03 00:00:00-04:00,0,4,0,4,0,2924,16149,19073
2015-04-03 01:00:00-04:00,0,4,1,4,0,3373,20308,23681
2015-04-03 02:00:00-04:00,0,4,2,4,0,3950,26059,30009
2015-04-03 03:00:00-04:00,0,4,3,4,0,4005,27294,31299
2015-04-03 04:00:00-04:00,0,4,4,4,0,3931,27711,31642
2015-04-03 05:00:00-04:00,0,4,5,4,0,3842,27164,31006
2015-04-03 06:00:00-04:00,0,4,6,4,0,3580,26377,29957
2015-04-03 07:00:00-04:00,0,4,7,4,0,3287,24687,27974
2015-04-03 08:00:00-04:00,0,4,8,4,0,2567,21065,23632
2015-04-03 09:00:00-04:00,0,4,9,4,0,1957,15128,17085
2015-04-03 10:00:00-04:00,0,4,10,4,0,1336,10382,11718
2015-04-03 11:00:00-04:00,0.01,4,11,4,0,981,7163,8144
2015-04-03 12:00:00-04:00,0.01,4,12,4,0,797,5354,6151
2015-04-03 13:00:00-04:00,0.02,4,13,4,0,525,4608,5133
2015-04-03 14:00:00-04:00,0,4,14,4,0,622,8191,8813
2015-04-03 15:00:00-04:00,0,4,15,4,0,1091,12599,13690
2015-04-03 16:00:00-04:00,0,4,16,4,0,1910,17712,19622
2015-04-03 17:00:00-04:00,0,4,17,4,0,2405,21276,23681
2015-04-03 18:00:00-04:00,0,4,18,4,0,2340,22415,24755
2015-04-03 19:00:00-04:00,0,4,19,4,0,2285,22450,24735
2015-04-03 20:00:00-04:00,0,4,20,4,0,2275,23838,26113
2015-04-03 21:00:00-04:00,0,4,21,4,0,2125,22603,24728
2015-04-03 22:00:00-04:00,0,4,22,4,0,2395,22370,24765
2015-04-03 23:00:00-04:00,0,4,23,4,0,2941,20889,23830
2015-04-04 00:00:00-04:00,0,4,0,5,0,3216,17832,21048
2015-04-04 01:00:00-04:00,0,4,1,5,0,3785,22325,26110
2015-04-04 02:00:00-04:00,0,4,2,5,0,4277,26183,30460
2015-04-04 03:00:00-04:00,0,4,3,5,0,4082,25104,29186
2015-04-04 04:00:00-04:00,0,4,4,5,0,4039,22350,26389
2015-04-04 05:00:00-04:00,0,4,5,5,0,3960,22467,26427
2015-04-04 06:00:00-04:00,0,4,6,5,0,4254,24913,29167
2015-04-04 07:00:00-04:00,0,4,7,5,0,4269,24860,29129
2015-04-04 08:00:00-04:00,0,4,8,5,0,4028,22606,26634
2015-04-04 09:00:00-04:00,0,4,9,5,0,3524,19341,22865
2015-04-04 10:00:00-04:00,0,4,10,5,0,2909,15973,18882
2015-04-04 11:00:00-04:00,0,4,11,5,0,2258,12409,14667
2015-04-04 12:00:00-04:00,0,4,12,5,0,1733,8446,10179
2015-04-04 13:00:00-04:00,0,4,13,5,0,850,4069,4919
2015-04-04 14:00:00-04:00,0,4,14,5,0,679,4875,5554
2015-04-04 15:00:00-04:00,0,4,15,5,0,801,6935,7736
2015-04-04 16:00:00-04:00,0,4,16,5,0,1030,9332,10362
2015-04-04 17:00:00-04:00,0,4,17,5,0,1465,14132,15597
2015-04-04 18:00:00-04:00,0,4,18,5,0,1956,18025,19981
2015-04-04 19:00:00-04:00,0,4,19,5,0,2245,20793,23038
2015-04-04 20:00:00-04:00,0,4,20,5,0,2376,22379,24755
2015-04-04 21:00:00-04:00,0,4,21,5,0,2488,22677,25165
2015-04-04 22:00:00-04:00,0,4,22,5,0,2791,21903,24694
2015-04-04 23:00:00-04:00,0,4,23,5,0,3096,22337,25433
2015-04-05 00:00:00-04:00,0,4,0,6,0,3286,20338,23624
2015-04-05 01:00:00-04:00,0,4,1,6,0,3688,23570,27258
2015-04-05 02:00:00-04:00,0,4,2,6,0,4089,25829,29918
2015-04-05 03:00:00-04:00,0,4,3,6,0,4309,25899,30208
2015-04-05 04:00:00-04:00,0,4,4,6,0,4498,23316,27814
2015-04-05 05:00:00-04:00,0,4,5,6,0,4571,23082,27653
2015-04-05 06:00:00-04:00,0,4,6,6,0,4767,24908,29675
2015-04-05 07:00:00-04:00,0,4,7,6,0,4936,26996,31932
2015-04-05 08:00:00-04:00,0,4,8,6,0,4447,22894,27341
2015-04-05 09:00:00-04:00,0,4,9,6,0,4069,19465,23534
2015-04-05 10:00:00-04:00,0,4,10,6,0,3281,16190,19471
2015-04-05 11:00:00-04:00,0,4,11,6,0,2717,12644,15361
2015-04-05 12:00:00-04:00,0,4,12,6,0,2136,8787,10923
2015-04-05 13:00:00-04:00,0,4,13,6,0,1033,4094,5127
2015-04-05 14:00:00-04:00,0,4,14,6,0,723,4227,4950
2015-04-05 15:00:00-04:00,0,4,15,6,0,703,5492,6195
2015-04-05 16:00:00-04:00,0,4,16,6,0,915,8500,9415
2015-04-05 17:00:00-04:00,0,4,17,6,0,1399,12350,13749
2015-04-05 18:00:00-04:00,0,4,18,6,0,1951,17505,19456
2015-04-05 19:00:00-04:00,0,4,19,6,0,2188,19202,21390
2015-04-05 20:00:00-04:00,0,4,20,6,0,2310,20451,22761
2015-04-05 21:00:00-04:00,0,4,21,6,0,2505,21402,23907
2015-04-05 22:00:00-04:00,0,4,22,6,0,2865,20725,23590
2015-04-05 23:00:00-04:00,0,4,23,6,0,3013,20322,23335
2015-04-06 00:00:00-04:00,0,4,0,0,0,2930,18522,21452
2015-04-06 01:00:00-04:00,0,4,1,0,0,2882,19180,22062
2015-04-06 02:00:00-04:00,0,4,2,0,0,2955,20144,23099
2015-04-06 03:00:00-04:00,0,4,3,0,0,2893,19018,21911
2015-04-06 04:00:00-04:00,0,4,4,0,0,2948,18543,21491
2015-04-06 05:00:00-04:00,0,4,5,0,0,2896,18298,21194
2015-04-06 06:00:00-04:00,0,4,6,0,0,2687,16523,19210
2015-04-06 07:00:00-04:00,0,4,7,0,0,2299,12984,15283
2015-04-06 08:00:00-04:00,0,4,8,0,0,1693,8397,10090
2015-04-06 09:00:00-04:00,0,4,9,0,0,1141,4780,5921
2015-04-06 10:00:00-04:00,0,4,10,0,0,681,3126,3807
2015-04-06 11:00:00-04:00,0,4,11,0,0,475,2177,2652
2015-04-06 12:00:00-04:00,0,4,12,0,0,515,2509,3024
2015-04-06 13:00:00-04:00,0,4,13,0,0,435,4187,4622
2015-04-06 14:00:00-04:00,0,4,14,0,0,735,10089,10824
2015-04-06 15:00:00-04:00,0,4,15,0,0,1353,17235,18588
2015-04-06 16:00:00-04:00,0,4,16,0,0,2195,21000,23195
2015-04-06 17:00:00-04:00,0,4,17,0,0,2528,20521,23049
2015-04-06 18:00:00-04:00,0,4,18,0,0,2085,18286,20371
2015-04-06 19:00:00-04:00,0,4,19,0,0,1958,18459,20417
2015-04-06 20:00:00-04:00,0,4,20,0,0,1805,18559,20364
2015-04-06 21:00:00-04:00,0,4,21,0,0,1806,18566,20372
2015-04-06 22:00:00-04:00,0,4,22,0,0,1951,19208,21159
2015-04-06 23:00:00-04:00,0,4,23,0,0,2179,19242,21421
2015-04-07 00:00:00-04:00,0,4,0,1,0,2282,17510,19792
2015-04-07 01:00:00-04:00,0,4,1,1,0,2595,20501,23096
2015-04-07 02:00:00-04:00,0,4,2,1,0,2947,24340,27287
2015-04-07 03:00:00-04:00,0,4,3,1,0,2765,24340,27105
2015-04-07 04:00:00-04:00,0,4,4,1,0,2784,23824,26608
2015-04-07 05:00:00-04:00,0,4,5,1,0,2553,22405,24958
2015-04-07 06:00:00-04:00,0,4,6,1,0,2081,18916,20997
2015-04-07 07:00:00-04:00,0.01,4,7,1,0,1941,17577,19518
2015-04-07 08:00:00-04:00,0,4,8,1,0,1388,10393,11781
2015-04-07 09:00:00-04:00,0,4,9,1,0,959,6101,7060
2015-04-07 10:00:00-04:00,0,4,10,1,0,571,3701,4272
2015-04-07 11:00:00-04:00,0,4,11,1,0,438,2536,2974
2015-04-07 12:00:00-04:00,0,4,12,1,0,392,2389,2781
2015-04-07 13:00:00-04:00,0,4,13,1,0,359,3912,4271
2015-04-07 14:00:00-04:00,0,4,14,1,0,667,10755,11422
2015-04-07 15:00:00-04:00,0,4,15,1,0,1439,19650,21089
2015-04-07 16:00:00-04:00,0,4,16,1,0,2357,23312,25669
2015-04-07 17:00:00-04:00,0,4,17,1,0,2431,22308,24739
2015-04-07 18:00:00-04:00,0,4,18,1,0,2016,19601,21617
2015-04-07 19:00:00-04:00,0.1,4,19,1,0,1860,19377,21237
2015-04-07 20:00:00-04:00,0.01,4,20,1,0,1930,20927,22857
2015-04-07 21:00:00-04:00,0,4,21,1,0,1916,20942,22858
2015-04-07 22:00:00-04:00,0.03,4,22,1,0,2052,21710,23762
2015-04-07 23:00:00-04:00,0.01,4,23,1,0,2351,20943,23294
2015-04-08 00:00:00-04:00,0.01,4,0,2,0,2672,17897,20569
2015-04-08 01:00:00-04:00,0,4,1,2,0,3007,22730,25737
2015-04-08 02:00:00-04:00,0,4,2,2,0,3571,28754,32325
2015-04-08 03:00:00-04:00,0,4,3,2,0,3906,31195,35101
2015-04-08 04:00:00-04:00,0,4,4,2,0,3312,27450,30762
2015-04-08 05:00:00-04:00,0,4,5,2,0,2855,26287,29142
2015-04-08 06:00:00-04:00,0,4,6,2,0,2646,24668,27314
2015-04-08 07:00:00-04:00,0,4,7,2,0,2309,18371,20680
2015-04-08 08:00:00-04:00,0,4,8,2,0,1635,11245,12880
2015-04-08 09:00:00-04:00,0,4,9,2,0,1058,6542,7600
2015-04-08 10:00:00-04:00,0,4,10,2,0,684,4207,4891
2015-04-08 11:00:00-04:00,0,4,11,2,0,438,2846,3284
2015-04-08 12:00:00-04:00,0,4,12,2,0,405,2600,3005
2015-04-08 13:00:00-04:00,0,4,13,2,0,365,4152,4517
2015-04-08 14:00:00-04:00,0,4,14,2,0,679,11169,11848
2015-04-08 15:00:00-04:00,0,4,15,2,0,1403,19865,21268
2015-04-08 16:00:00-04:00,0,4,16,2,0,2301,24235,26536
2015-04-08 17:00:00-04:00,0,4,17,2,0,2382,23229,25611
2015-04-08 18:00:00-04:00,0,4,18,2,0,2121,21327,23448
2015-04-08 19:00:00-04:00,0,4,19,2,0,1969,21069,23038
2015-04-08 20:00:00-04:00,0,4,20,2,0,2001,21980,23981
2015-04-08 21:00:00-04:00,0,4,21,2,0,2063,21583,23646
2015-04-08 22:00:00-04:00,0,4,22,2,0,2315,22638,24953
2015-04-08 23:00:00-04:00,0,4,23,2,0,2422,21380,23802
2015-04-09 00:00:00-04:00,0,4,0,3,0,2783,17962,20745
2015-04-09 01:00:00-04:00,0,4,1,3,0,3179,21636,24815
2015-04-09 02:00:00-04:00,0,4,2,3,0,3510,26781,30291
2015-04-09 03:00:00-04:00,0,4,3,3,0,3551,28822,32373
2015-04-09 04:00:00-04:00,0,4,4,3,0,3528,29603,33131
2015-04-09 05:00:00-04:00,0,4,5,3,0,3454,28752,32206
2015-04-09 06:00:00-04:00,0,4,6,3,0,3275,27312,30587
2015-04-09 07:00:00-04:00,0,4,7,3,0,2875,22557,25432
2015-04-09 08:00:00-04:00,0,4,8,3,0,1929,14427,16356
2015-04-09 09:00:00-04:00,0,4,9,3,0,1282,8094,9376
2015-04-09 10:00:00-04:00,0,4,10,3,0,824,5046,5870
2015-04-09 11:00:00-04:00,0,4,11,3,0,573,3376,3949
2015-04-09 12:00:00-04:00,0,4,12,3,0,523,3107,3630
2015-04-09 13:00:00-04:00,0,4,13,3,0,379,4480,4859
2015-04-09 14:00:00-04:00,0,4,14,3,0,666,11381,12047
2015-04-09 15:00:00-04:00,0,4,15,3,0,1471,20247,21718
2015-04-09 16:00:00-04:00,0,4,16,3,0,2380,24849,27229
2015-04-09 17:00:00-04:00,0,4,17,3,0,2556,24445,27001
2015-04-09 18:00:00-04:00,0,4,18,3,0,2199,21892,24091
2015-04-09 19:00:00-04:00,0,4,19,3,0,2095,21467,23562
2015-04-09 20:00:00-04:00,0,4,20,3,0,2001,22962,24963
2015-04-09 21:00:00-04:00,0,4,21,3,0,2110,22521,24631
2015-04-09 22:00:00-04:00,0,4,22,3,0,2185,22969,25154
2015-04-09 23:00:00-04:00,0,4,23,3,0,2545,21704,24249
2015-04-10 00:00:00-04:00,0.01,4,0,4,0,2792,17656,20448
2015-04-10 01:00:00-04:00,0.01,4,1,4,0,3269,22343,25612
2015-04-10 02:00:00-04:00,0,4,2,4,0,3764,28106,31870
2015-04-10 03:00:00-04:00,0,4,3,4,0,3508,29502,33010
2015-04-10 04:00:00-04:00,0.1,4,4,4,0,3402,28982,32384
2015-04-10 05:00:00-04:00,0.02,4,5,4,0,3268,29044,32312
2015-04-10 06:00:00-04:00,0.11,4,6,4,0,3176,27224,30400
2015-04-10 07:00:00-04:00,0,4,7,4,0,2907,24652,27559
2015-04-10 08:00:00-04:00,0,4,8,4,0,2305,18551,20856
2015-04-10 09:00:00-04:00,0,4,9,4,0,1602,11556,13158
2015-04-10 10:00:00-04:00,0,4,10,4,0,976,7443,8419
2015-04-10 11:00:00-04:00,0,4,11,4,0,670,5026,5696
2015-04-10 12:00:00-04:00,0,4,12,4,0,610,4122,4732
2015-04-10 13:00:00-04:00,0,4,13,4,0,435,4837,5272
2015-04-10 14:00:00-04:00,0,4,14,4,0,739,11862,12601
2015-04-10 15:00:00-04:00,0,4,15,4,0,1474,19683,21157
2015-04-10 16:00:00-04:00,0,4,16,4,0,2354,24233,26587
2015-04-10 17:00:00-04:00,0,4,17,4,0,2683,23605,26288
2015-04-10 18:00:00-04:00,0,4,18,4,0,2286,21293,23579
2015-04-10 19:00:00-04:00,0,4,19,4,0,2068,21123,23191
2015-04-10 20:00:00-04:00,0,4,20,4,0,1950,21722,23672
2015-04-10 21:00:00-04:00,0,4,21,4,0,1886,20827,22713
2015-04-10 22:00:00-04:00,0,4,22,4,0,2310,22553,24863
2015-04-10 23:00:00-04:00,0,4,23,4,0,2697,20994,23691
2015-04-11 00:00:00-04:00,0,4,0,5,0,3031,18412,21443
2015-04-11 01:00:00-04:00,0,4,1,5,0,3701,22948,26649
2015-04-11 02:00:00-04:00,0,4,2,5,0,4110,28056,32166
2015-04-11 03:00:00-04:00,0,4,3,5,0,4140,29477,33617
2015-04-11 04:00:00-04:00,0,4,4,5,0,4263,27393,31656
2015-04-11 05:00:00-04:00,0,4,5,5,0,4133,26817,30950
2015-04-11 06:00:00-04:00,0,4,6,5,0,4320,27564,31884
2015-04-11 07:00:00-04:00,0,4,7,5,0,4510,27980,32490
2015-04-11 08:00:00-04:00,0,4,8,5,0,4409,26130,30539
2015-04-11 09:00:00-04:00,0,4,9,5,0,3892,22461,26353
2015-04-11 10:00:00-04:00,0,4,10,5,0,3271,18762,22033
2015-04-11 11:00:00-04:00,0,4,11,5,0,2636,13794,16430
2015-04-11 12:00:00-04:00,0,4,12,5,0,1937,8824,10761
2015-04-11 13:00:00-04:00,0,4,13,5,0,882,4244,5126
2015-04-11 14:00:00-04:00,0,4,14,5,0,729,5437,6166
2015-04-11 15:00:00-04:00,0,4,15,5,0,870,7531,8401
2015-04-11 16:00:00-04:00,0,4,16,5,0,1256,12001,13257
2015-04-11 17:00:00-04:00,0,4,17,5,0,1757,16234,17991
2015-04-11 18:00:00-04:00,0,4,18,5,0,2114,19443,21557
2015-04-11 19:00:00-04:00,0,4,19,5,0,2285,21741,24026
2015-04-11 20:00:00-04:00,0,4,20,5,0,2425,23158,25583
2015-04-11 21:00:00-04:00,0,4,21,5,0,2589,23045,25634
2015-04-11 22:00:00-04:00,0,4,22,5,0,2805,21834,24639
2015-04-11 23:00:00-04:00,0,4,23,5,0,3052,21408,24460
2015-04-12 00:00:00-04:00,0,4,0,6,0,3329,18866,22195
2015-04-12 01:00:00-04:00,0,4,1,6,0,3710,21981,25691
2015-04-12 02:00:00-04:00,0,4,2,6,0,4386,26848,31234
2015-04-12 03:00:00-04:00,0,4,3,6,0,4681,27736,32417
2015-04-12 04:00:00-04:00,0,4,4,6,0,4796,27028,31824
2015-04-12 05:00:00-04:00,0,4,5,6,0,4761,27206,31967
2015-04-12 06:00:00-04:00,0,4,6,6,0,5183,28388,33571
2015-04-12 07:00:00-04:00,0,4,7,6,0,5189,29630,34819
2015-04-12 08:00:00-04:00,0,4,8,6,0,5044,28093,33137
2015-04-12 09:00:00-04:00,0,4,9,6,0,4602,24670,29272
2015-04-12 10:00:00-04:00,0,4,10,6,0,3900,21538,25438
2015-04-12 11:00:00-04:00,0,4,11,6,0,3147,16265,19412
2015-04-12 12:00:00-04:00,0,4,12,6,0,2293,10044,12337
2015-04-12 13:00:00-04:00,0,4,13,6,0,1177,4419,5596
2015-04-12 14:00:00-04:00,0,4,14,6,0,712,4670,5382
2015-04-12 15:00:00-04:00,0,4,15,6,0,697,6176,6873
2015-04-12 16:00:00-04:00,0,4,16,6,0,916,8789,9705
2015-04-12 17:00:00-04:00,0,4,17,6,0,1269,13315,14584
2015-04-12 18:00:00-04:00,0,4,18,6,0,1600,17365,18965
2015-04-12 19:00:00-04:00,0,4,19,6,0,1940,20165,22105
2015-04-12 20:00:00-04:00,0,4,20,6,0,2124,22211,24335
2015-04-12 21:00:00-04:00,0,4,21,6,0,2214,21543,23757
2015-04-12 22:00:00-04:00,0,4,22,6,0,2558,21508,24066
2015-04-12 23:00:00-04:00,0,4,23,6,0,2740,20497,23237
2015-04-13 00:00:00-04:00,0,4,0,0,0,2940,19270,22210
2015-04-13 01:00:00-04:00,0,4,1,0,0,3056,20051,23107
2015-04-13 02:00:00-04:00,0,4,2,0,0,3218,21065,24283
2015-04-13 03:00:00-04:00,0,4,3,0,0,3470,20787,24257
2015-04-13 04:00:00-04:00,0,4,4,0,0,3335,19523,22858
2015-04-13 05:00:00-04:00,0,4,5,0,0,2740,16942,19682
2015-04-13 06:00:00-04:00,0,4,6,0,0,2728,15638,18366
2015-04-13 07:00:00-04:00,0,4,7,0,0,2468,12798,15266
2015-04-13 08:00:00-04:00,0,4,8,0,0,1812,8939,10751
2015-04-13 09:00:00-04:00,0,4,9,0,0,1120,5032,6152
2015-04-13 10:00:00-04:00,0,4,10,0,0,750,3276,4026
2015-04-13 11:00:00-04:00,0,4,11,0,0,519,2176,2695
2015-04-13 12:00:00-04:00,0,4,12,0,0,573,2554,3127
2015-04-13 13:00:00-04:00,0,4,13,0,0,400,4393,4793
2015-04-13 14:00:00-04:00,0,4,14,0,0,823,11529,12352
2015-04-13 15:00:00-04:00,0,4,15,0,0,1716,19359,21075
2015-04-13 16:00:00-04:00,0,4,16,0,0,2615,22282,24897
2015-04-13 17:00:00-04:00,0,4,17,0,0,2383,20524,22907
2015-04-13 18:00:00-04:00,0,4,18,0,0,2024,17959,19983
2015-04-13 19:00:00-04:00,0,4,19,0,0,1813,17682,19495
2015-04-13 20:00:00-04:00,0,4,20,0,0,1737,17989,19726
2015-04-13 21:00:00-04:00,0,4,21,0,0,1785,17604,19389
2015-04-13 22:00:00-04:00,0,4,22,0,0,2060,19570,21630
2015-04-13 23:00:00-04:00,0,4,23,0,0,2317,19460,21777
2015-04-14 00:00:00-04:00,0,4,0,1,0,2444,17745,20189
2015-04-14 01:00:00-04:00,0,4,1,1,0,2758,20972,23730
2015-04-14 02:00:00-04:00,0,4,2,1,0,2983,24845,27828
2015-04-14 03:00:00-04:00,0,4,3,1,0,2922,24327,27249
2015-04-14 04:00:00-04:00,0,4,4,1,0,2589,23562,26151
2015-04-14 05:00:00-04:00,0,4,5,1,0,2425,22544,24969
2015-04-14 06:00:00-04:00,0,4,6,1,0,2066,18809,20875
2015-04-14 07:00:00-04:00,0,4,7,1,0,1684,14026,15710
2015-04-14 08:00:00-04:00,0,4,8,1,0,1268,9471,10739
2015-04-14 09:00:00-04:00,0,4,9,1,0,786,5557,6343
2015-04-14 10:00:00-04:00,0,4,10,1,0,494,3332,3826
2015-04-14 11:00:00-04:00,0,4,11,1,0,374,2210,2584
2015-04-14 12:00:00-04:00,0,4,12,1,0,417,2136,2553
2015-04-14 13:00:00-04:00,0,4,13,1,0,354,3879,4233
2015-04-14 14:00:00-04:00,0,4,14,1,0,718,11557,12275
2015-04-14 15:00:00-04:00,0,4,15,1,0,1810,21115,22925
2015-04-14 16:00:00-04:00,0,4,16,1,0,2680,25030,27710
2015-04-14 17:00:00-04:00,0,4,17,1,0,2403,22191,24594
2015-04-14 18:00:00-04:00,0,4,18,1,0,2076,19850,21926
2015-04-14 19:00:00-04:00,0,4,19,1,0,1911,19050,20961
2015-04-14 20:00:00-04:00,0,4,20,1,0,1900,19571,21471
2015-04-14 21:00:00-04:00,0,4,21,1,0,1851,19553,21404
2015-04-14 22:00:00-04:00,0,4,22,1,0,2136,21285,23421
2015-04-14 23:00:00-04:00,0,4,23,1,0,2302,20115,22417
2015-04-15 00:00:00-04:00,0,4,0,2,0,2525,17813,20338
2015-04-15 01:00:00-04:00,0,4,1,2,0,2799,22370,25169
2015-04-15 02:00:00-04:00,0,4,2,2,0,3196,26915,30111
2015-04-15 03:00:00-04:00,0,4,3,2,0,2892,26774,29666
2015-04-15 04:00:00-04:00,0,4,4,2,0,2699,25940,28639
2015-04-15 05:00:00-04:00,0,4,5,2,0,2470,25586,28056
2015-04-15 06:00:00-04:00,0,4,6,2,0,2154,22718,24872
2015-04-15 07:00:00-04:00,0,4,7,2,0,1888,17874,19762
2015-04-15 08:00:00-04:00,0,4,8,2,0,1371,11467,12838
2015-04-15 09:00:00-04:00,0,4,9,2,0,1023,7501,8524
2015-04-15 10:00:00-04:00,0,4,10,2,0,687,4340,5027
2015-04-15 11:00:00-04:00,0,4,11,2,0,442,2887,3329
2015-04-15 12:00:00-04:00,0,4,12,2,0,363,2624,2987
2015-04-15 13:00:00-04:00,0,4,13,2,0,365,4288,4653
2015-04-15 14:00:00-04:00,0,4,14,2,0,765,11832,12597
2015-04-15 15:00:00-04:00,0,4,15,2,0,1720,21203,22923
2015-04-15 16:00:00-04:00,0,4,16,2,0,2586,24341,26927
2015-04-15 17:00:00-04:00,0,4,17,2,0,2438,22230,24668
2015-04-15 18:00:00-04:00,0,4,18,2,0,2128,19893,22021
2015-04-15 19:00:00-04:00,0,4,19,2,0,1952,19856,21808
2015-04-15 20:00:00-04:00,0,4,20,2,0,1984,20534,22518
2015-04-15 21:00:00-04:00,0,4,21,2,0,1960,20088,22048
2015-04-15 22:00:00-04:00,0,4,22,2,0,2395,20899,23294
2015-04-15 23:00:00-04:00,0,4,23,2,0,2521,20047,22568
2015-04-16 00:00:00-04:00,0,4,0,3,0,2660,16611,19271
2015-04-16 01:00:00-04:00,0,4,1,3,0,3042,21102,24144
2015-04-16 02:00:00-04:00,0,4,2,3,0,3357,25454,28811
2015-04-16 03:00:00-04:00,0,4,3,3,0,3291,27160,30451
2015-04-16 04:00:00-04:00,0,4,4,3,0,3182,27315,30497
2015-04-16 05:00:00-04:00,0,4,5,3,0,2996,28018,31014
2015-04-16 06:00:00-04:00,0,4,6,3,0,2869,26040,28909
2015-04-16 07:00:00-04:00,0,4,7,3,0,2372,21362,23734
2015-04-16 08:00:00-04:00,0,4,8,3,0,1866,14068,15934
2015-04-16 09:00:00-04:00,0,4,9,3,0,1304,8280,9584
2015-04-16 10:00:00-04:00,0,4,10,3,0,759,5162,5921
2015-04-16 11:00:00-04:00,0,4,11,3,0,579,3385,3964
2015-04-16 12:00:00-04:00,0,4,12,3,0,496,3160,3656
2015-04-16 13:00:00-04:00,0,4,13,3,0,388,4533,4921
2015-04-16 14:00:00-04:00,0,4,14,3,0,833,12281,13114
2015-04-16 15:00:00-04:00,0,4,15,3,0,1936,21558,23494
2015-04-16 16:00:00-04:00,0,4,16,3,0,2733,24631,27364
2015-04-16 17:00:00-04:00,0,4,17,3,0,2596,22516,25112
2015-04-16 18:00:00-04:00,0,4,18,3,0,2123,20394,22517
2015-04-16 19:00:00-04:00,0,4,19,3,0,2030,20660,22690
2015-04-16 20:00:00-04:00,0,4,20,3,0,2011,21333,23344
2015-04-16 21:00:00-04:00,0,4,21,3,0,2053,20927,22980
2015-04-16 22:00:00-04:00,0,4,22,3,0,2397,22567,24964
2015-04-16 23:00:00-04:00,0,4,23,3,0,2569,20766,23335
2015-04-17 00:00:00-04:00,0,4,0,4,0,2764,16766,19530
2015-04-17 01:00:00-04:00,0,4,1,4,0,3110,21809,24919
2015-04-17 02:00:00-04:00,0,4,2,4,0,3697,28205,31902
2015-04-17 03:00:00-04:00,0,4,3,4,0,3799,29810,33609
2015-04-17 04:00:00-04:00,0.01,4,4,4,0,3580,29417,32997
2015-04-17 05:00:00-04:00,0.06,4,5,4,0,3459,28840,32299
2015-04-17 06:00:00-04:00,0.01,4,6,4,0,3238,27212,30450
2015-04-17 07:00:00-04:00,0,4,7,4,0,2843,23877,26720
2015-04-17 08:00:00-04:00,0,4,8,4,0,2166,18512,20678
2015-04-17 09:00:00-04:00,0,4,9,4,0,1580,11813,13393
2015-04-17 10:00:00-04:00,0,4,10,4,0,1090,7836,8926
2015-04-17 11:00:00-04:00,0,4,11,4,0,851,5274,6125
2015-04-17 12:00:00-04:00,0,4,12,4,0,620,4243,4863
2015-04-17 13:00:00-04:00,0,4,13,4,0,474,5368,5842
2015-04-17 14:00:00-04:00,0,4,14,4,0,777,12200,12977
2015-04-17 15:00:00-04:00,0,4,15,4,0,1818,20992,22810
2015-04-17 16:00:00-04:00,0,4,16,4,0,2625,24934,27559
2015-04-17 17:00:00-04:00,0,4,17,4,0,2752,23620,26372
2015-04-17 18:00:00-04:00,0,4,18,4,0,2381,21389,23770
2015-04-17 19:00:00-04:00,0,4,19,4,0,2107,21284,23391
2015-04-17 20:00:00-04:00,0,4,20,4,0,2026,22066,24092
2015-04-17 21:00:00-04:00,0,4,21,4,0,1904,21182,23086
2015-04-17 22:00:00-04:00,0,4,22,4,0,2343,22563,24906
2015-04-17 23:00:00-04:00,0,4,23,4,0,2761,20551,23312
2015-04-18 00:00:00-04:00,0,4,0,5,0,2936,17035,19971
2015-04-18 01:00:00-04:00,0,4,1,5,0,3533,21031,24564
2015-04-18 02:00:00-04:00,0,4,2,5,0,3979,27133,31112
2015-04-18 03:00:00-04:00,0,4,3,5,0,4307,29731,34038
2015-04-18 04:00:00-04:00,0,4,4,5,0,4046,28260,32306
2015-04-18 05:00:00-04:00,0,4,5,5,0,4121,26901,31022
2015-04-18 06:00:00-04:00,0,4,6,5,0,4304,27437,31741
2015-04-18 07:00:00-04:00,0,4,7,5,0,4552,27928,32480
2015-04-18 08:00:00-04:00,0,4,8,5,0,4230,26100,30330
2015-04-18 09:00:00-04:00,0,4,9,5,0,3779,22491,26270
2015-04-18 10:00:00-04:00,0,4,10,5,0,3282,18220,21502
2015-04-18 11:00:00-04:00,0,4,11,5,0,2640,13531,16171
2015-04-18 12:00:00-04:00,0,4,12,5,0,1969,8827,10796
2015-04-18 13:00:00-04:00,0,4,13,5,0,1000,4549,5549
2015-04-18 14:00:00-04:00,0,4,14,5,0,804,5799,6603
2015-04-18 15:00:00-04:00,0,4,15,5,0,1018,8659,9677
2015-04-18 16:00:00-04:00,0,4,16,5,0,1389,13202,14591
2015-04-18 17:00:00-04:00,0,4,17,5,0,1941,18201,20142
2015-04-18 18:00:00-04:00,0,4,18,5,0,2177,21041,23218
2015-04-18 19:00:00-04:00,0,4,19,5,0,2517,23729,26246
2015-04-18 20:00:00-04:00,0,4,20,5,0,2607,25510,28117
2015-04-18 21:00:00-04:00,0,4,21,5,0,2804,25640,28444
2015-04-18 22:00:00-04:00,0,4,22,5,0,3113,25326,28439
2015-04-18 23:00:00-04:00,0,4,23,5,0,3359,24546,27905
2015-04-19 00:00:00-04:00,0,4,0,6,0,3638,20762,24400
2015-04-19 01:00:00-04:00,0,4,1,6,0,3897,24005,27902
2015-04-19 02:00:00-04:00,0,4,2,6,0,4393,28676,33069
2015-04-19 03:00:00-04:00,0,4,3,6,0,4670,29493,34163
2015-04-19 04:00:00-04:00,0,4,4,6,0,4969,27870,32839
2015-04-19 05:00:00-04:00,0,4,5,6,0,4938,27043,31981
2015-04-19 06:00:00-04:00,0,4,6,6,0,5229,28617,33846
2015-04-19 07:00:00-04:00,0,4,7,6,0,5253,29091,34344
2015-04-19 08:00:00-04:00,0,4,8,6,0,5206,26876,32082
2015-04-19 09:00:00-04:00,0,4,9,6,0,4790,24448,29238
2015-04-19 10:00:00-04:00,0,4,10,6,0,3946,21466,25412
2015-04-19 11:00:00-04:00,0,4,11,6,0,3201,16144,19345
2015-04-19 12:00:00-04:00,0,4,12,6,0,2364,10456,12820
2015-04-19 13:00:00-04:00,0,4,13,6,0,1095,4932,6027
2015-04-19 14:00:00-04:00,0,4,14,6,0,762,5191,5953
2015-04-19 15:00:00-04:00,0,4,15,6,0,767,7321,8088
2015-04-19 16:00:00-04:00,0,4,16,6,0,1016,10113,11129
2015-04-19 17:00:00-04:00,0,4,17,6,0,1379,15169,16548
2015-04-19 18:00:00-04:00,0,4,18,6,0,1795,19673,21468
2015-04-19 19:00:00-04:00,0,4,19,6,0,2179,22873,25052
2015-04-19 20:00:00-04:00,0,4,20,6,0,2349,24004,26353
2015-04-19 21:00:00-04:00,0,4,21,6,0,2470,23570,26040
2015-04-19 22:00:00-04:00,0,4,22,6,0,2803,23907,26710
2015-04-19 23:00:00-04:00,0,4,23,6,0,3125,23082,26207
2015-04-20 00:00:00-04:00,0,4,0,0,0,3249,21704,24953
2015-04-20 01:00:00-04:00,0,4,1,0,0,3372,22997,26369
2015-04-20 02:00:00-04:00,0,4,2,0,0,3642,24377,28019
2015-04-20 03:00:00-04:00,0,4,3,0,0,3322,22841,26163
2015-04-20 04:00:00-04:00,0,4,4,0,0,3360,22045,25405
2015-04-20 05:00:00-04:00,0,4,5,0,0,2940,20355,23295
2015-04-20 06:00:00-04:00,0,4,6,0,0,2832,18148,20980
2015-04-20 07:00:00-04:00,0,4,7,0,0,2309,14093,16402
2015-04-20 08:00:00-04:00,0,4,8,0,0,1621,8815,10436
2015-04-20 09:00:00-04:00,0.21,4,9,0,0,986,5082,6068
2015-04-20 10:00:00-04:00,0.32,4,10,0,0,652,3302,3954
2015-04-20 11:00:00-04:00,0.22,4,11,0,0,498,2202,2700
2015-04-20 12:00:00-04:00,0.04,4,12,0,0,563,2519,3082
2015-04-20 13:00:00-04:00,0.07,4,13,0,0,503,4570,5073
2015-04-20 14:00:00-04:00,0,4,14,0,0,779,12353,13132
2015-04-20 15:00:00-04:00,0.01,4,15,0,0,1923,21060,22983
2015-04-20 16:00:00-04:00,0,4,16,0,0,3085,23756,26841
2015-04-20 17:00:00-04:00,0,4,17,0,0,3113,23875,26988
2015-04-20 18:00:00-04:00,0,4,18,0,0,2727,21855,24582
2015-04-20 19:00:00-04:00,0,4,19,0,0,2403,19946,22349
2015-04-20 20:00:00-04:00,0,4,20,0,0,2223,20300,22523
2015-04-20 21:00:00-04:00,0,4,21,0,0,1987,18473,20460
2015-04-20 22:00:00-04:00,0,4,22,0,0,2217,19715,21932
2015-04-20 23:00:00-04:00,0,4,23,0,0,2364,19410,21774
2015-04-21 00:00:00-04:00,0.07,4,0,1,0,2462,17443,19905
2015-04-21 01:00:00-04:00,0.04,4,1,1,0,2687,21497,24184
2015-04-21 02:00:00-04:00,0.04,4,2,1,0,2999,26157,29156
2015-04-21 03:00:00-04:00,0.02,4,3,1,0,2730,24875,27605
2015-04-21 04:00:00-04:00,0.04,4,4,1,0,2490,23538,26028
2015-04-21 05:00:00-04:00,0.02,4,5,1,0,2199,22327,24526
2015-04-21 06:00:00-04:00,0.01,4,6,1,0,1876,19381,21257
2015-04-21 07:00:00-04:00,0,4,7,1,0,1637,14808,16445
2015-04-21 08:00:00-04:00,0,4,8,1,0,1366,10418,11784
2015-04-21 09:00:00-04:00,0.07,4,9,1,0,910,6137,7047
2015-04-21 10:00:00-04:00,0,4,10,1,0,580,4595,5175
2015-04-21 11:00:00-04:00,0,4,11,1,0,394,2633,3027
2015-04-21 12:00:00-04:00,0,4,12,1,0,414,2357,2771
2015-04-21 13:00:00-04:00,0,4,13,1,0,372,4278,4650
2015-04-21 14:00:00-04:00,0,4,14,1,0,740,12178,12918
2015-04-21 15:00:00-04:00,0,4,15,1,0,1706,21222,22928
2015-04-21 16:00:00-04:00,0,4,16,1,0,2687,25424,28111
2015-04-21 17:00:00-04:00,0,4,17,1,0,2695,23805,26500
2015-04-21 18:00:00-04:00,0,4,18,1,0,2045,19948,21993
2015-04-21 19:00:00-04:00,0,4,19,1,0,1798,20115,21913
2015-04-21 20:00:00-04:00,0,4,20,1,0,1876,20496,22372
2015-04-21 21:00:00-04:00,0,4,21,1,0,1749,19657,21406
2015-04-21 22:00:00-04:00,0,4,22,1,0,2100,21313,23413
2015-04-21 23:00:00-04:00,0,4,23,1,0,2341,20122,22463
2015-04-22 00:00:00-04:00,0,4,0,2,0,2513,17383,19896
2015-04-22 01:00:00-04:00,0,4,1,2,0,2724,21532,24256
2015-04-22 02:00:00-04:00,0,4,2,2,0,3239,26923,30162
2015-04-22 03:00:00-04:00,0,4,3,2,0,3037,27312,30349
2015-04-22 04:00:00-04:00,0,4,4,2,0,2792,27224,30016
2015-04-22 05:00:00-04:00,0,4,5,2,0,2654,26957,29611
2015-04-22 06:00:00-04:00,0,4,6,2,0,2314,24922,27236
2015-04-22 07:00:00-04:00,0,4,7,2,0,1945,19186,21131
2015-04-22 08:00:00-04:00,0,4,8,2,0,1457,12399,13856
2015-04-22 09:00:00-04:00,0,4,9,2,0,1014,7193,8207
2015-04-22 10:00:00-04:00,0,4,10,2,0,626,4566,5192
2015-04-22 11:00:00-04:00,0,4,11,2,0,424,2862,3286
2015-04-22 12:00:00-04:00,0,4,12,2,0,422,2683,3105
2015-04-22 13:00:00-04:00,0,4,13,2,0,389,4330,4719
2015-04-22 14:00:00-04:00,0,4,14,2,0,765,11980,12745
2015-04-22 15:00:00-04:00,0,4,15,2,0,1685,21132,22817
2015-04-22 16:00:00-04:00,0.07,4,16,2,0,2615,24449,27064
2015-04-22 17:00:00-04:00,0.01,4,17,2,0,2384,22122,24506
2015-04-22 18:00:00-04:00,0.01,4,18,2,0,2064,19854,21918
2015-04-22 19:00:00-04:00,0.01,4,19,2,0,1845,20104,21949
2015-04-22 20:00:00-04:00,0,4,20,2,0,1924,20514,22438
2015-04-22 21:00:00-04:00,0,4,21,2,0,1927,20137,22064
2015-04-22 22:00:00-04:00,0,4,22,2,0,2256,21742,23998
2015-04-22 23:00:00-04:00,0,4,23,2,0,3213,22530,25743
2015-04-23 00:00:00-04:00,0,4,0,3,0,3249,16192,19441
2015-04-23 01:00:00-04:00,0,4,1,3,0,3486,21274,24760
2015-04-23 02:00:00-04:00,0,4,2,3,0,4070,26720,30790
2015-04-23 03:00:00-04:00,0,4,3,3,0,3412,26744,30156
2015-04-23 04:00:00-04:00,0,4,4,3,0,3129,27548,30677
2015-04-23 05:00:00-04:00,0,4,5,3,0,2956,27784,30740
2015-04-23 06:00:00-04:00,0,4,6,3,0,2802,26336,29138
2015-04-23 07:00:00-04:00,0,4,7,3,0,2343,21296,23639
2015-04-23 08:00:00-04:00,0,4,8,3,0,1768,13662,15430
2015-04-23 09:00:00-04:00,0,4,9,3,0,1194,8138,9332
2015-04-23 10:00:00-04:00,0,4,10,3,0,770,4959,5729
2015-04-23 11:00:00-04:00,0,4,11,3,0,521,3207,3728
2015-04-23 12:00:00-04:00,0,4,12,3,0,466,3061,3527
2015-04-23 13:00:00-04:00,0,4,13,3,0,446,4593,5039
2015-04-23 14:00:00-04:00,0,4,14,3,0,881,12616,13497
2015-04-23 15:00:00-04:00,0,4,15,3,0,1826,22274,24100
2015-04-23 16:00:00-04:00,0,4,16,3,0,2570,25277,27847
2015-04-23 17:00:00-04:00,0,4,17,3,0,2603,23358,25961
2015-04-23 18:00:00-04:00,0,4,18,3,0,2179,21304,23483
2015-04-23 19:00:00-04:00,0,4,19,3,0,2123,21795,23918
2015-04-23 20:00:00-04:00,0,4,20,3,0,2011,22571,24582
2015-04-23 21:00:00-04:00,0,4,21,3,0,1974,21932,23906
2015-04-23 22:00:00-04:00,0,4,22,3,0,2426,22845,25271
2015-04-23 23:00:00-04:00,0,4,23,3,0,2847,21036,23883
2015-04-24 00:00:00-04:00,0,4,0,4,0,3193,16723,19916
2015-04-24 01:00:00-04:00,0,4,1,4,0,3736,21744,25480
2015-04-24 02:00:00-04:00,0,4,2,4,0,4036,27993,32029
2015-04-24 03:00:00-04:00,0,4,3,4,0,3922,30325,34247
2015-04-24 04:00:00-04:00,0,4,4,4,0,3806,30076,33882
2015-04-24 05:00:00-04:00,0,4,5,4,0,3729,29861,33590
2015-04-24 06:00:00-04:00,0,4,6,4,0,3626,28449,32075
2015-04-24 07:00:00-04:00,0,4,7,4,0,3124,25687,28811
2015-04-24 08:00:00-04:00,0,4,8,4,0,2393,18830,21223
2015-04-24 09:00:00-04:00,0,4,9,4,0,1709,11748,13457
2015-04-24 10:00:00-04:00,0,4,10,4,0,1068,7850,8918
2015-04-24 11:00:00-04:00,0,4,11,4,0,784,5249,6033
2015-04-24 12:00:00-04:00,0,4,12,4,0,645,4231,4876
2015-04-24 13:00:00-04:00,0,4,13,4,0,506,4947,5453
2015-04-24 14:00:00-04:00,0,4,14,4,0,904,12315,13219
2015-04-24 15:00:00-04:00,0,4,15,4,0,1933,21527,23460
2015-04-24 16:00:00-04:00,0,4,16,4,0,2742,24851,27593
2015-04-24 17:00:00-04:00,0,4,17,4,0,2765,23069,25834
2015-04-24 18:00:00-04:00,0,4,18,4,0,2314,21511,23825
2015-04-24 19:00:00-04:00,0,4,19,4,0,2116,21926,24042
2015-04-24 20:00:00-04:00,0,4,20,4,0,2146,22028,24174
2015-04-24 21:00:00-04:00,0,4,21,4,0,1974,20741,22715
2015-04-24 22:00:00-04:00,0,4,22,4,0,2475,22247,24722
2015-04-24 23:00:00-04:00,0,4,23,4,0,2897,19917,22814
2015-04-25 00:00:00-04:00,0,4,0,5,0,3152,16256,19408
2015-04-25 01:00:00-04:00,0,4,1,5,0,3796,20553,24349
2015-04-25 02:00:00-04:00,0,4,2,5,0,4539,26070,30609
2015-04-25 03:00:00-04:00,0,4,3,5,0,4785,29270,34055
2015-04-25 04:00:00-04:00,0,4,4,5,0,4941,29965,34906
2015-04-25 05:00:00-04:00,0,4,5,5,0,4786,29350,34136
2015-04-25 06:00:00-04:00,0,4,6,5,0,5129,30270,35399
2015-04-25 07:00:00-04:00,0,4,7,5,0,5237,29347,34584
2015-04-25 08:00:00-04:00,0,4,8,5,0,4734,26312,31046
2015-04-25 09:00:00-04:00,0,4,9,5,0,3981,21901,25882
2015-04-25 10:00:00-04:00,0,4,10,5,0,3165,17887,21052
2015-04-25 11:00:00-04:00,0,4,11,5,0,2552,13593,16145
2015-04-25 12:00:00-04:00,0,4,12,5,0,1902,8834,10736
2015-04-25 13:00:00-04:00,0,4,13,5,0,975,4729,5704
2015-04-25 14:00:00-04:00,0,4,14,5,0,746,5610,6356
2015-04-25 15:00:00-04:00,0,4,15,5,0,950,8471,9421
2015-04-25 16:00:00-04:00,0,4,16,5,0,1485,13498,14983
2015-04-25 17:00:00-04:00,0,4,17,5,0,1873,18469,20342
2015-04-25 18:00:00-04:00,0,4,18,5,0,2192,21184,23376
2015-04-25 19:00:00-04:00,0,4,19,5,0,2416,23598,26014
2015-04-25 20:00:00-04:00,0,4,20,5,0,2589,24423,27012
2015-04-25 21:00:00-04:00,0,4,21,5,0,2588,23697,26285
2015-04-25 22:00:00-04:00,0,4,22,5,0,2882,22801,25683
2015-04-25 23:00:00-04:00,0,4,23,5,0,3267,22539,25806
2015-04-26 00:00:00-04:00,0,4,0,6,0,3567,19493,23060
2015-04-26 01:00:00-04:00,0,4,1,6,0,3897,22622,26519
2015-04-26 02:00:00-04:00,0,4,2,6,0,4471,27679,32150
2015-04-26 03:00:00-04:00,0,4,3,6,0,4782,29578,34360
2015-04-26 04:00:00-04:00,0,4,4,6,0,4936,28040,32976
2015-04-26 05:00:00-04:00,0,4,5,6,0,4986,27051,32037
2015-04-26 06:00:00-04:00,0,4,6,6,0,5191,28462,33653
2015-04-26 07:00:00-04:00,0,4,7,6,0,5342,29003,34345
2015-04-26 08:00:00-04:00,0,4,8,6,0,5151,26998,32149
2015-04-26 09:00:00-04:00,0,4,9,6,0,4611,24304,28915
2015-04-26 10:00:00-04:00,0,4,10,6,0,3950,21315,25265
2015-04-26 11:00:00-04:00,0,4,11,6,0,3174,16191,19365
2015-04-26 12:00:00-04:00,0,4,12,6,0,2381,10342,12723
2015-04-26 13:00:00-04:00,0,4,13,6,0,1150,4687,5837
2015-04-26 14:00:00-04:00,0,4,14,6,0,768,4878,5646
2015-04-26 15:00:00-04:00,0,4,15,6,0,738,7136,7874
2015-04-26 16:00:00-04:00,0,4,16,6,0,934,9977,10911
2015-04-26 17:00:00-04:00,0,4,17,6,0,1379,14536,15915
2015-04-26 18:00:00-04:00,0,4,18,6,0,1742,18350,20092
2015-04-26 19:00:00-04:00,0,4,19,6,0,2068,21198,23266
2015-04-26 20:00:00-04:00,0,4,20,6,0,2284,22632,24916
2015-04-26 21:00:00-04:00,0,4,21,6,0,2374,22645,25019
2015-04-26 22:00:00-04:00,0,4,22,6,0,2650,22791,25441
2015-04-26 23:00:00-04:00,0,4,23,6,0,2948,21796,24744
2015-04-27 00:00:00-04:00,0,4,0,0,0,3099,19978,23077
2015-04-27 01:00:00-04:00,0,4,1,0,0,3255,22077,25332
2015-04-27 02:00:00-04:00,0,4,2,0,0,3309,22332,25641
2015-04-27 03:00:00-04:00,0,4,3,0,0,3125,20848,23973
2015-04-27 04:00:00-04:00,0,4,4,0,0,3061,20227,23288
2015-04-27 05:00:00-04:00,0,4,5,0,0,2875,18920,21795
2015-04-27 06:00:00-04:00,0,4,6,0,0,2780,16958,19738
2015-04-27 07:00:00-04:00,0,4,7,0,0,2384,13492,15876
2015-04-27 08:00:00-04:00,0,4,8,0,0,1718,8386,10104
2015-04-27 09:00:00-04:00,0,4,9,0,0,1024,4855,5879
2015-04-27 10:00:00-04:00,0,4,10,0,0,709,3182,3891
2015-04-27 11:00:00-04:00,0,4,11,0,0,516,2347,2863
2015-04-27 12:00:00-04:00,0,4,12,0,0,575,2639,3214
2015-04-27 13:00:00-04:00,0,4,13,0,0,459,4601,5060
2015-04-27 14:00:00-04:00,0,4,14,0,0,797,11572,12369
2015-04-27 15:00:00-04:00,0,4,15,0,0,1820,20058,21878
2015-04-27 16:00:00-04:00,0,4,16,0,0,2538,23180,25718
2015-04-27 17:00:00-04:00,0,4,17,0,0,2426,21324,23750
2015-04-27 18:00:00-04:00,0,4,18,0,0,2011,18627,20638
2015-04-27 19:00:00-04:00,0,4,19,0,0,1844,18287,20131
2015-04-27 20:00:00-04:00,0,4,20,0,0,1854,18877,20731
2015-04-27 21:00:00-04:00,0,4,21,0,0,1816,18793,20609
2015-04-27 22:00:00-04:00,0,4,22,0,0,2179,20598,22777
2015-04-27 23:00:00-04:00,0,4,23,0,0,2345,19872,22217
2015-04-28 00:00:00-04:00,0,4,0,1,0,2465,17970,20435
2015-04-28 01:00:00-04:00,0,4,1,1,0,2752,21675,24427
2015-04-28 02:00:00-04:00,0,4,2,1,0,3067,25902,28969
2015-04-28 03:00:00-04:00,0,4,3,1,0,2798,25673,28471
2015-04-28 04:00:00-04:00,0,4,4,1,0,2605,24525,27130
2015-04-28 05:00:00-04:00,0,4,5,1,0,2451,24292,26743
2015-04-28 06:00:00-04:00,0,4,6,1,0,2189,21291,23480
2015-04-28 07:00:00-04:00,0,4,7,1,0,1736,15000,16736
2015-04-28 08:00:00-04:00,0,4,8,1,0,1244,9465,10709
2015-04-28 09:00:00-04:00,0,4,9,1,0,861,5693,6554
2015-04-28 10:00:00-04:00,0,4,10,1,0,564,3544,4108
2015-04-28 11:00:00-04:00,0,4,11,1,0,390,2260,2650
2015-04-28 12:00:00-04:00,0,4,12,1,0,376,2268,2644
2015-04-28 13:00:00-04:00,0,4,13,1,0,337,4194,4531
2015-04-28 14:00:00-04:00,0,4,14,1,0,699,11464,12163
2015-04-28 15:00:00-04:00,0,4,15,1,0,1752,20525,22277
2015-04-28 16:00:00-04:00,0,4,16,1,0,2527,23676,26203
2015-04-28 17:00:00-04:00,0,4,17,1,0,2396,21961,24357
2015-04-28 18:00:00-04:00,0,4,18,1,0,1981,19291,21272
2015-04-28 19:00:00-04:00,0,4,19,1,0,1763,19288,21051
2015-04-28 20:00:00-04:00,0,4,20,1,0,1798,19786,21584
2015-04-28 21:00:00-04:00,0,4,21,1,0,1862,19141,21003
2015-04-28 22:00:00-04:00,0,4,22,1,0,2110,20875,22985
2015-04-28 23:00:00-04:00,0,4,23,1,0,2427,19922,22349
2015-04-29 00:00:00-04:00,0,4,0,2,0,2538,17289,19827
2015-04-29 01:00:00-04:00,0,4,1,2,0,2876,21535,24411
2015-04-29 02:00:00-04:00,0,4,2,2,0,3007,26676,29683
2015-04-29 03:00:00-04:00,0,4,3,2,0,2900,26357,29257
2015-04-29 04:00:00-04:00,0,4,4,2,0,2810,26464,29274
2015-04-29 05:00:00-04:00,0,4,5,2,0,2552,26871,29423
2015-04-29 06:00:00-04:00,0,4,6,2,0,2439,24521,26960
2015-04-29 07:00:00-04:00,0,4,7,2,0,2018,18705,20723
2015-04-29 08:00:00-04:00,0,4,8,2,0,1493,11799,13292
2015-04-29 09:00:00-04:00,0,4,9,2,0,1049,7000,8049
2015-04-29 10:00:00-04:00,0,4,10,2,0,655,4342,4997
2015-04-29 11:00:00-04:00,0,4,11,2,0,418,2928,3346
2015-04-29 12:00:00-04:00,0,4,12,2,0,443,2717,3160
2015-04-29 13:00:00-04:00,0,4,13,2,0,402,4409,4811
2015-04-29 14:00:00-04:00,0,4,14,2,0,712,11715,12427
2015-04-29 15:00:00-04:00,0,4,15,2,0,1658,20886,22544
2015-04-29 16:00:00-04:00,0,4,16,2,0,2467,24241,26708
2015-04-29 17:00:00-04:00,0,4,17,2,0,2373,22292,24665
2015-04-29 18:00:00-04:00,0,4,18,2,0,2066,19919,21985
2015-04-29 19:00:00-04:00,0,4,19,2,0,1905,19799,21704
2015-04-29 20:00:00-04:00,0,4,20,2,0,1900,20390,22290
2015-04-29 21:00:00-04:00,0,4,21,2,0,1880,20058,21938
2015-04-29 22:00:00-04:00,0,4,22,2,0,2168,20998,23166
2015-04-29 23:00:00-04:00,0,4,23,2,0,2484,20090,22574
2015-04-30 00:00:00-04:00,0,4,0,3,0,2598,15736,18334
2015-04-30 01:00:00-04:00,0,4,1,3,0,2992,19807,22799
2015-04-30 02:00:00-04:00,0,4,2,3,0,3309,24931,28240
2015-04-30 03:00:00-04:00,0,4,3,3,0,3466,27756,31222
2015-04-30 04:00:00-04:00,0,4,4,3,0,3594,28629,32223
2015-04-30 05:00:00-04:00,0,4,5,3,0,3357,28354,31711
2015-04-30 06:00:00-04:00,0,4,6,3,0,3127,27008,30135
2015-04-30 07:00:00-04:00,0,4,7,3,0,2616,21703,24319
2015-04-30 08:00:00-04:00,0,4,8,3,0,1909,14643,16552
2015-04-30 09:00:00-04:00,0,4,9,3,0,1311,8569,9880
2015-04-30 10:00:00-04:00,0,4,10,3,0,785,5136,5921
2015-04-30 11:00:00-04:00,0,4,11,3,0,570,3363,3933
2015-04-30 12:00:00-04:00,0,4,12,3,0,461,3179,3640
2015-04-30 13:00:00-04:00,0,4,13,3,0,440,4636,5076
2015-04-30 14:00:00-04:00,0,4,14,3,0,813,12555,13368
2015-04-30 15:00:00-04:00,0,4,15,3,0,1816,21516,23332
2015-04-30 16:00:00-04:00,0,4,16,3,0,2730,24344,27074
2015-04-30 17:00:00-04:00,0,4,17,3,0,2497,22223,24720
2015-04-30 18:00:00-04:00,0,4,18,3,0,2107,20284,22391
2015-04-30 19:00:00-04:00,0,4,19,3,0,1962,19994,21956
2015-04-30 20:00:00-04:00,0,4,20,3,0,2034,20801,22835
2015-04-30 21:00:00-04:00,0,4,21,3,0,2025,20316,22341
2015-04-30 22:00:00-04:00,0,4,22,3,0,2356,21350,23706
2015-04-30 23:00:00-04:00,0,4,23,3,0,2602,19597,22199
2015-05-01 00:00:00-04:00,0,5,0,4,0,2796,15769,18565
2015-05-01 01:00:00-04:00,0,5,1,4,0,3221,20833,24054
2015-05-01 02:00:00-04:00,0,5,2,4,0,3650,27288,30938
2015-05-01 03:00:00-04:00,0,5,3,4,0,3750,29606,33356
2015-05-01 04:00:00-04:00,0,5,4,4,0,3642,29200,32842
2015-05-01 05:00:00-04:00,0,5,5,4,0,3533,29381,32914
2015-05-01 06:00:00-04:00,0,5,6,4,0,3378,27691,31069
2015-05-01 07:00:00-04:00,0,5,7,4,0,3019,23858,26877
2015-05-01 08:00:00-04:00,0,5,8,4,0,2423,18232,20655
2015-05-01 09:00:00-04:00,0,5,9,4,0,1753,12043,13796
2015-05-01 10:00:00-04:00,0,5,10,4,0,1225,7816,9041
2015-05-01 11:00:00-04:00,0,5,11,4,0,810,5325,6135
2015-05-01 12:00:00-04:00,0,5,12,4,0,701,4379,5080
2015-05-01 13:00:00-04:00,0,5,13,4,0,562,4880,5442
2015-05-01 14:00:00-04:00,0,5,14,4,0,901,11616,12517
2015-05-01 15:00:00-04:00,0,5,15,4,0,1849,20690,22539
2015-05-01 16:00:00-04:00,0,5,16,4,0,2721,23970,26691
2015-05-01 17:00:00-04:00,0,5,17,4,0,2639,22105,24744
2015-05-01 18:00:00-04:00,0,5,18,4,0,2386,20056,22442
2015-05-01 19:00:00-04:00,0,5,19,4,0,2392,20740,23132
2015-05-01 20:00:00-04:00,0,5,20,4,0,2136,20958,23094
2015-05-01 21:00:00-04:00,0,5,21,4,0,2186,19958,22144
2015-05-01 22:00:00-04:00,0,5,22,4,0,2560,22281,24841
2015-05-01 23:00:00-04:00,0,5,23,4,0,2952,19590,22542
2015-05-02 00:00:00-04:00,0,5,0,5,0,3406,16544,19950
2015-05-02 01:00:00-04:00,0,5,1,5,0,3945,20890,24835
2015-05-02 02:00:00-04:00,0,5,2,5,0,4782,26798,31580
2015-05-02 03:00:00-04:00,0,5,3,5,0,4993,30003,34996
2015-05-02 04:00:00-04:00,0,5,4,5,0,4611,28533,33144
2015-05-02 05:00:00-04:00,0,5,5,5,0,4523,27912,32435
2015-05-02 06:00:00-04:00,0,5,6,5,0,4858,28612,33470
2015-05-02 07:00:00-04:00,0,5,7,5,0,4873,27616,32489
2015-05-02 08:00:00-04:00,0,5,8,5,0,4486,25471,29957
2015-05-02 09:00:00-04:00,0,5,9,5,0,3876,22072,25948
2015-05-02 10:00:00-04:00,0,5,10,5,0,3127,17716,20843
2015-05-02 11:00:00-04:00,0,5,11,5,0,2476,12783,15259
2015-05-02 12:00:00-04:00,0,5,12,5,0,1831,8161,9992
2015-05-02 13:00:00-04:00,0,5,13,5,0,983,4182,5165
2015-05-02 14:00:00-04:00,0,5,14,5,0,758,5546,6304
2015-05-02 15:00:00-04:00,0,5,15,5,0,968,8214,9182
2015-05-02 16:00:00-04:00,0,5,16,5,0,1518,13189,14707
2015-05-02 17:00:00-04:00,0,5,17,5,0,1967,17763,19730
2015-05-02 18:00:00-04:00,0,5,18,5,0,2243,20801,23044
2015-05-02 19:00:00-04:00,0,5,19,5,0,2646,23500,26146
2015-05-02 20:00:00-04:00,0,5,20,5,0,2746,24865,27611
2015-05-02 21:00:00-04:00,0,5,21,5,0,2888,24378,27266
2015-05-02 22:00:00-04:00,0,5,22,5,0,3208,24336,27544
2015-05-02 23:00:00-04:00,0,5,23,5,0,3557,24923,28480
2015-05-03 00:00:00-04:00,0,5,0,6,0,3851,21847,25698
2015-05-03 01:00:00-04:00,0,5,1,6,0,4218,25136,29354
2015-05-03 02:00:00-04:00,0,5,2,6,0,4798,29708,34506
2015-05-03 03:00:00-04:00,0,5,3,6,0,5352,32435,37787
2015-05-03 04:00:00-04:00,0,5,4,6,0,5628,30338,35966
2015-05-03 05:00:00-04:00,0,5,5,6,0,6017,30626,36643
2015-05-03 06:00:00-04:00,0,5,6,6,0,6566,31566,38132
2015-05-03 07:00:00-04:00,0,5,7,6,0,5866,28063,33929
2015-05-03 08:00:00-04:00,0,5,8,6,0,4706,25318,30024
2015-05-03 09:00:00-04:00,0,5,9,6,0,6152,31475,37627
2015-05-03 10:00:00-04:00,0,5,10,6,0,4934,21918,26852
2015-05-03 11:00:00-04:00,0,5,11,6,0,3736,15846,19582
2015-05-03 12:00:00-04:00,0,5,12,6,0,2607,9942,12549
2015-05-03 13:00:00-04:00,0,5,13,6,0,1238,4630,5868
2015-05-03 14:00:00-04:00,0,5,14,6,0,784,4832,5616
2015-05-03 15:00:00-04:00,0,5,15,6,0,751,6732,7483
2015-05-03 16:00:00-04:00,0,5,16,6,0,905,9776,10681
2015-05-03 17:00:00-04:00,0,5,17,6,0,1267,13242,14509
2015-05-03 18:00:00-04:00,0,5,18,6,0,1704,17408,19112
2015-05-03 19:00:00-04:00,0,5,19,6,0,1992,20707,22699
2015-05-03 20:00:00-04:00,0,5,20,6,0,2361,22453,24814
2015-05-03 21:00:00-04:00,0,5,21,6,0,2369,23310,25679
2015-05-03 22:00:00-04:00,0,5,22,6,0,2681,23250,25931
2015-05-03 23:00:00-04:00,0,5,23,6,0,2897,22483,25380
2015-05-04 00:00:00-04:00,0,5,0,0,0,3217,21349,24566
2015-05-04 01:00:00-04:00,0,5,1,0,0,3342,22799,26141
2015-05-04 02:00:00-04:00,0,5,2,0,0,3435,23865,27300
2015-05-04 03:00:00-04:00,0,5,3,0,0,3330,22211,25541
2015-05-04 04:00:00-04:00,0,5,4,0,0,3182,20805,23987
2015-05-04 05:00:00-04:00,0,5,5,0,0,2943,19269,22212
2015-05-04 06:00:00-04:00,0,5,6,0,0,2886,17253,20139
2015-05-04 07:00:00-04:00,0,5,7,0,0,2252,13916,16168
2015-05-04 08:00:00-04:00,0,5,8,0,0,1633,8856,10489
2015-05-04 09:00:00-04:00,0,5,9,0,0,1111,5197,6308
2015-05-04 10:00:00-04:00,0,5,10,0,0,675,3343,4018
2015-05-04 11:00:00-04:00,0,5,11,0,0,501,2332,2833
2015-05-04 12:00:00-04:00,0,5,12,0,0,496,2654,3150
2015-05-04 13:00:00-04:00,0,5,13,0,0,508,4584,5092
2015-05-04 14:00:00-04:00,0,5,14,0,0,885,11507,12392
2015-05-04 15:00:00-04:00,0,5,15,0,0,1827,19653,21480
2015-05-04 16:00:00-04:00,0,5,16,0,0,2617,22167,24784
2015-05-04 17:00:00-04:00,0,5,17,0,0,2584,20788,23372
2015-05-04 18:00:00-04:00,0,5,18,0,0,2112,18437,20549
2015-05-04 19:00:00-04:00,0,5,19,0,0,1942,18361,20303
2015-05-04 20:00:00-04:00,0,5,20,0,0,1848,19044,20892
2015-05-04 21:00:00-04:00,0,5,21,0,0,1955,19141,21096
2015-05-04 22:00:00-04:00,0,5,22,0,0,2219,20816,23035
2015-05-04 23:00:00-04:00,0,5,23,0,0,2377,19997,22374
2015-05-05 00:00:00-04:00,0,5,0,1,0,2577,17253,19830
2015-05-05 01:00:00-04:00,0,5,1,1,0,2814,20849,23663
2015-05-05 02:00:00-04:00,0,5,2,1,0,3078,26043,29121
2015-05-05 03:00:00-04:00,0,5,3,1,0,2820,24883,27703
2015-05-05 04:00:00-04:00,0,5,4,1,0,2596,23726,26322
2015-05-05 05:00:00-04:00,0,5,5,1,0,2256,23846,26102
2015-05-05 06:00:00-04:00,0,5,6,1,0,2079,20960,23039
2015-05-05 07:00:00-04:00,0,5,7,1,0,1763,15829,17592
2015-05-05 08:00:00-04:00,0,5,8,1,0,1314,10413,11727
2015-05-05 09:00:00-04:00,0,5,9,1,0,880,6292,7172
2015-05-05 10:00:00-04:00,0,5,10,1,0,532,4042,4574
2015-05-05 11:00:00-04:00,0,5,11,1,0,398,2474,2872
2015-05-05 12:00:00-04:00,0,5,12,1,0,412,2487,2899
2015-05-05 13:00:00-04:00,0,5,13,1,0,394,4194,4588
2015-05-05 14:00:00-04:00,0,5,14,1,0,733,11618,12351
2015-05-05 15:00:00-04:00,0,5,15,1,0,1720,20667,22387
2015-05-05 16:00:00-04:00,0,5,16,1,0,2466,23882,26348
2015-05-05 17:00:00-04:00,0,5,17,1,0,2501,22612,25113
2015-05-05 18:00:00-04:00,0,5,18,1,0,2054,20182,22236
2015-05-05 19:00:00-04:00,0,5,19,1,0,1934,20233,22167
2015-05-05 20:00:00-04:00,0,5,20,1,0,1925,20685,22610
2015-05-05 21:00:00-04:00,0,5,21,1,0,1999,20410,22409
2015-05-05 22:00:00-04:00,0,5,22,1,0,2263,21902,24165
2015-05-05 23:00:00-04:00,0,5,23,1,0,2495,20840,23335
2015-05-06 00:00:00-04:00,0,5,0,2,0,2654,17615,20269
2015-05-06 01:00:00-04:00,0,5,1,2,0,3026,22484,25510
2015-05-06 02:00:00-04:00,0,5,2,2,0,3449,27383,30832
2015-05-06 03:00:00-04:00,0,5,3,2,0,3190,27691,30881
2015-05-06 04:00:00-04:00,0,5,4,2,0,3046,27791,30837
2015-05-06 05:00:00-04:00,0,5,5,2,0,3010,27879,30889
2015-05-06 06:00:00-04:00,0,5,6,2,0,2786,26833,29619
2015-05-06 07:00:00-04:00,0,5,7,2,0,2564,21843,24407
2015-05-06 08:00:00-04:00,0,5,8,2,0,1968,15119,17087
2015-05-06 09:00:00-04:00,0,5,9,2,0,1267,9090,10357
2015-05-06 10:00:00-04:00,0,5,10,2,0,816,5626,6442
2015-05-06 11:00:00-04:00,0,5,11,2,0,563,3767,4330
2015-05-06 12:00:00-04:00,0,5,12,2,0,460,3089,3549
2015-05-06 13:00:00-04:00,0,5,13,2,0,450,4612,5062
2015-05-06 14:00:00-04:00,0,5,14,2,0,820,12530,13350
2015-05-06 15:00:00-04:00,0,5,15,2,0,1886,23159,25045
2015-05-06 16:00:00-04:00,0,5,16,2,0,2713,25729,28442
2015-05-06 17:00:00-04:00,0,5,17,2,0,2728,24077,26805
2015-05-06 18:00:00-04:00,0,5,18,2,0,2244,21235,23479
2015-05-06 19:00:00-04:00,0,5,19,2,0,2122,20585,22707
2015-05-06 20:00:00-04:00,0,5,20,2,0,2107,21026,23133
2015-05-06 21:00:00-04:00,0,5,21,2,0,2030,20636,22666
2015-05-06 22:00:00-04:00,0,5,22,2,0,2323,21661,23984
2015-05-06 23:00:00-04:00,0,5,23,2,0,2535,20062,22597
2015-05-07 00:00:00-04:00,0,5,0,3,0,2668,16573,19241
2015-05-07 01:00:00-04:00,0,5,1,3,0,2969,21038,24007
2015-05-07 02:00:00-04:00,0,5,2,3,0,3325,26673,29998
2015-05-07 03:00:00-04:00,0,5,3,3,0,3265,27728,30993
2015-05-07 04:00:00-04:00,0,5,4,3,0,3032,27047,30079
2015-05-07 05:00:00-04:00,0,5,5,3,0,3042,27568,30610
2015-05-07 06:00:00-04:00,0,5,6,3,0,2776,25804,28580
2015-05-07 07:00:00-04:00,0,5,7,3,0,2337,20514,22851
2015-05-07 08:00:00-04:00,0,5,8,3,0,1763,13739,15502
2015-05-07 09:00:00-04:00,0,5,9,3,0,1108,8123,9231
2015-05-07 10:00:00-04:00,0,5,10,3,0,691,5113,5804
2015-05-07 11:00:00-04:00,0,5,11,3,0,502,3216,3718
2015-05-07 12:00:00-04:00,0,5,12,3,0,491,2921,3412
2015-05-07 13:00:00-04:00,0,5,13,3,0,466,4731,5197
2015-05-07 14:00:00-04:00,0,5,14,3,0,858,12132,12990
2015-05-07 15:00:00-04:00,0,5,15,3,0,1861,21556,23417
2015-05-07 16:00:00-04:00,0,5,16,3,0,2656,23980,26636
2015-05-07 17:00:00-04:00,0,5,17,3,0,2508,21843,24351
2015-05-07 18:00:00-04:00,0,5,18,3,0,2157,20334,22491
2015-05-07 19:00:00-04:00,0,5,19,3,0,2180,20434,22614
2015-05-07 20:00:00-04:00,0,5,20,3,0,2117,21074,23191
2015-05-07 21:00:00-04:00,0,5,21,3,0,2126,20759,22885
2015-05-07 22:00:00-04:00,0,5,22,3,0,2532,21498,24030
2015-05-07 23:00:00-04:00,0,5,23,3,0,2774,19346,22120
2015-05-08 00:00:00-04:00,0,5,0,4,0,3048,15774,18822
2015-05-08 01:00:00-04:00,0,5,1,4,0,3288,20207,23495
2015-05-08 02:00:00-04:00,0,5,2,4,0,3709,26261,29970
2015-05-08 03:00:00-04:00,0,5,3,4,0,3820,28376,32196
2015-05-08 04:00:00-04:00,0,5,4,4,0,3686,28776,32462
2015-05-08 05:00:00-04:00,0,5,5,4,0,3681,29352,33033
2015-05-08 06:00:00-04:00,0,5,6,4,0,3647,27925,31572
2015-05-08 07:00:00-04:00,0,5,7,4,0,3052,24752,27804
2015-05-08 08:00:00-04:00,0,5,8,4,0,2354,18474,20828
2015-05-08 09:00:00-04:00,0,5,9,4,0,1709,11967,13676
2015-05-08 10:00:00-04:00,0,5,10,4,0,1042,7599,8641
2015-05-08 11:00:00-04:00,0,5,11,4,0,739,5058,5797
2015-05-08 12:00:00-04:00,0,5,12,4,0,641,4262,4903
2015-05-08 13:00:00-04:00,0,5,13,4,0,529,4873,5402
2015-05-08 14:00:00-04:00,0,5,14,4,0,857,11713,12570
2015-05-08 15:00:00-04:00,0,5,15,4,0,1826,20543,22369
2015-05-08 16:00:00-04:00,0,5,16,4,0,2645,23010,25655
2015-05-08 17:00:00-04:00,0,5,17,4,0,2503,21157,23660
2015-05-08 18:00:00-04:00,0,5,18,4,0,2212,19727,21939
2015-05-08 19:00:00-04:00,0,5,19,4,0,2219,20084,22303
2015-05-08 20:00:00-04:00,0,5,20,4,0,2123,21037,23160
2015-05-08 21:00:00-04:00,0,5,21,4,0,2078,20200,22278
2015-05-08 22:00:00-04:00,0,5,22,4,0,2599,21674,24273
2015-05-08 23:00:00-04:00,0,5,23,4,0,2978,19183,22161
2015-05-09 00:00:00-04:00,0,5,0,5,0,3246,15591,18837
2015-05-09 01:00:00-04:00,0,5,1,5,0,3718,19700,23418
2015-05-09 02:00:00-04:00,0,5,2,5,0,4362,25808,30170
2015-05-09 03:00:00-04:00,0,5,3,5,0,4533,28510,33043
2015-05-09 04:00:00-04:00,0,5,4,5,0,4445,26828,31273
2015-05-09 05:00:00-04:00,0,5,5,5,0,4530,26711,31241
2015-05-09 06:00:00-04:00,0,5,6,5,0,4779,28049,32828
2015-05-09 07:00:00-04:00,0,5,7,5,0,4803,27251,32054
2015-05-09 08:00:00-04:00,0,5,8,5,0,4362,24812,29174
2015-05-09 09:00:00-04:00,0,5,9,5,0,3897,21747,25644
2015-05-09 10:00:00-04:00,0,5,10,5,0,3164,17552,20716
2015-05-09 11:00:00-04:00,0,5,11,5,0,2375,12864,15239
2015-05-09 12:00:00-04:00,0.01,5,12,5,0,1846,8256,10102
2015-05-09 13:00:00-04:00,0,5,13,5,0,933,4267,5200
2015-05-09 14:00:00-04:00,0,5,14,5,0,811,5269,6080
2015-05-09 15:00:00-04:00,0,5,15,5,0,950,7776,8726
2015-05-09 16:00:00-04:00,0,5,16,5,0,1381,12590,13971
2015-05-09 17:00:00-04:00,0,5,17,5,0,1941,17977,19918
2015-05-09 18:00:00-04:00,0,5,18,5,0,2239,21372,23611
2015-05-09 19:00:00-04:00,0,5,19,5,0,2507,23450,25957
2015-05-09 20:00:00-04:00,0,5,20,5,0,2809,24756,27565
2015-05-09 21:00:00-04:00,0,5,21,5,0,2701,24158,26859
2015-05-09 22:00:00-04:00,0,5,22,5,0,2972,22652,25624
2015-05-09 23:00:00-04:00,0,5,23,5,0,3185,22484,25669
2015-05-10 00:00:00-04:00,0,5,0,6,0,3587,20283,23870
2015-05-10 01:00:00-04:00,0,5,1,6,0,3985,23376,27361
2015-05-10 02:00:00-04:00,0,5,2,6,0,4322,26418,30740
2015-05-10 03:00:00-04:00,0,5,3,6,0,4600,27768,32368
2015-05-10 04:00:00-04:00,0,5,4,6,0,4531,24089,28620
2015-05-10 05:00:00-04:00,0,5,5,6,0,4526,23269,27795
2015-05-10 06:00:00-04:00,0,5,6,6,0,4812,25679,30491
2015-05-10 07:00:00-04:00,0,5,7,6,0,4988,26153,31141
2015-05-10 08:00:00-04:00,0,5,8,6,0,4798,23944,28742
2015-05-10 09:00:00-04:00,0,5,9,6,0,3988,20603,24591
2015-05-10 10:00:00-04:00,0,5,10,6,0,3351,17121,20472
2015-05-10 11:00:00-04:00,0,5,11,6,0,2772,13023,15795
2015-05-10 12:00:00-04:00,0,5,12,6,0,2122,8317,10439
2015-05-10 13:00:00-04:00,0,5,13,6,0,1005,4048,5053
2015-05-10 14:00:00-04:00,0,5,14,6,0,647,4534,5181
2015-05-10 15:00:00-04:00,0,5,15,6,0,700,6315,7015
2015-05-10 16:00:00-04:00,0,5,16,6,0,929,9178,10107
2015-05-10 17:00:00-04:00,0,5,17,6,0,1420,14157,15577
2015-05-10 18:00:00-04:00,0,5,18,6,0,1997,19247,21244
2015-05-10 19:00:00-04:00,0,5,19,6,0,2402,21986,24388
2015-05-10 20:00:00-04:00,0,5,20,6,0,2625,22749,25374
2015-05-10 21:00:00-04:00,0,5,21,6,0,2719,22509,25228
2015-05-10 22:00:00-04:00,0,5,22,6,0,3083,22735,25818
2015-05-10 23:00:00-04:00,0,5,23,6,0,3403,21028,24431
2015-05-11 00:00:00-04:00,0,5,0,0,0,3585,19638,23223
2015-05-11 01:00:00-04:00,0,5,1,0,0,3478,20911,24389
2015-05-11 02:00:00-04:00,0,5,2,0,0,3655,22024,25679
2015-05-11 03:00:00-04:00,0,5,3,0,0,3566,20399,23965
2015-05-11 04:00:00-04:00,0,5,4,0,0,3439,20443,23882
2015-05-11 05:00:00-04:00,0,5,5,0,0,3276,19025,22301
2015-05-11 06:00:00-04:00,0,5,6,0,0,3121,17705,20826
2015-05-11 07:00:00-04:00,0,5,7,0,0,2595,13788,16383
2015-05-11 08:00:00-04:00,0,5,8,0,0,1799,8922,10721
2015-05-11 09:00:00-04:00,0,5,9,0,0,1130,5102,6232
2015-05-11 10:00:00-04:00,0,5,10,0,0,773,3373,4146
2015-05-11 11:00:00-04:00,0,5,11,0,0,566,2109,2675
2015-05-11 12:00:00-04:00,0,5,12,0,0,625,2521,3146
2015-05-11 13:00:00-04:00,0,5,13,0,0,494,4559,5053
2015-05-11 14:00:00-04:00,0,5,14,0,0,851,11759,12610
2015-05-11 15:00:00-04:00,0,5,15,0,0,1705,19390,21095
2015-05-11 16:00:00-04:00,0,5,16,0,0,2579,22229,24808
2015-05-11 17:00:00-04:00,0,5,17,0,0,2520,20696,23216
2015-05-11 18:00:00-04:00,0,5,18,0,0,2031,18496,20527
2015-05-11 19:00:00-04:00,0,5,19,0,0,2003,18832,20835
2015-05-11 20:00:00-04:00,0,5,20,0,0,2002,19771,21773
2015-05-11 21:00:00-04:00,0,5,21,0,0,2030,19956,21986
2015-05-11 22:00:00-04:00,0,5,22,0,0,2424,21446,23870
2015-05-11 23:00:00-04:00,0,5,23,0,0,2722,21491,24213
2015-05-12 00:00:00-04:00,0,5,0,1,0,2704,17333,20037
2015-05-12 01:00:00-04:00,0,5,1,1,0,2730,21095,23825
2015-05-12 02:00:00-04:00,0,5,2,1,0,2963,25764,28727
2015-05-12 03:00:00-04:00,0,5,3,1,0,2843,25209,28052
2015-05-12 04:00:00-04:00,0,5,4,1,0,2521,24467,26988
2015-05-12 05:00:00-04:00,0,5,5,1,0,2380,23448,25828
2015-05-12 06:00:00-04:00,0,5,6,1,0,2162,21255,23417
2015-05-12 07:00:00-04:00,0,5,7,1,0,1869,16057,17926
2015-05-12 08:00:00-04:00,0,5,8,1,0,1441,11225,12666
2015-05-12 09:00:00-04:00,0,5,9,1,0,933,6602,7535
2015-05-12 10:00:00-04:00,0,5,10,1,0,554,3969,4523
2015-05-12 11:00:00-04:00,0,5,11,1,0,436,2510,2946
2015-05-12 12:00:00-04:00,0,5,12,1,0,411,2365,2776
2015-05-12 13:00:00-04:00,0,5,13,1,0,419,4401,4820
2015-05-12 14:00:00-04:00,0,5,14,1,0,774,11776,12550
2015-05-12 15:00:00-04:00,0,5,15,1,0,1762,20827,22589
2015-05-12 16:00:00-04:00,0,5,16,1,0,2600,23579,26179
2015-05-12 17:00:00-04:00,0,5,17,1,0,2415,22126,24541
2015-05-12 18:00:00-04:00,0,5,18,1,0,2218,20334,22552
2015-05-12 19:00:00-04:00,0,5,19,1,0,1963,20178,22141
2015-05-12 20:00:00-04:00,0,5,20,1,0,1952,20397,22349
2015-05-12 21:00:00-04:00,0,5,21,1,0,1986,20300,22286
2015-05-12 22:00:00-04:00,0,5,22,1,0,2394,21880,24274
2015-05-12 23:00:00-04:00,0,5,23,1,0,2525,20395,22920
2015-05-13 00:00:00-04:00,0,5,0,2,0,2568,16962,19530
2015-05-13 01:00:00-04:00,0,5,1,2,0,2857,21475,24332
2015-05-13 02:00:00-04:00,0,5,2,2,0,3205,26747,29952
2015-05-13 03:00:00-04:00,0,5,3,2,0,3056,26718,29774
2015-05-13 04:00:00-04:00,0,5,4,2,0,2896,26824,29720
2015-05-13 05:00:00-04:00,0,5,5,2,0,2761,26944,29705
2015-05-13 06:00:00-04:00,0,5,6,2,0,2578,25238,27816
2015-05-13 07:00:00-04:00,0,5,7,2,0,2322,20740,23062
2015-05-13 08:00:00-04:00,0,5,8,2,0,1658,13538,15196
2015-05-13 09:00:00-04:00,0,5,9,2,0,1125,8008,9133
2015-05-13 10:00:00-04:00,0,5,10,2,0,710,4905,5615
2015-05-13 11:00:00-04:00,0,5,11,2,0,476,3259,3735
2015-05-13 12:00:00-04:00,0,5,12,2,0,451,2828,3279
2015-05-13 13:00:00-04:00,0,5,13,2,0,447,4725,5172
2015-05-13 14:00:00-04:00,0,5,14,2,0,792,12123,12915
2015-05-13 15:00:00-04:00,0,5,15,2,0,1836,21669,23505
2015-05-13 16:00:00-04:00,0,5,16,2,0,2646,24031,26677
2015-05-13 17:00:00-04:00,0,5,17,2,0,2556,22299,24855
2015-05-13 18:00:00-04:00,0,5,18,2,0,2153,20294,22447
2015-05-13 19:00:00-04:00,0,5,19,2,0,2035,20625,22660
2015-05-13 20:00:00-04:00,0,5,20,2,0,1951,20298,22249
2015-05-13 21:00:00-04:00,0,5,21,2,0,2005,20209,22214
2015-05-13 22:00:00-04:00,0,5,22,2,0,2442,20588,23030
2015-05-13 23:00:00-04:00,0,5,23,2,0,2534,19319,21853
2015-05-14 00:00:00-04:00,0,5,0,3,0,2739,15838,18577
2015-05-14 01:00:00-04:00,0,5,1,3,0,3125,20595,23720
2015-05-14 02:00:00-04:00,0,5,2,3,0,3541,25986,29527
2015-05-14 03:00:00-04:00,0,5,3,3,0,3848,28967,32815
2015-05-14 04:00:00-04:00,0,5,4,3,0,3497,28800,32297
2015-05-14 05:00:00-04:00,0,5,5,3,0,3342,28803,32145
2015-05-14 06:00:00-04:00,0,5,6,3,0,3115,27040,30155
2015-05-14 07:00:00-04:00,0,5,7,3,0,2843,24624,27467
2015-05-14 08:00:00-04:00,0,5,8,3,0,2134,16615,18749
2015-05-14 09:00:00-04:00,0,5,9,3,0,1385,9607,10992
2015-05-14 10:00:00-04:00,0,5,10,3,0,908,5891,6799
2015-05-14 11:00:00-04:00,0,5,11,3,0,600,3860,4460
2015-05-14 12:00:00-04:00,0,5,12,3,0,530,3420,3950
2015-05-14 13:00:00-04:00,0,5,13,3,0,444,4696,5140
2015-05-14 14:00:00-04:00,0,5,14,3,0,786,12567,13353
2015-05-14 15:00:00-04:00,0,5,15,3,0,1884,21714,23598
2015-05-14 16:00:00-04:00,0,5,16,3,0,2726,24232,26958
2015-05-14 17:00:00-04:00,0,5,17,3,0,2585,22664,25249
2015-05-14 18:00:00-04:00,0,5,18,3,0,2150,20917,23067
2015-05-14 19:00:00-04:00,0,5,19,3,0,2069,20869,22938
2015-05-14 20:00:00-04:00,0,5,20,3,0,2071,21123,23194
2015-05-14 21:00:00-04:00,0,5,21,3,0,2132,20732,22864
2015-05-14 22:00:00-04:00,0,5,22,3,0,2347,21517,23864
2015-05-14 23:00:00-04:00,0,5,23,3,0,2695,18524,21219
2015-05-15 00:00:00-04:00,0,5,0,4,0,2880,14121,17001
2015-05-15 01:00:00-04:00,0,5,1,4,0,3225,18198,21423
2015-05-15 02:00:00-04:00,0,5,2,4,0,3695,24306,28001
2015-05-15 03:00:00-04:00,0,5,3,4,0,3739,27205,30944
2015-05-15 04:00:00-04:00,0,5,4,4,0,3631,28115,31746
2015-05-15 05:00:00-04:00,0,5,5,4,0,3537,28556,32093
2015-05-15 06:00:00-04:00,0,5,6,4,0,3487,26617,30104
2015-05-15 07:00:00-04:00,0,5,7,4,0,3138,23870,27008
2015-05-15 08:00:00-04:00,0,5,8,4,0,2486,19534,22020
2015-05-15 09:00:00-04:00,0,5,9,4,0,1720,13115,14835
2015-05-15 10:00:00-04:00,0,5,10,4,0,1178,8529,9707
2015-05-15 11:00:00-04:00,0,5,11,4,0,780,5702,6482
2015-05-15 12:00:00-04:00,0,5,12,4,0,665,4684,5349
2015-05-15 13:00:00-04:00,0,5,13,4,0,575,5020,5595
2015-05-15 14:00:00-04:00,0,5,14,4,0,870,11723,12593
2015-05-15 15:00:00-04:00,0,5,15,4,0,1871,20316,22187
2015-05-15 16:00:00-04:00,0,5,16,4,0,2558,22937,25495
2015-05-15 17:00:00-04:00,0,5,17,4,0,2565,22144,24709
2015-05-15 18:00:00-04:00,0,5,18,4,0,2314,20638,22952
2015-05-15 19:00:00-04:00,0,5,19,4,0,2193,20981,23174
2015-05-15 20:00:00-04:00,0,5,20,4,0,2023,20212,22235
2015-05-15 21:00:00-04:00,0,5,21,4,0,2016,18554,20570
2015-05-15 22:00:00-04:00,0,5,22,4,0,2457,19910,22367
2015-05-15 23:00:00-04:00,0,5,23,4,0,2869,17872,20741
2015-05-16 00:00:00-04:00,0,5,0,5,0,3246,15094,18340
2015-05-16 01:00:00-04:00,0,5,1,5,0,3812,20193,24005
2015-05-16 02:00:00-04:00,0,5,2,5,0,4453,26969,31422
2015-05-16 03:00:00-04:00,0.01,5,3,5,0,4635,30114,34749
2015-05-16 04:00:00-04:00,0,5,4,5,0,4470,28830,33300
2015-05-16 05:00:00-04:00,0,5,5,5,0,4799,29134,33933
2015-05-16 06:00:00-04:00,0,5,6,5,0,4723,28496,33219
2015-05-16 07:00:00-04:00,0,5,7,5,0,4674,26840,31514
2015-05-16 08:00:00-04:00,0.07,5,8,5,0,4320,24228,28548
2015-05-16 09:00:00-04:00,0,5,9,5,0,3839,21231,25070
2015-05-16 10:00:00-04:00,0,5,10,5,0,3206,18385,21591
2015-05-16 11:00:00-04:00,0,5,11,5,0,2431,13502,15933
2015-05-16 12:00:00-04:00,0,5,12,5,0,1801,8808,10609
2015-05-16 13:00:00-04:00,0,5,13,5,0,1114,5410,6524
2015-05-16 14:00:00-04:00,0,5,14,5,0,935,6441,7376
2015-05-16 15:00:00-04:00,0,5,15,5,0,977,7919,8896
2015-05-16 16:00:00-04:00,0,5,16,5,0,1513,14472,15985
2015-05-16 17:00:00-04:00,0,5,17,5,0,1875,18101,19976
2015-05-16 18:00:00-04:00,0,5,18,5,0,2126,21192,23318
2015-05-16 19:00:00-04:00,0,5,19,5,0,2458,22955,25413
2015-05-16 20:00:00-04:00,0.01,5,20,5,0,2687,23673,26360
2015-05-16 21:00:00-04:00,0.01,5,21,5,0,2784,23715,26499
2015-05-16 22:00:00-04:00,0.09,5,22,5,0,3060,22425,25485
2015-05-16 23:00:00-04:00,0.01,5,23,5,0,3239,21954,25193
2015-05-17 00:00:00-04:00,0.07,5,0,6,0,3529,19459,22988
2015-05-17 01:00:00-04:00,0.01,5,1,6,0,3750,21889,25639
2015-05-17 02:00:00-04:00,0,5,2,6,0,4416,25960,30376
2015-05-17 03:00:00-04:00,0.01,5,3,6,0,5039,27713,32752
2015-05-17 04:00:00-04:00,0,5,4,6,0,5048,27758,32806
2015-05-17 05:00:00-04:00,0,5,5,6,0,5243,28071,33314
2015-05-17 06:00:00-04:00,0,5,6,6,0,5521,28272,33793
2015-05-17 07:00:00-04:00,0,5,7,6,0,5094,26047,31141
2015-05-17 08:00:00-04:00,0,5,8,6,0,4820,24462,29282
2015-05-17 09:00:00-04:00,0,5,9,6,0,4102,21253,25355
2015-05-17 10:00:00-04:00,0,5,10,6,0,3376,18790,22166
2015-05-17 11:00:00-04:00,0,5,11,6,0,2646,13999,16645
2015-05-17 12:00:00-04:00,0,5,12,6,0,1967,8986,10953
2015-05-17 13:00:00-04:00,0,5,13,6,0,1009,4463,5472
2015-05-17 14:00:00-04:00,0,5,14,6,0,680,4675,5355
2015-05-17 15:00:00-04:00,0,5,15,6,0,777,6534,7311
2015-05-17 16:00:00-04:00,0,5,16,6,0,974,10281,11255
2015-05-17 17:00:00-04:00,0,5,17,6,0,1493,15213,16706
2015-05-17 18:00:00-04:00,0,5,18,6,0,1958,20210,22168
2015-05-17 19:00:00-04:00,0,5,19,6,0,2274,22210,24484
2015-05-17 20:00:00-04:00,0,5,20,6,0,2524,23577,26101
2015-05-17 21:00:00-04:00,0,5,21,6,0,2645,23438,26083
2015-05-17 22:00:00-04:00,0,5,22,6,0,2912,23176,26088
2015-05-17 23:00:00-04:00,0,5,23,6,0,3144,21937,25081
2015-05-18 00:00:00-04:00,0,5,0,0,0,3304,19696,23000
2015-05-18 01:00:00-04:00,0,5,1,0,0,3247,21078,24325
2015-05-18 02:00:00-04:00,0,5,2,0,0,3460,23126,26586
2015-05-18 03:00:00-04:00,0,5,3,0,0,3309,21846,25155
2015-05-18 04:00:00-04:00,0,5,4,0,0,3075,20353,23428
2015-05-18 05:00:00-04:00,0,5,5,0,0,2951,19902,22853
2015-05-18 06:00:00-04:00,0,5,6,0,0,2725,18525,21250
2015-05-18 07:00:00-04:00,0,5,7,0,0,2374,15468,17842
2015-05-18 08:00:00-04:00,0,5,8,0,0,1884,10142,12026
2015-05-18 09:00:00-04:00,0,5,9,0,0,1243,5778,7021
2015-05-18 10:00:00-04:00,0,5,10,0,0,843,4052,4895
2015-05-18 11:00:00-04:00,0,5,11,0,0,643,2670,3313
2015-05-18 12:00:00-04:00,0,5,12,0,0,632,2934,3566
2015-05-18 13:00:00-04:00,0,5,13,0,0,524,4755,5279
2015-05-18 14:00:00-04:00,0,5,14,0,0,844,11465,12309
2015-05-18 15:00:00-04:00,0,5,15,0,0,1807,18895,20702
2015-05-18 16:00:00-04:00,0,5,16,0,0,2574,21096,23670
2015-05-18 17:00:00-04:00,0,5,17,0,0,2367,20749,23116
2015-05-18 18:00:00-04:00,0,5,18,0,0,2070,19022,21092
2015-05-18 19:00:00-04:00,0,5,19,0,0,1925,19277,21202
2015-05-18 20:00:00-04:00,0,5,20,0,0,1887,20251,22138
2015-05-18 21:00:00-04:00,0,5,21,0,0,1911,20306,22217
2015-05-18 22:00:00-04:00,0,5,22,0,0,2198,21594,23792
2015-05-18 23:00:00-04:00,0,5,23,0,0,2511,20546,23057
2015-05-19 00:00:00-04:00,0,5,0,1,0,2899,17567,20466
2015-05-19 01:00:00-04:00,0,5,1,1,0,2919,20892,23811
2015-05-19 02:00:00-04:00,0,5,2,1,0,3130,25342,28472
2015-05-19 03:00:00-04:00,0,5,3,1,0,2965,26225,29190
2015-05-19 04:00:00-04:00,0.01,5,4,1,0,2681,24604,27285
2015-05-19 05:00:00-04:00,0,5,5,1,0,2331,25052,27383
2015-05-19 06:00:00-04:00,0,5,6,1,0,2095,23004,25099
2015-05-19 07:00:00-04:00,0,5,7,1,0,1937,17423,19360
2015-05-19 08:00:00-04:00,0,5,8,1,0,1436,11994,13430
2015-05-19 09:00:00-04:00,0,5,9,1,0,960,7381,8341
2015-05-19 10:00:00-04:00,0,5,10,1,0,585,4681,5266
2015-05-19 11:00:00-04:00,0,5,11,1,0,436,2700,3136
2015-05-19 12:00:00-04:00,0,5,12,1,0,452,2666,3118
2015-05-19 13:00:00-04:00,0,5,13,1,0,431,4326,4757
2015-05-19 14:00:00-04:00,0,5,14,1,0,812,12067,12879
2015-05-19 15:00:00-04:00,0,5,15,1,0,1839,21294,23133
2015-05-19 16:00:00-04:00,0,5,16,1,0,2757,25300,28057
2015-05-19 17:00:00-04:00,0,5,17,1,0,2668,23761,26429
2015-05-19 18:00:00-04:00,0,5,18,1,0,2176,20350,22526
2015-05-19 19:00:00-04:00,0,5,19,1,0,1993,20918,22911
2015-05-19 20:00:00-04:00,0,5,20,1,0,2116,21285,23401
2015-05-19 21:00:00-04:00,0,5,21,1,0,2065,20682,22747
2015-05-19 22:00:00-04:00,0,5,22,1,0,2275,21950,24225
2015-05-19 23:00:00-04:00,0,5,23,1,0,2422,20395,22817
2015-05-20 00:00:00-04:00,0,5,0,2,0,2587,16540,19127
2015-05-20 01:00:00-04:00,0,5,1,2,0,2953,21034,23987
2015-05-20 02:00:00-04:00,0,5,2,2,0,3216,26502,29718
2015-05-20 03:00:00-04:00,0,5,3,2,0,3397,28048,31445
2015-05-20 04:00:00-04:00,0,5,4,2,0,2862,26731,29593
2015-05-20 05:00:00-04:00,0,5,5,2,0,2790,26645,29435
2015-05-20 06:00:00-04:00,0,5,6,2,0,2506,24682,27188
2015-05-20 07:00:00-04:00,0,5,7,2,0,2298,21011,23309
2015-05-20 08:00:00-04:00,0,5,8,2,0,1704,14456,16160
2015-05-20 09:00:00-04:00,0,5,9,2,0,1129,8380,9509
2015-05-20 10:00:00-04:00,0,5,10,2,0,759,5262,6021
2015-05-20 11:00:00-04:00,0,5,11,2,0,515,3510,4025
2015-05-20 12:00:00-04:00,0,5,12,2,0,501,3215,3716
2015-05-20 13:00:00-04:00,0,5,13,2,0,445,4852,5297
2015-05-20 14:00:00-04:00,0,5,14,2,0,781,12140,12921
2015-05-20 15:00:00-04:00,0,5,15,2,0,1744,21390,23134
2015-05-20 16:00:00-04:00,0,5,16,2,0,2536,24229,26765
2015-05-20 17:00:00-04:00,0,5,17,2,0,2436,22806,25242
2015-05-20 18:00:00-04:00,0,5,18,2,0,2125,20556,22681
2015-05-20 19:00:00-04:00,0,5,19,2,0,1987,20719,22706
2015-05-20 20:00:00-04:00,0,5,20,2,0,2140,21218,23358
2015-05-20 21:00:00-04:00,0,5,21,2,0,2224,20793,23017
2015-05-20 22:00:00-04:00,0,5,22,2,0,2402,21416,23818
2015-05-20 23:00:00-04:00,0,5,23,2,0,2560,19689,22249
2015-05-21 00:00:00-04:00,0,5,0,3,0,2741,15864,18605
2015-05-21 01:00:00-04:00,0,5,1,3,0,3096,19876,22972
2015-05-21 02:00:00-04:00,0,5,2,3,0,3474,25425,28899
2015-05-21 03:00:00-04:00,0,5,3,3,0,3609,28754,32363
2015-05-21 04:00:00-04:00,0,5,4,3,0,3323,28493,31816
2015-05-21 05:00:00-04:00,0,5,5,3,0,3263,28582,31845
2015-05-21 06:00:00-04:00,0,5,6,3,0,2970,26630,29600
2015-05-21 07:00:00-04:00,0,5,7,3,0,2765,22977,25742
2015-05-21 08:00:00-04:00,0,5,8,3,0,2013,15455,17468
2015-05-21 09:00:00-04:00,0,5,9,3,0,1399,9386,10785
2015-05-21 10:00:00-04:00,0,5,10,3,0,874,5987,6861
2015-05-21 11:00:00-04:00,0,5,11,3,0,614,3793,4407
2015-05-21 12:00:00-04:00,0,5,12,3,0,599,3360,3959
2015-05-21 13:00:00-04:00,0,5,13,3,0,519,4737,5256
2015-05-21 14:00:00-04:00,0,5,14,3,0,828,12024,12852
2015-05-21 15:00:00-04:00,0,5,15,3,0,1869,21441,23310
2015-05-21 16:00:00-04:00,0,5,16,3,0,2643,23895,26538
2015-05-21 17:00:00-04:00,0,5,17,3,0,2606,23144,25750
2015-05-21 18:00:00-04:00,0,5,18,3,0,2335,21341,23676
2015-05-21 19:00:00-04:00,0,5,19,3,0,2079,21024,23103
2015-05-21 20:00:00-04:00,0,5,20,3,0,2090,21538,23628
2015-05-21 21:00:00-04:00,0,5,21,3,0,2152,21576,23728
2015-05-21 22:00:00-04:00,0,5,22,3,0,2460,22285,24745
2015-05-21 23:00:00-04:00,0,5,23,3,0,2742,19847,22589
2015-05-22 00:00:00-04:00,0,5,0,4,0,3012,15592,18604
2015-05-22 01:00:00-04:00,0,5,1,4,0,3496,20445,23941
2015-05-22 02:00:00-04:00,0,5,2,4,0,3863,25940,29803
2015-05-22 03:00:00-04:00,0,5,3,4,0,3816,27833,31649
2015-05-22 04:00:00-04:00,0,5,4,4,0,3466,27546,31012
2015-05-22 05:00:00-04:00,0,5,5,4,0,3376,28155,31531
2015-05-22 06:00:00-04:00,0,5,6,4,0,3143,26256,29399
2015-05-22 07:00:00-04:00,0,5,7,4,0,2943,24219,27162
2015-05-22 08:00:00-04:00,0,5,8,4,0,2235,19033,21268
2015-05-22 09:00:00-04:00,0,5,9,4,0,1583,12617,14200
2015-05-22 10:00:00-04:00,0,5,10,4,0,1127,8665,9792
2015-05-22 11:00:00-04:00,0,5,11,4,0,801,5864,6665
2015-05-22 12:00:00-04:00,0,5,12,4,0,721,4646,5367
2015-05-22 13:00:00-04:00,0,5,13,4,0,622,5269,5891
2015-05-22 14:00:00-04:00,0,5,14,4,0,849,11204,12053
2015-05-22 15:00:00-04:00,0,5,15,4,0,1764,18387,20151
2015-05-22 16:00:00-04:00,0,5,16,4,0,2489,21451,23940
2015-05-22 17:00:00-04:00,0,5,17,4,0,2474,20424,22898
2015-05-22 18:00:00-04:00,0,5,18,4,0,2150,18847,20997
2015-05-22 19:00:00-04:00,0,5,19,4,0,2025,18823,20848
2015-05-22 20:00:00-04:00,0,5,20,4,0,2109,20176,22285
2015-05-22 21:00:00-04:00,0,5,21,4,0,2027,19618,21645
2015-05-22 22:00:00-04:00,0,5,22,4,0,2584,20846,23430
2015-05-22 23:00:00-04:00,0,5,23,4,0,3355,18888,22243
2015-05-23 00:00:00-04:00,0,5,0,5,0,3429,15619,19048
2015-05-23 01:00:00-04:00,0,5,1,5,0,3821,19797,23618
2015-05-23 02:00:00-04:00,0,5,2,5,0,4017,23358,27375
2015-05-23 03:00:00-04:00,0,5,3,5,0,4062,24313,28375
2015-05-23 04:00:00-04:00,0,5,4,5,0,3834,21877,25711
2015-05-23 05:00:00-04:00,0,5,5,5,0,3944,21987,25931
2015-05-23 06:00:00-04:00,0,5,6,5,0,4172,23922,28094
2015-05-23 07:00:00-04:00,0,5,7,5,0,4598,23998,28596
2015-05-23 08:00:00-04:00,0,5,8,5,0,4312,22267,26579
2015-05-23 09:00:00-04:00,0,5,9,5,0,3803,18182,21985
2015-05-23 10:00:00-04:00,0,5,10,5,0,3026,14792,17818
2015-05-23 11:00:00-04:00,0,5,11,5,0,2469,11014,13483
2015-05-23 12:00:00-04:00,0,5,12,5,0,1778,7555,9333
2015-05-23 13:00:00-04:00,0,5,13,5,0,875,4566,5441
2015-05-23 14:00:00-04:00,0,5,14,5,0,719,5149,5868
2015-05-23 15:00:00-04:00,0,5,15,5,0,816,6941,7757
2015-05-23 16:00:00-04:00,0,5,16,5,0,1122,9380,10502
2015-05-23 17:00:00-04:00,0,5,17,5,0,1530,13053,14583
2015-05-23 18:00:00-04:00,0,5,18,5,0,1908,15714,17622
2015-05-23 19:00:00-04:00,0,5,19,5,0,2077,17233,19310
2015-05-23 20:00:00-04:00,0,5,20,5,0,2217,18171,20388
2015-05-23 21:00:00-04:00,0,5,21,5,0,2204,19106,21310
2015-05-23 22:00:00-04:00,0,5,22,5,0,2529,18055,20584
2015-05-23 23:00:00-04:00,0,5,23,5,0,2871,18318,21189
2015-05-24 00:00:00-04:00,0,5,0,6,0,3141,17796,20937
2015-05-24 01:00:00-04:00,0,5,1,6,0,3225,19954,23179
2015-05-24 02:00:00-04:00,0,5,2,6,0,3588,21407,24995
2015-05-24 03:00:00-04:00,0,5,3,6,0,3918,22381,26299
2015-05-24 04:00:00-04:00,0,5,4,6,0,3788,19385,23173
2015-05-24 05:00:00-04:00,0,5,5,6,0,4112,19780,23892
2015-05-24 06:00:00-04:00,0,5,6,6,0,4331,21559,25890
2015-05-24 07:00:00-04:00,0,5,7,6,0,4361,21605,25966
2015-05-24 08:00:00-04:00,0,5,8,6,0,4356,20303,24659
2015-05-24 09:00:00-04:00,0,5,9,6,0,3755,17013,20768
2015-05-24 10:00:00-04:00,0,5,10,6,0,3158,13594,16752
2015-05-24 11:00:00-04:00,0,5,11,6,0,2497,10655,13152
2015-05-24 12:00:00-04:00,0,5,12,6,0,1906,7525,9431
2015-05-24 13:00:00-04:00,0,5,13,6,0,929,3529,4458
2015-05-24 14:00:00-04:00,0,5,14,6,0,630,3524,4154
2015-05-24 15:00:00-04:00,0,5,15,6,0,673,4860,5533
2015-05-24 16:00:00-04:00,0,5,16,6,0,736,6494,7230
2015-05-24 17:00:00-04:00,0,5,17,6,0,1078,9757,10835
2015-05-24 18:00:00-04:00,0,5,18,6,0,1558,13663,15221
2015-05-24 19:00:00-04:00,0,5,19,6,0,1801,15407,17208
2015-05-24 20:00:00-04:00,0,5,20,6,0,1979,16579,18558
2015-05-24 21:00:00-04:00,0,5,21,6,0,2216,17780,19996
2015-05-24 22:00:00-04:00,0,5,22,6,0,2439,18703,21142
2015-05-24 23:00:00-04:00,0,5,23,6,0,2842,17150,19992
2015-05-25 00:00:00-04:00,0,5,0,0,1,2793,16676,19469
2015-05-25 01:00:00-04:00,0,5,1,0,1,2833,18387,21220
2015-05-25 02:00:00-04:00,0,5,2,0,1,3103,19152,22255
2015-05-25 03:00:00-04:00,0,5,3,0,1,3139,18233,21372
2015-05-25 04:00:00-04:00,0,5,4,0,1,2962,16788,19750
2015-05-25 05:00:00-04:00,0,5,5,0,1,3102,16677,19779
2015-05-25 06:00:00-04:00,0,5,6,0,1,3241,16938,20179
2015-05-25 07:00:00-04:00,0,5,7,0,1,3308,17265,20573
2015-05-25 08:00:00-04:00,0,5,8,0,1,2998,14528,17526
2015-05-25 09:00:00-04:00,0,5,9,0,1,2423,10506,12929
2015-05-25 10:00:00-04:00,0,5,10,0,1,1757,7842,9599
2015-05-25 11:00:00-04:00,0,5,11,0,1,1302,5532,6834
2015-05-25 12:00:00-04:00,0,5,12,0,1,1049,4094,5143
2015-05-25 13:00:00-04:00,0,5,13,0,1,714,2864,3578
2015-05-25 14:00:00-04:00,0,5,14,0,1,539,3546,4085
2015-05-25 15:00:00-04:00,0,5,15,0,1,564,4476,5040
2015-05-25 16:00:00-04:00,0,5,16,0,1,617,5901,6518
2015-05-25 17:00:00-04:00,0,5,17,0,1,874,8651,9525
2015-05-25 18:00:00-04:00,0,5,18,0,1,1091,11183,12274
2015-05-25 19:00:00-04:00,0,5,19,0,1,1322,13477,14799
2015-05-25 20:00:00-04:00,0,5,20,0,1,1579,15474,17053
2015-05-25 21:00:00-04:00,0,5,21,0,1,1670,16782,18452
2015-05-25 22:00:00-04:00,0,5,22,0,1,2116,17592,19708
2015-05-25 23:00:00-04:00,0,5,23,0,1,2335,18149,20484
2015-05-26 00:00:00-04:00,0,5,0,1,0,2631,17699,20330
2015-05-26 01:00:00-04:00,0,5,1,1,0,2614,18952,21566
2015-05-26 02:00:00-04:00,0,5,2,1,0,2813,19864,22677
2015-05-26 03:00:00-04:00,0,5,3,1,0,2850,19386,22236
2015-05-26 04:00:00-04:00,0,5,4,1,0,2679,17960,20639
2015-05-26 05:00:00-04:00,0,5,5,1,0,2823,18196,21019
2015-05-26 06:00:00-04:00,0,5,6,1,0,2576,16425,19001
2015-05-26 07:00:00-04:00,0,5,7,1,0,2064,12627,14691
2015-05-26 08:00:00-04:00,0,5,8,1,0,1481,8266,9747
2015-05-26 09:00:00-04:00,0,5,9,1,0,949,4497,5446
2015-05-26 10:00:00-04:00,0,5,10,1,0,611,2940,3551
2015-05-26 11:00:00-04:00,0,5,11,1,0,454,1906,2360
2015-05-26 12:00:00-04:00,0,5,12,1,0,461,2315,2776
2015-05-26 13:00:00-04:00,0,5,13,1,0,455,4394,4849
2015-05-26 14:00:00-04:00,0,5,14,1,0,811,11457,12268
2015-05-26 15:00:00-04:00,0,5,15,1,0,1769,19075,20844
2015-05-26 16:00:00-04:00,0,5,16,1,0,2620,21393,24013
2015-05-26 17:00:00-04:00,0,5,17,1,0,2330,20196,22526
2015-05-26 18:00:00-04:00,0,5,18,1,0,2008,18211,20219
2015-05-26 19:00:00-04:00,0,5,19,1,0,1869,18514,20383
2015-05-26 20:00:00-04:00,0,5,20,1,0,1897,19300,21197
2015-05-26 21:00:00-04:00,0,5,21,1,0,1917,19849,21766
2015-05-26 22:00:00-04:00,0,5,22,1,0,2237,21499,23736
2015-05-26 23:00:00-04:00,0,5,23,1,0,2433,20359,22792
2015-05-27 00:00:00-04:00,0,5,0,2,0,2527,17563,20090
2015-05-27 01:00:00-04:00,0,5,1,2,0,2726,21213,23939
2015-05-27 02:00:00-04:00,0,5,2,2,0,2973,25947,28920
2015-05-27 03:00:00-04:00,0,5,3,2,0,2876,24575,27451
2015-05-27 04:00:00-04:00,0,5,4,2,0,2439,23204,25643
2015-05-27 05:00:00-04:00,0,5,5,2,0,2398,23362,25760
2015-05-27 06:00:00-04:00,0,5,6,2,0,2232,20870,23102
2015-05-27 07:00:00-04:00,0,5,7,2,0,2105,16229,18334
2015-05-27 08:00:00-04:00,0,5,8,2,0,1543,10072,11615
2015-05-27 09:00:00-04:00,0,5,9,2,0,965,6016,6981
2015-05-27 10:00:00-04:00,0,5,10,2,0,680,3827,4507
2015-05-27 11:00:00-04:00,0,5,11,2,0,446,2762,3208
2015-05-27 12:00:00-04:00,0,5,12,2,0,433,2484,2917
2015-05-27 13:00:00-04:00,0,5,13,2,0,423,4280,4703
2015-05-27 14:00:00-04:00,0,5,14,2,0,800,11782,12582
2015-05-27 15:00:00-04:00,0,5,15,2,0,1917,21007,22924
2015-05-27 16:00:00-04:00,0,5,16,2,0,2616,24006,26622
2015-05-27 17:00:00-04:00,0,5,17,2,0,2403,22048,24451
2015-05-27 18:00:00-04:00,0,5,18,2,0,2106,20065,22171
2015-05-27 19:00:00-04:00,0,5,19,2,0,1932,20124,22056
2015-05-27 20:00:00-04:00,0.01,5,20,2,0,1972,20401,22373
2015-05-27 21:00:00-04:00,0.01,5,21,2,0,1988,20262,22250
2015-05-27 22:00:00-04:00,0,5,22,2,0,2252,21077,23329
2015-05-27 23:00:00-04:00,0,5,23,2,0,2550,19281,21831
2015-05-28 00:00:00-04:00,0,5,0,3,0,2716,15811,18527
2015-05-28 01:00:00-04:00,0,5,1,3,0,2857,19513,22370
2015-05-28 02:00:00-04:00,0,5,2,3,0,3400,25833,29233
2015-05-28 03:00:00-04:00,0,5,3,3,0,3783,27899,31682
2015-05-28 04:00:00-04:00,0,5,4,3,0,3575,27315,30890
2015-05-28 05:00:00-04:00,0,5,5,3,0,2834,26018,28852
2015-05-28 06:00:00-04:00,0,5,6,3,0,2542,24625,27167
2015-05-28 07:00:00-04:00,0,5,7,3,0,2338,19411,21749
2015-05-28 08:00:00-04:00,0,5,8,3,0,1789,13627,15416
2015-05-28 09:00:00-04:00,0,5,9,3,0,1192,7973,9165
2015-05-28 10:00:00-04:00,0,5,10,3,0,793,4883,5676
2015-05-28 11:00:00-04:00,0,5,11,3,0,499,3077,3576
2015-05-28 12:00:00-04:00,0,5,12,3,0,482,2817,3299
2015-05-28 13:00:00-04:00,0,5,13,3,0,465,4466,4931
2015-05-28 14:00:00-04:00,0,5,14,3,0,829,11640,12469
2015-05-28 15:00:00-04:00,0,5,15,3,0,1836,21193,23029
2015-05-28 16:00:00-04:00,0,5,16,3,0,2602,24204,26806
2015-05-28 17:00:00-04:00,0,5,17,3,0,2564,22747,25311
2015-05-28 18:00:00-04:00,0,5,18,3,0,2198,20787,22985
2015-05-28 19:00:00-04:00,0,5,19,3,0,2068,20525,22593
2015-05-28 20:00:00-04:00,0,5,20,3,0,2063,20688,22751
2015-05-28 21:00:00-04:00,0,5,21,3,0,2106,20756,22862
2015-05-28 22:00:00-04:00,0,5,22,3,0,2468,21609,24077
2015-05-28 23:00:00-04:00,0,5,23,3,0,2628,19867,22495
2015-05-29 00:00:00-04:00,0,5,0,4,0,2943,16007,18950
2015-05-29 01:00:00-04:00,0,5,1,4,0,3283,20342,23625
2015-05-29 02:00:00-04:00,0,5,2,4,0,3515,25857,29372
2015-05-29 03:00:00-04:00,0,5,3,4,0,3618,27804,31422
2015-05-29 04:00:00-04:00,0,5,4,4,0,3159,26519,29678
2015-05-29 05:00:00-04:00,0,5,5,4,0,3163,27266,30429
2015-05-29 06:00:00-04:00,0,5,6,4,0,3076,25066,28142
2015-05-29 07:00:00-04:00,0,5,7,4,0,2997,22392,25389
2015-05-29 08:00:00-04:00,0,5,8,4,0,2406,17735,20141
2015-05-29 09:00:00-04:00,0,5,9,4,0,1726,11816,13542
2015-05-29 10:00:00-04:00,0,5,10,4,0,1227,7706,8933
2015-05-29 11:00:00-04:00,0,5,11,4,0,874,5408,6282
2015-05-29 12:00:00-04:00,0,5,12,4,0,705,4308,5013
2015-05-29 13:00:00-04:00,0,5,13,4,0,537,5000,5537
2015-05-29 14:00:00-04:00,0,5,14,4,0,803,11400,12203
2015-05-29 15:00:00-04:00,0,5,15,4,0,1831,20026,21857
2015-05-29 16:00:00-04:00,0,5,16,4,0,2632,23067,25699
2015-05-29 17:00:00-04:00,0,5,17,4,0,2425,21753,24178
2015-05-29 18:00:00-04:00,0,5,18,4,0,2109,19759,21868
2015-05-29 19:00:00-04:00,0,5,19,4,0,2076,19993,22069
2015-05-29 20:00:00-04:00,0,5,20,4,0,1992,19879,21871
2015-05-29 21:00:00-04:00,0,5,21,4,0,1934,19337,21271
2015-05-29 22:00:00-04:00,0,5,22,4,0,2435,20211,22646
2015-05-29 23:00:00-04:00,0,5,23,4,0,2810,18351,21161
2015-05-30 00:00:00-04:00,0,5,0,5,0,3187,15734,18921
2015-05-30 01:00:00-04:00,0,5,1,5,0,3568,19912,23480
2015-05-30 02:00:00-04:00,0,5,2,5,0,4202,26025,30227
2015-05-30 03:00:00-04:00,0,5,3,5,0,4302,28812,33114
2015-05-30 04:00:00-04:00,0,5,4,5,0,4003,25955,29958
2015-05-30 05:00:00-04:00,0,5,5,5,0,4224,25524,29748
2015-05-30 06:00:00-04:00,0,5,6,5,0,4369,26674,31043
2015-05-30 07:00:00-04:00,0,5,7,5,0,4905,26914,31819
2015-05-30 08:00:00-04:00,0,5,8,5,0,4441,24611,29052
2015-05-30 09:00:00-04:00,0,5,9,5,0,3970,22059,26029
2015-05-30 10:00:00-04:00,0,5,10,5,0,3234,17794,21028
2015-05-30 11:00:00-04:00,0,5,11,5,0,2474,13223,15697
2015-05-30 12:00:00-04:00,0,5,12,5,0,1862,8370,10232
2015-05-30 13:00:00-04:00,0,5,13,5,0,946,4336,5282
2015-05-30 14:00:00-04:00,0,5,14,5,0,729,5092,5821
2015-05-30 15:00:00-04:00,0,5,15,5,0,927,7719,8646
2015-05-30 16:00:00-04:00,0,5,16,5,0,1399,12714,14113
2015-05-30 17:00:00-04:00,0,5,17,5,0,1845,17061,18906
2015-05-30 18:00:00-04:00,0,5,18,5,0,2265,20776,23041
2015-05-30 19:00:00-04:00,0,5,19,5,0,2492,21535,24027
2015-05-30 20:00:00-04:00,0,5,20,5,0,2664,22519,25183
2015-05-30 21:00:00-04:00,0,5,21,5,0,2709,22991,25700
2015-05-30 22:00:00-04:00,0,5,22,5,0,3066,21751,24817
2015-05-30 23:00:00-04:00,0,5,23,5,0,3334,21223,24557
2015-05-31 00:00:00-04:00,0,5,0,6,0,3581,18508,22089
2015-05-31 01:00:00-04:00,0,5,1,6,0,3627,21293,24920
2015-05-31 02:00:00-04:00,0,5,2,6,0,4255,24624,28879
2015-05-31 03:00:00-04:00,0,5,3,6,0,4511,25445,29956
2015-05-31 04:00:00-04:00,0,5,4,6,0,4123,22351,26474
2015-05-31 05:00:00-04:00,0,5,5,6,0,4586,23160,27746
2015-05-31 06:00:00-04:00,0,5,6,6,0,4899,25478,30377
2015-05-31 07:00:00-04:00,0,5,7,6,0,5147,26447,31594
2015-05-31 08:00:00-04:00,0,5,8,6,0,5026,24928,29954
2015-05-31 09:00:00-04:00,0,5,9,6,0,4388,22545,26933
2015-05-31 10:00:00-04:00,0,5,10,6,0,3865,19300,23165
2015-05-31 11:00:00-04:00,0,5,11,6,0,3065,14386,17451
2015-05-31 12:00:00-04:00,0,5,12,6,0,2141,9093,11234
2015-05-31 13:00:00-04:00,0,5,13,6,0,1109,4259,5368
2015-05-31 14:00:00-04:00,0,5,14,6,0,724,4138,4862
2015-05-31 15:00:00-04:00,0,5,15,6,0,712,5564,6276
2015-05-31 16:00:00-04:00,0.04,5,16,6,0,849,8691,9540
2015-05-31 17:00:00-04:00,0.35,5,17,6,0,1333,13123,14456
2015-05-31 18:00:00-04:00,0.64,5,18,6,0,1734,17279,19013
2015-05-31 19:00:00-04:00,0.03,5,19,6,0,2086,18845,20931
2015-05-31 20:00:00-04:00,0.1,5,20,6,0,2260,20152,22412
2015-05-31 21:00:00-04:00,0.05,5,21,6,0,2338,20420,22758
2015-05-31 22:00:00-04:00,0,5,22,6,0,2749,20174,22923
2015-05-31 23:00:00-04:00,0.07,5,23,6,0,2995,17571,20566
2015-06-01 00:00:00-04:00,0,6,0,0,0,3685,15499,19184
2015-06-01 01:00:00-04:00,0,6,1,0,0,4026,16046,20072
2015-06-01 02:00:00-04:00,0,6,2,0,0,3911,17148,21059
2015-06-01 03:00:00-04:00,0.15,6,3,0,0,3824,17598,21422
2015-06-01 04:00:00-04:00,0.22,6,4,0,0,3229,17222,20451
2015-06-01 05:00:00-04:00,0.04,6,5,0,0,2844,16079,18923
2015-06-01 06:00:00-04:00,0,6,6,0,0,2593,15210,17803
2015-06-01 07:00:00-04:00,0,6,7,0,0,2458,12749,15207
2015-06-01 08:00:00-04:00,0,6,8,0,0,1785,9250,11035
2015-06-01 09:00:00-04:00,0,6,9,0,0,1138,6551,7689
2015-06-01 10:00:00-04:00,0.03,6,10,0,0,711,4346,5057
2015-06-01 11:00:00-04:00,0.17,6,11,0,0,579,2587,3166
2015-06-01 12:00:00-04:00,0.05,6,12,0,0,596,2696,3292
2015-06-01 13:00:00-04:00,0.01,6,13,0,0,523,4669,5192
2015-06-01 14:00:00-04:00,0,6,14,0,0,829,12144,12973
2015-06-01 15:00:00-04:00,0,6,15,0,0,1862,19217,21079
2015-06-01 16:00:00-04:00,0,6,16,0,0,2905,21985,24890
2015-06-01 17:00:00-04:00,0,6,17,0,0,2778,20515,23293
2015-06-01 18:00:00-04:00,0,6,18,0,0,2678,20343,23021
2015-06-01 19:00:00-04:00,0.01,6,19,0,0,2645,20669,23314
2015-06-01 20:00:00-04:00,0.01,6,20,0,0,2341,19518,21859
2015-06-01 21:00:00-04:00,0.01,6,21,0,0,2051,18250,20301
2015-06-01 22:00:00-04:00,0.02,6,22,0,0,2402,20019,22421
2015-06-01 23:00:00-04:00,0.03,6,23,0,0,2568,19613,22181
2015-06-02 00:00:00-04:00,0.02,6,0,1,0,2875,17310,20185
2015-06-02 01:00:00-04:00,0.01,6,1,1,0,3171,21646,24817
2015-06-02 02:00:00-04:00,0.05,6,2,1,0,3454,25656,29110
2015-06-02 03:00:00-04:00,0.03,6,3,1,0,3536,26795,30331
2015-06-02 04:00:00-04:00,0,6,4,1,0,2873,24404,27277
2015-06-02 05:00:00-04:00,0,6,5,1,0,2767,24901,27668
2015-06-02 06:00:00-04:00,0.02,6,6,1,0,2483,22257,24740
2015-06-02 07:00:00-04:00,0.01,6,7,1,0,1999,15492,17491
2015-06-02 08:00:00-04:00,0.01,6,8,1,0,1464,10288,11752
2015-06-02 09:00:00-04:00,0.01,6,9,1,0,992,6853,7845
2015-06-02 10:00:00-04:00,0,6,10,1,0,581,4124,4705
2015-06-02 11:00:00-04:00,0,6,11,1,0,397,2403,2800
2015-06-02 12:00:00-04:00,0,6,12,1,0,380,2292,2672
2015-06-02 13:00:00-04:00,0.01,6,13,1,0,383,4592,4975
2015-06-02 14:00:00-04:00,0.01,6,14,1,0,823,12359,13182
2015-06-02 15:00:00-04:00,0.06,6,15,1,0,1837,20801,22638
2015-06-02 16:00:00-04:00,0.01,6,16,1,0,2783,23936,26719
2015-06-02 17:00:00-04:00,0.02,6,17,1,0,2605,22183,24788
2015-06-02 18:00:00-04:00,0.01,6,18,1,0,2227,19522,21749
2015-06-02 19:00:00-04:00,0.04,6,19,1,0,2001,19488,21489
2015-06-02 20:00:00-04:00,0.04,6,20,1,0,1919,20507,22426
2015-06-02 21:00:00-04:00,0,6,21,1,0,2072,21086,23158
2015-06-02 22:00:00-04:00,0.02,6,22,1,0,2491,22407,24898
2015-06-02 23:00:00-04:00,0,6,23,1,0,2920,20726,23646
2015-06-03 00:00:00-04:00,0,6,0,2,0,2965,16286,19251
2015-06-03 01:00:00-04:00,0,6,1,2,0,3242,20757,23999
2015-06-03 02:00:00-04:00,0,6,2,2,0,3622,25919,29541
2015-06-03 03:00:00-04:00,0,6,3,2,0,3663,27330,30993
2015-06-03 04:00:00-04:00,0,6,4,2,0,3148,26922,30070
2015-06-03 05:00:00-04:00,0,6,5,2,0,2844,26702,29546
2015-06-03 06:00:00-04:00,0,6,6,2,0,2473,23768,26241
2015-06-03 07:00:00-04:00,0,6,7,2,0,2130,18743,20873
2015-06-03 08:00:00-04:00,0,6,8,2,0,1554,12692,14246
2015-06-03 09:00:00-04:00,0,6,9,2,0,1014,7171,8185
2015-06-03 10:00:00-04:00,0,6,10,2,0,601,4586,5187
2015-06-03 11:00:00-04:00,0,6,11,2,0,447,2817,3264
2015-06-03 12:00:00-04:00,0,6,12,2,0,394,2722,3116
2015-06-03 13:00:00-04:00,0,6,13,2,0,369,4309,4678
2015-06-03 14:00:00-04:00,0,6,14,2,0,771,11643,12414
2015-06-03 15:00:00-04:00,0,6,15,2,0,1739,21091,22830
2015-06-03 16:00:00-04:00,0,6,16,2,0,2628,24361,26989
2015-06-03 17:00:00-04:00,0,6,17,2,0,2488,22262,24750
2015-06-03 18:00:00-04:00,0,6,18,2,0,2160,19840,22000
2015-06-03 19:00:00-04:00,0,6,19,2,0,2029,20272,22301
2015-06-03 20:00:00-04:00,0,6,20,2,0,1961,20684,22645
2015-06-03 21:00:00-04:00,0,6,21,2,0,2015,20076,22091
2015-06-03 22:00:00-04:00,0,6,22,2,0,2316,20868,23184
2015-06-03 23:00:00-04:00,0,6,23,2,0,2530,19644,22174
2015-06-04 00:00:00-04:00,0,6,0,3,0,2701,15763,18464
2015-06-04 01:00:00-04:00,0,6,1,3,0,3139,19628,22767
2015-06-04 02:00:00-04:00,0,6,2,3,0,3637,24999,28636
2015-06-04 03:00:00-04:00,0,6,3,3,0,3599,27428,31027
2015-06-04 04:00:00-04:00,0,6,4,3,0,3285,27174,30459
2015-06-04 05:00:00-04:00,0,6,5,3,0,3235,27731,30966
2015-06-04 06:00:00-04:00,0,6,6,3,0,3011,25822,28833
2015-06-04 07:00:00-04:00,0,6,7,3,0,2688,22193,24881
2015-06-04 08:00:00-04:00,0,6,8,3,0,2088,15487,17575
2015-06-04 09:00:00-04:00,0,6,9,3,0,1440,8929,10369
2015-06-04 10:00:00-04:00,0,6,10,3,0,910,5577,6487
2015-06-04 11:00:00-04:00,0,6,11,3,0,596,3651,4247
2015-06-04 12:00:00-04:00,0,6,12,3,0,523,3130,3653
2015-06-04 13:00:00-04:00,0,6,13,3,0,527,4584,5111
2015-06-04 14:00:00-04:00,0,6,14,3,0,828,11881,12709
2015-06-04 15:00:00-04:00,0,6,15,3,0,1752,20929,22681
2015-06-04 16:00:00-04:00,0,6,16,3,0,2587,24230,26817
2015-06-04 17:00:00-04:00,0,6,17,3,0,2543,22563,25106
2015-06-04 18:00:00-04:00,0,6,18,3,0,2290,20681,22971
2015-06-04 19:00:00-04:00,0,6,19,3,0,2054,20542,22596
2015-06-04 20:00:00-04:00,0,6,20,3,0,2083,20995,23078
2015-06-04 21:00:00-04:00,0,6,21,3,0,1980,20486,22466
2015-06-04 22:00:00-04:00,0,6,22,3,0,2259,21431,23690
2015-06-04 23:00:00-04:00,0,6,23,3,0,2597,19526,22123
2015-06-05 00:00:00-04:00,0,6,0,4,0,2985,15950,18935
2015-06-05 01:00:00-04:00,0,6,1,4,0,3257,20417,23674
2015-06-05 02:00:00-04:00,0,6,2,4,0,3650,25954,29604
2015-06-05 03:00:00-04:00,0,6,3,4,0,3568,28056,31624
2015-06-05 04:00:00-04:00,0,6,4,4,0,3326,28166,31492
2015-06-05 05:00:00-04:00,0,6,5,4,0,3422,28708,32130
2015-06-05 06:00:00-04:00,0,6,6,4,0,3133,27498,30631
2015-06-05 07:00:00-04:00,0,6,7,4,0,2920,25172,28092
2015-06-05 08:00:00-04:00,0,6,8,4,0,2642,20647,23289
2015-06-05 09:00:00-04:00,0,6,9,4,0,1811,12696,14507
2015-06-05 10:00:00-04:00,0,6,10,4,0,1358,8490,9848
2015-06-05 11:00:00-04:00,0,6,11,4,0,909,5642,6551
2015-06-05 12:00:00-04:00,0,6,12,4,0,715,4397,5112
2015-06-05 13:00:00-04:00,0,6,13,4,0,535,4824,5359
2015-06-05 14:00:00-04:00,0,6,14,4,0,849,11404,12253
2015-06-05 15:00:00-04:00,0,6,15,4,0,1800,19782,21582
2015-06-05 16:00:00-04:00,0,6,16,4,0,2696,23429,26125
2015-06-05 17:00:00-04:00,0,6,17,4,0,2620,21910,24530
2015-06-05 18:00:00-04:00,0,6,18,4,0,2427,22829,25256
2015-06-05 19:00:00-04:00,0,6,19,4,0,2423,22577,25000
2015-06-05 20:00:00-04:00,0,6,20,4,0,2309,20824,23133
2015-06-05 21:00:00-04:00,0,6,21,4,0,2168,19638,21806
2015-06-05 22:00:00-04:00,0,6,22,4,0,2527,20103,22630
2015-06-05 23:00:00-04:00,0,6,23,4,0,2875,18320,21195
2015-06-06 00:00:00-04:00,0,6,0,5,0,3299,15934,19233
2015-06-06 01:00:00-04:00,0,6,1,5,0,3799,20679,24478
2015-06-06 02:00:00-04:00,0,6,2,5,0,4457,26187,30644
2015-06-06 03:00:00-04:00,0,6,3,5,0,4423,27529,31952
2015-06-06 04:00:00-04:00,0.08,6,4,5,0,3870,24715,28585
2015-06-06 05:00:00-04:00,0.47,6,5,5,0,4178,25083,29261
2015-06-06 06:00:00-04:00,0.07,6,6,5,0,4369,26497,30866
2015-06-06 07:00:00-04:00,0,6,7,5,0,4594,27049,31643
2015-06-06 08:00:00-04:00,0,6,8,5,0,4701,26158,30859
2015-06-06 09:00:00-04:00,0,6,9,5,0,3873,21125,24998
2015-06-06 10:00:00-04:00,0,6,10,5,0,3282,17630,20912
2015-06-06 11:00:00-04:00,0,6,11,5,0,2541,13101,15642
2015-06-06 12:00:00-04:00,0,6,12,5,0,1966,8419,10385
2015-06-06 13:00:00-04:00,0,6,13,5,0,1113,4442,5555
2015-06-06 14:00:00-04:00,0,6,14,5,0,818,5395,6213
2015-06-06 15:00:00-04:00,0,6,15,5,0,984,9069,10053
2015-06-06 16:00:00-04:00,0,6,16,5,0,1381,11367,12748
2015-06-06 17:00:00-04:00,0,6,17,5,0,1816,16461,18277
2015-06-06 18:00:00-04:00,0,6,18,5,0,2071,19282,21353
2015-06-06 19:00:00-04:00,0,6,19,5,0,2348,20877,23225
2015-06-06 20:00:00-04:00,0,6,20,5,0,2559,22393,24952
2015-06-06 21:00:00-04:00,0,6,21,5,0,2684,22608,25292
2015-06-06 22:00:00-04:00,0,6,22,5,0,3065,22249,25314
2015-06-06 23:00:00-04:00,0,6,23,5,0,3235,20578,23813
2015-06-07 00:00:00-04:00,0,6,0,6,0,3385,18756,22141
2015-06-07 01:00:00-04:00,0,6,1,6,0,3699,21278,24977
2015-06-07 02:00:00-04:00,0,6,2,6,0,3987,23699,27686
2015-06-07 03:00:00-04:00,0,6,3,6,0,4315,25624,29939
2015-06-07 04:00:00-04:00,0,6,4,6,0,4202,22101,26303
2015-06-07 05:00:00-04:00,0,6,5,6,0,4768,23271,28039
2015-06-07 06:00:00-04:00,0,6,6,6,0,5013,26402,31415
2015-06-07 07:00:00-04:00,0,6,7,6,0,5465,27519,32984
2015-06-07 08:00:00-04:00,0,6,8,6,0,5009,25344,30353
2015-06-07 09:00:00-04:00,0,6,9,6,0,4563,22681,27244
2015-06-07 10:00:00-04:00,0,6,10,6,0,4012,19947,23959
2015-06-07 11:00:00-04:00,0,6,11,6,0,3183,15507,18690
2015-06-07 12:00:00-04:00,0,6,12,6,0,2364,9675,12039
2015-06-07 13:00:00-04:00,0,6,13,6,0,1127,4294,5421
2015-06-07 14:00:00-04:00,0,6,14,6,0,687,4477,5164
2015-06-07 15:00:00-04:00,0,6,15,6,0,706,6297,7003
2015-06-07 16:00:00-04:00,0,6,16,6,0,879,8774,9653
2015-06-07 17:00:00-04:00,0,6,17,6,0,1332,12243,13575
2015-06-07 18:00:00-04:00,0,6,18,6,0,1733,16935,18668
2015-06-07 19:00:00-04:00,0,6,19,6,0,2148,19813,21961
2015-06-07 20:00:00-04:00,0,6,20,6,0,2238,21084,23322
2015-06-07 21:00:00-04:00,0,6,21,6,0,2359,21474,23833
2015-06-07 22:00:00-04:00,0,6,22,6,0,2722,21525,24247
2015-06-07 23:00:00-04:00,0,6,23,6,0,3003,20333,23336
2015-06-08 00:00:00-04:00,0,6,0,0,0,3052,18561,21613
2015-06-08 01:00:00-04:00,0,6,1,0,0,3133,19370,22503
2015-06-08 02:00:00-04:00,0,6,2,0,0,3367,20786,24153
2015-06-08 03:00:00-04:00,0,6,3,0,0,3619,20629,24248
2015-06-08 04:00:00-04:00,0,6,4,0,0,3440,19354,22794
2015-06-08 05:00:00-04:00,0,6,5,0,0,3349,18909,22258
2015-06-08 06:00:00-04:00,0,6,6,0,0,3089,17191,20280
2015-06-08 07:00:00-04:00,0,6,7,0,0,3072,16985,20057
2015-06-08 08:00:00-04:00,0,6,8,0,0,2150,10770,12920
2015-06-08 09:00:00-04:00,0,6,9,0,0,1386,6062,7448
2015-06-08 10:00:00-04:00,0,6,10,0,0,882,4191,5073
2015-06-08 11:00:00-04:00,0,6,11,0,0,709,2776,3485
2015-06-08 12:00:00-04:00,0,6,12,0,0,613,2990,3603
2015-06-08 13:00:00-04:00,0,6,13,0,0,583,4953,5536
2015-06-08 14:00:00-04:00,0,6,14,0,0,845,11834,12679
2015-06-08 15:00:00-04:00,0,6,15,0,0,1770,19017,20787
2015-06-08 16:00:00-04:00,0,6,16,0,0,2582,21069,23651
2015-06-08 17:00:00-04:00,0,6,17,0,0,2448,19924,22372
2015-06-08 18:00:00-04:00,0,6,18,0,0,2195,17958,20153
2015-06-08 19:00:00-04:00,0,6,19,0,0,1813,17725,19538
2015-06-08 20:00:00-04:00,0,6,20,0,0,1862,18474,20336
2015-06-08 21:00:00-04:00,0,6,21,0,0,1819,18360,20179
2015-06-08 22:00:00-04:00,0.01,6,22,0,0,2029,19968,21997
2015-06-08 23:00:00-04:00,0.01,6,23,0,0,2358,19392,21750
2015-06-09 00:00:00-04:00,0.02,6,0,1,0,2439,17321,19760
2015-06-09 01:00:00-04:00,0.01,6,1,1,0,2597,20723,23320
2015-06-09 02:00:00-04:00,0,6,2,1,0,2879,25335,28214
2015-06-09 03:00:00-04:00,0,6,3,1,0,2635,24677,27312
2015-06-09 04:00:00-04:00,0,6,4,1,0,2282,23063,25345
2015-06-09 05:00:00-04:00,0,6,5,1,0,2633,26256,28889
2015-06-09 06:00:00-04:00,0,6,6,1,0,2085,21090,23175
2015-06-09 07:00:00-04:00,0,6,7,1,0,2092,17159,19251
2015-06-09 08:00:00-04:00,0,6,8,1,0,1397,10378,11775
2015-06-09 09:00:00-04:00,0,6,9,1,0,828,5978,6806
2015-06-09 10:00:00-04:00,0,6,10,1,0,551,3540,4091
2015-06-09 11:00:00-04:00,0,6,11,1,0,383,2297,2680
2015-06-09 12:00:00-04:00,0,6,12,1,0,379,2310,2689
2015-06-09 13:00:00-04:00,0,6,13,1,0,400,4058,4458
2015-06-09 14:00:00-04:00,0,6,14,1,0,741,11355,12096
2015-06-09 15:00:00-04:00,0,6,15,1,0,1746,20810,22556
2015-06-09 16:00:00-04:00,0,6,16,1,0,2655,23720,26375
2015-06-09 17:00:00-04:00,0,6,17,1,0,2518,22197,24715
2015-06-09 18:00:00-04:00,0,6,18,1,0,2111,19859,21970
2015-06-09 19:00:00-04:00,0,6,19,1,0,2044,19952,21996
2015-06-09 20:00:00-04:00,0,6,20,1,0,1905,20180,22085
2015-06-09 21:00:00-04:00,0,6,21,1,0,1881,19941,21822
2015-06-09 22:00:00-04:00,0,6,22,1,0,2179,21200,23379
2015-06-09 23:00:00-04:00,0,6,23,1,0,2469,19659,22128
2015-06-10 00:00:00-04:00,0,6,0,2,0,2606,16315,18921
2015-06-10 01:00:00-04:00,0,6,1,2,0,2840,19875,22715
2015-06-10 02:00:00-04:00,0,6,2,2,0,2975,24611,27586
2015-06-10 03:00:00-04:00,0,6,3,2,0,2913,25801,28714
2015-06-10 04:00:00-04:00,0,6,4,2,0,2644,25280,27924
2015-06-10 05:00:00-04:00,0,6,5,2,0,2670,26306,28976
2015-06-10 06:00:00-04:00,0,6,6,2,0,2423,24500,26923
2015-06-10 07:00:00-04:00,0,6,7,2,0,2118,19066,21184
2015-06-10 08:00:00-04:00,0,6,8,2,0,1800,13850,15650
2015-06-10 09:00:00-04:00,0,6,9,2,0,1147,7610,8757
2015-06-10 10:00:00-04:00,0,6,10,2,0,753,4776,5529
2015-06-10 11:00:00-04:00,0,6,11,2,0,466,3114,3580
2015-06-10 12:00:00-04:00,0,6,12,2,0,486,2898,3384
2015-06-10 13:00:00-04:00,0,6,13,2,0,436,4434,4870
2015-06-10 14:00:00-04:00,0,6,14,2,0,767,11858,12625
2015-06-10 15:00:00-04:00,0,6,15,2,0,1775,19911,21686
2015-06-10 16:00:00-04:00,0,6,16,2,0,2575,22875,25450
2015-06-10 17:00:00-04:00,0,6,17,2,0,2499,21458,23957
2015-06-10 18:00:00-04:00,0,6,18,2,0,2157,19986,22143
2015-06-10 19:00:00-04:00,0,6,19,2,0,1921,20311,22232
2015-06-10 20:00:00-04:00,0,6,20,2,0,1948,20612,22560
2015-06-10 21:00:00-04:00,0,6,21,2,0,1952,20176,22128
2015-06-10 22:00:00-04:00,0,6,22,2,0,2197,20900,23097
2015-06-10 23:00:00-04:00,0,6,23,2,0,2457,18960,21417
2015-06-11 00:00:00-04:00,0,6,0,3,0,2608,15959,18567
2015-06-11 01:00:00-04:00,0,6,1,3,0,2924,20188,23112
2015-06-11 02:00:00-04:00,0,6,2,3,0,3356,25308,28664
2015-06-11 03:00:00-04:00,0,6,3,3,0,3232,27439,30671
2015-06-11 04:00:00-04:00,0,6,4,3,0,2805,26151,28956
2015-06-11 05:00:00-04:00,0,6,5,3,0,2947,27854,30801
2015-06-11 06:00:00-04:00,0,6,6,3,0,2637,26108,28745
2015-06-11 07:00:00-04:00,0,6,7,3,0,2451,21620,24071
2015-06-11 08:00:00-04:00,0,6,8,3,0,1991,14625,16616
2015-06-11 09:00:00-04:00,0,6,9,3,0,1334,8653,9987
2015-06-11 10:00:00-04:00,0,6,10,3,0,851,5285,6136
2015-06-11 11:00:00-04:00,0,6,11,3,0,624,3505,4129
2015-06-11 12:00:00-04:00,0,6,12,3,0,512,3171,3683
2015-06-11 13:00:00-04:00,0,6,13,3,0,457,4620,5077
2015-06-11 14:00:00-04:00,0,6,14,3,0,815,11592,12407
2015-06-11 15:00:00-04:00,0,6,15,3,0,1743,19874,21617
2015-06-11 16:00:00-04:00,0,6,16,3,0,2598,23019,25617
2015-06-11 17:00:00-04:00,0,6,17,3,0,2557,22404,24961
2015-06-11 18:00:00-04:00,0,6,18,3,0,2132,20586,22718
2015-06-11 19:00:00-04:00,0,6,19,3,0,2059,20869,22928
2015-06-11 20:00:00-04:00,0,6,20,3,0,2105,21267,23372
2015-06-11 21:00:00-04:00,0,6,21,3,0,2092,21576,23668
2015-06-11 22:00:00-04:00,0,6,22,3,0,2498,22060,24558
2015-06-11 23:00:00-04:00,0,6,23,3,0,2744,19565,22309
2015-06-12 00:00:00-04:00,0,6,0,4,0,3004,15668,18672
2015-06-12 01:00:00-04:00,0,6,1,4,0,3382,19690,23072
2015-06-12 02:00:00-04:00,0,6,2,4,0,3778,25774,29552
2015-06-12 03:00:00-04:00,0,6,3,4,0,3774,28394,32168
2015-06-12 04:00:00-04:00,0,6,4,4,0,3350,28255,31605
2015-06-12 05:00:00-04:00,0,6,5,4,0,3440,28070,31510
2015-06-12 06:00:00-04:00,0,6,6,4,0,3329,26944,30273
2015-06-12 07:00:00-04:00,0,6,7,4,0,3071,24403,27474
2015-06-12 08:00:00-04:00,0,6,8,4,0,2606,20139,22745
2015-06-12 09:00:00-04:00,0,6,9,4,0,1861,12619,14480
2015-06-12 10:00:00-04:00,0,6,10,4,0,1228,8229,9457
2015-06-12 11:00:00-04:00,0,6,11,4,0,796,5427,6223
2015-06-12 12:00:00-04:00,0,6,12,4,0,605,4367,4972
2015-06-12 13:00:00-04:00,0,6,13,4,0,514,4982,5496
2015-06-12 14:00:00-04:00,0,6,14,4,0,848,11408,12256
2015-06-12 15:00:00-04:00,0,6,15,4,0,1780,18911,20691
2015-06-12 16:00:00-04:00,0,6,16,4,0,2752,22829,25581
2015-06-12 17:00:00-04:00,0,6,17,4,0,2639,21254,23893
2015-06-12 18:00:00-04:00,0,6,18,4,0,2242,19576,21818
2015-06-12 19:00:00-04:00,0,6,19,4,0,2134,19784,21918
2015-06-12 20:00:00-04:00,0,6,20,4,0,2036,20136,22172
2015-06-12 21:00:00-04:00,0,6,21,4,0,1984,19916,21900
2015-06-12 22:00:00-04:00,0,6,22,4,0,2515,20766,23281
2015-06-12 23:00:00-04:00,0,6,23,4,0,2945,18636,21581
2015-06-13 00:00:00-04:00,0,6,0,5,0,3251,15776,19027
2015-06-13 01:00:00-04:00,0,6,1,5,0,3760,20323,24083
2015-06-13 02:00:00-04:00,0,6,2,5,0,4383,26259,30642
2015-06-13 03:00:00-04:00,0,6,3,5,0,4405,27837,32242
2015-06-13 04:00:00-04:00,0,6,4,5,0,3966,25605,29571
2015-06-13 05:00:00-04:00,0,6,5,5,0,4269,25553,29822
2015-06-13 06:00:00-04:00,0,6,6,5,0,4454,26786,31240
2015-06-13 07:00:00-04:00,0,6,7,5,0,4650,25908,30558
2015-06-13 08:00:00-04:00,0,6,8,5,0,4385,24948,29333
2015-06-13 09:00:00-04:00,0,6,9,5,0,3794,21408,25202
2015-06-13 10:00:00-04:00,0,6,10,5,0,3135,17767,20902
2015-06-13 11:00:00-04:00,0,6,11,5,0,2552,12792,15344
2015-06-13 12:00:00-04:00,0,6,12,5,0,1749,8002,9751
2015-06-13 13:00:00-04:00,0,6,13,5,0,999,4177,5176
2015-06-13 14:00:00-04:00,0,6,14,5,0,746,5218,5964
2015-06-13 15:00:00-04:00,0,6,15,5,0,938,7862,8800
2015-06-13 16:00:00-04:00,0,6,16,5,0,1235,11143,12378
2015-06-13 17:00:00-04:00,0,6,17,5,0,1734,14701,16435
2015-06-13 18:00:00-04:00,0,6,18,5,0,1996,17731,19727
2015-06-13 19:00:00-04:00,0,6,19,5,0,2179,19217,21396
2015-06-13 20:00:00-04:00,0,6,20,5,0,2397,20428,22825
2015-06-13 21:00:00-04:00,0,6,21,5,0,2482,21151,23633
2015-06-13 22:00:00-04:00,0,6,22,5,0,2784,20751,23535
2015-06-13 23:00:00-04:00,0,6,23,5,0,3148,20229,23377
2015-06-14 00:00:00-04:00,0,6,0,6,0,3311,18641,21952
2015-06-14 01:00:00-04:00,0,6,1,6,0,3653,21264,24917
2015-06-14 02:00:00-04:00,0,6,2,6,0,3970,23785,27755
2015-06-14 03:00:00-04:00,0,6,3,6,0,4198,24576,28774
2015-06-14 04:00:00-04:00,0,6,4,6,0,4118,20794,24912
2015-06-14 05:00:00-04:00,0,6,5,6,0,4413,21941,26354
2015-06-14 06:00:00-04:00,0,6,6,6,0,4729,24115,28844
2015-06-14 07:00:00-04:00,0,6,7,6,0,5095,25363,30458
2015-06-14 08:00:00-04:00,0,6,8,6,0,4963,24615,29578
2015-06-14 09:00:00-04:00,0,6,9,6,0,4467,22117,26584
2015-06-14 10:00:00-04:00,0,6,10,6,0,3822,18992,22814
2015-06-14 11:00:00-04:00,0,6,11,6,0,3041,14476,17517
2015-06-14 12:00:00-04:00,0,6,12,6,0,2275,9294,11569
2015-06-14 13:00:00-04:00,0,6,13,6,0,1079,4332,5411
2015-06-14 14:00:00-04:00,0,6,14,6,0,600,4191,4791
2015-06-14 15:00:00-04:00,0,6,15,6,0,714,5583,6297
2015-06-14 16:00:00-04:00,0,6,16,6,0,908,7890,8798
2015-06-14 17:00:00-04:00,0,6,17,6,0,1211,11303,12514
2015-06-14 18:00:00-04:00,0,6,18,6,0,1639,15440,17079
2015-06-14 19:00:00-04:00,0,6,19,6,0,2043,17300,19343
2015-06-14 20:00:00-04:00,0,6,20,6,0,2185,18381,20566
2015-06-14 21:00:00-04:00,0,6,21,6,0,2395,18824,21219
2015-06-14 22:00:00-04:00,0.09,6,22,6,0,2699,19229,21928
2015-06-14 23:00:00-04:00,0.13,6,23,6,0,2990,18258,21248
2015-06-15 00:00:00-04:00,0.02,6,0,0,0,3006,17303,20309
2015-06-15 01:00:00-04:00,0.12,6,1,0,0,3065,18872,21937
2015-06-15 02:00:00-04:00,0.02,6,2,0,0,3160,19862,23022
2015-06-15 03:00:00-04:00,0.06,6,3,0,0,3180,19301,22481
2015-06-15 04:00:00-04:00,0.32,6,4,0,0,3014,18238,21252
2015-06-15 05:00:00-04:00,0.03,6,5,0,0,3561,20486,24047
2015-06-15 06:00:00-04:00,0,6,6,0,0,3899,20931,24830
2015-06-15 07:00:00-04:00,0,6,7,0,0,3573,16819,20392
2015-06-15 08:00:00-04:00,0,6,8,0,0,2363,9607,11970
2015-06-15 09:00:00-04:00,0,6,9,0,0,1301,5902,7203
2015-06-15 10:00:00-04:00,0,6,10,0,0,818,3571,4389
2015-06-15 11:00:00-04:00,0,6,11,0,0,593,2154,2747
2015-06-15 12:00:00-04:00,0,6,12,0,0,614,2580,3194
2015-06-15 13:00:00-04:00,0,6,13,0,0,577,4445,5022
2015-06-15 14:00:00-04:00,0,6,14,0,0,819,10997,11816
2015-06-15 15:00:00-04:00,0,6,15,0,0,1697,17645,19342
2015-06-15 16:00:00-04:00,0.01,6,16,0,0,2606,20930,23536
2015-06-15 17:00:00-04:00,0,6,17,0,0,2407,19756,22163
2015-06-15 18:00:00-04:00,0.01,6,18,0,0,2191,17973,20164
2015-06-15 19:00:00-04:00,0,6,19,0,0,2037,17733,19770
2015-06-15 20:00:00-04:00,0,6,20,0,0,1867,18634,20501
2015-06-15 21:00:00-04:00,0,6,21,0,0,1873,19030,20903
2015-06-15 22:00:00-04:00,0,6,22,0,0,2305,22320,24625
2015-06-15 23:00:00-04:00,0,6,23,0,0,2605,18723,21328
2015-06-16 00:00:00-04:00,0,6,0,1,0,2995,16608,19603
2015-06-16 01:00:00-04:00,0,6,1,1,0,2925,19643,22568
2015-06-16 02:00:00-04:00,0,6,2,1,0,3004,23674,26678
2015-06-16 03:00:00-04:00,0,6,3,1,0,2927,24042,26969
2015-06-16 04:00:00-04:00,0,6,4,1,0,2377,22623,25000
2015-06-16 05:00:00-04:00,0,6,5,1,0,2249,22335,24584
2015-06-16 06:00:00-04:00,0,6,6,1,0,2035,19342,21377
2015-06-16 07:00:00-04:00,0,6,7,1,0,1622,14591,16213
2015-06-16 08:00:00-04:00,0,6,8,1,0,1255,9932,11187
2015-06-16 09:00:00-04:00,0,6,9,1,0,951,6259,7210
2015-06-16 10:00:00-04:00,0,6,10,1,0,577,3767,4344
2015-06-16 11:00:00-04:00,0,6,11,1,0,398,2265,2663
2015-06-16 12:00:00-04:00,0,6,12,1,0,411,2286,2697
2015-06-16 13:00:00-04:00,0,6,13,1,0,415,4161,4576
2015-06-16 14:00:00-04:00,0.02,6,14,1,0,749,11170,11919
2015-06-16 15:00:00-04:00,0,6,15,1,0,1662,18497,20159
2015-06-16 16:00:00-04:00,0,6,16,1,0,2595,22967,25562
2015-06-16 17:00:00-04:00,0.32,6,17,1,0,2389,21440,23829
2015-06-16 18:00:00-04:00,0,6,18,1,0,2058,18941,20999
2015-06-16 19:00:00-04:00,0,6,19,1,0,1848,18960,20808
2015-06-16 20:00:00-04:00,0,6,20,1,0,1899,19779,21678
2015-06-16 21:00:00-04:00,0,6,21,1,0,2064,20911,22975
2015-06-16 22:00:00-04:00,0,6,22,1,0,2410,20854,23264
2015-06-16 23:00:00-04:00,0,6,23,1,0,2287,18612,20899
2015-06-17 00:00:00-04:00,0,6,0,2,0,2441,16119,18560
2015-06-17 01:00:00-04:00,0,6,1,2,0,3688,21921,25609
2015-06-17 02:00:00-04:00,0,6,2,2,0,3180,23615,26795
2015-06-17 03:00:00-04:00,0,6,3,2,0,2900,24900,27800
2015-06-17 04:00:00-04:00,0,6,4,2,0,2646,24800,27446
2015-06-17 05:00:00-04:00,0,6,5,2,0,2557,25898,28455
2015-06-17 06:00:00-04:00,0,6,6,2,0,2293,23920,26213
2015-06-17 07:00:00-04:00,0,6,7,2,0,2031,18544,20575
2015-06-17 08:00:00-04:00,0,6,8,2,0,1913,16243,18156
2015-06-17 09:00:00-04:00,0,6,9,2,0,1220,8200,9420
2015-06-17 10:00:00-04:00,0,6,10,2,0,766,4864,5630
2015-06-17 11:00:00-04:00,0,6,11,2,0,518,3146,3664
2015-06-17 12:00:00-04:00,0,6,12,2,0,447,2839,3286
2015-06-17 13:00:00-04:00,0,6,13,2,0,437,4317,4754
2015-06-17 14:00:00-04:00,0,6,14,2,0,816,11302,12118
2015-06-17 15:00:00-04:00,0,6,15,2,0,1568,19458,21026
2015-06-17 16:00:00-04:00,0,6,16,2,0,2575,23617,26192
2015-06-17 17:00:00-04:00,0,6,17,2,0,2458,21421,23879
2015-06-17 18:00:00-04:00,0,6,18,2,0,2109,19488,21597
2015-06-17 19:00:00-04:00,0,6,19,2,0,2019,20240,22259
2015-06-17 20:00:00-04:00,0,6,20,2,0,1949,20861,22810
2015-06-17 21:00:00-04:00,0,6,21,2,0,2024,20512,22536
2015-06-17 22:00:00-04:00,0,6,22,2,0,2210,20316,22526
2015-06-17 23:00:00-04:00,0,6,23,2,0,2388,18448,20836
2015-06-18 00:00:00-04:00,0,6,0,3,0,2629,15712,18341
2015-06-18 01:00:00-04:00,0,6,1,3,0,3166,19807,22973
2015-06-18 02:00:00-04:00,0,6,2,3,0,3587,25120,28707
2015-06-18 03:00:00-04:00,0,6,3,3,0,3670,28121,31791
2015-06-18 04:00:00-04:00,0,6,4,3,0,3007,26758,29765
2015-06-18 05:00:00-04:00,0,6,5,3,0,2766,27535,30301
2015-06-18 06:00:00-04:00,0,6,6,3,0,2549,26038,28587
2015-06-18 07:00:00-04:00,0,6,7,3,0,2291,21380,23671
2015-06-18 08:00:00-04:00,0,6,8,3,0,1874,14611,16485
2015-06-18 09:00:00-04:00,0,6,9,3,0,1394,8721,10115
2015-06-18 10:00:00-04:00,0,6,10,3,0,835,5180,6015
2015-06-18 11:00:00-04:00,0,6,11,3,0,513,3590,4103
2015-06-18 12:00:00-04:00,0,6,12,3,0,481,3088,3569
2015-06-18 13:00:00-04:00,0,6,13,3,0,516,4606,5122
2015-06-18 14:00:00-04:00,0,6,14,3,0,826,11377,12203
2015-06-18 15:00:00-04:00,0,6,15,3,0,1713,19645,21358
2015-06-18 16:00:00-04:00,0,6,16,3,0,2720,23711,26431
2015-06-18 17:00:00-04:00,0,6,17,3,0,2624,22914,25538
2015-06-18 18:00:00-04:00,0,6,18,3,0,2292,20510,22802
2015-06-18 19:00:00-04:00,0,6,19,3,0,2155,19940,22095
2015-06-18 20:00:00-04:00,0,6,20,3,0,2032,20393,22425
2015-06-18 21:00:00-04:00,0,6,21,3,0,1987,20241,22228
2015-06-18 22:00:00-04:00,0,6,22,3,0,2453,21171,23624
2015-06-18 23:00:00-04:00,0,6,23,3,0,2728,19407,22135
2015-06-19 00:00:00-04:00,0,6,0,4,0,2947,15982,18929
2015-06-19 01:00:00-04:00,0,6,1,4,0,3271,19943,23214
2015-06-19 02:00:00-04:00,0,6,2,4,0,3617,25697,29314
2015-06-19 03:00:00-04:00,0,6,3,4,0,3168,27412,30580
2015-06-19 04:00:00-04:00,0,6,4,4,0,2418,24348,26766
2015-06-19 05:00:00-04:00,0,6,5,4,0,2510,26803,29313
2015-06-19 06:00:00-04:00,0,6,6,4,0,2615,26240,28855
2015-06-19 07:00:00-04:00,0,6,7,4,0,2502,23856,26358
2015-06-19 08:00:00-04:00,0,6,8,4,0,2288,19066,21354
2015-06-19 09:00:00-04:00,0,6,9,4,0,1731,12781,14512
2015-06-19 10:00:00-04:00,0,6,10,4,0,1124,7795,8919
2015-06-19 11:00:00-04:00,0,6,11,4,0,702,5162,5864
2015-06-19 12:00:00-04:00,0,6,12,4,0,609,4241,4850
2015-06-19 13:00:00-04:00,0,6,13,4,0,591,4875,5466
2015-06-19 14:00:00-04:00,0,6,14,4,0,831,10843,11674
2015-06-19 15:00:00-04:00,0,6,15,4,0,1651,17524,19175
2015-06-19 16:00:00-04:00,0,6,16,4,0,2635,22185,24820
2015-06-19 17:00:00-04:00,0,6,17,4,0,2611,21387,23998
2015-06-19 18:00:00-04:00,0,6,18,4,0,2270,19438,21708
2015-06-19 19:00:00-04:00,0,6,19,4,0,2244,19569,21813
2015-06-19 20:00:00-04:00,0,6,20,4,0,2161,20232,22393
2015-06-19 21:00:00-04:00,0,6,21,4,0,1940,19786,21726
2015-06-19 22:00:00-04:00,0,6,22,4,0,2631,20912,23543
2015-06-19 23:00:00-04:00,0,6,23,4,0,3120,19063,22183
2015-06-20 00:00:00-04:00,0,6,0,5,0,3447,16028,19475
2015-06-20 01:00:00-04:00,0,6,1,5,0,3879,20319,24198
2015-06-20 02:00:00-04:00,0,6,2,5,0,4143,25716,29859
2015-06-20 03:00:00-04:00,0,6,3,5,0,4135,27151,31286
2015-06-20 04:00:00-04:00,0,6,4,5,0,3232,24057,27289
2015-06-20 05:00:00-04:00,0,6,5,5,0,3515,25346,28861
2015-06-20 06:00:00-04:00,0,6,6,5,0,3877,26623,30500
2015-06-20 07:00:00-04:00,0,6,7,5,0,4338,26204,30542
2015-06-20 08:00:00-04:00,0,6,8,5,0,4336,24802,29138
2015-06-20 09:00:00-04:00,0,6,9,5,0,3961,22007,25968
2015-06-20 10:00:00-04:00,0,6,10,5,0,3023,17132,20155
2015-06-20 11:00:00-04:00,0,6,11,5,0,1973,12824,14797
2015-06-20 12:00:00-04:00,0,6,12,5,0,1793,8558,10351
2015-06-20 13:00:00-04:00,0,6,13,5,0,988,4376,5364
2015-06-20 14:00:00-04:00,0,6,14,5,0,746,5008,5754
2015-06-20 15:00:00-04:00,0,6,15,5,0,876,6872,7748
2015-06-20 16:00:00-04:00,0,6,16,5,0,1284,10005,11289
2015-06-20 17:00:00-04:00,0,6,17,5,0,1761,14176,15937
2015-06-20 18:00:00-04:00,0,6,18,5,0,2088,17247,19335
2015-06-20 19:00:00-04:00,0,6,19,5,0,2343,19690,22033
2015-06-20 20:00:00-04:00,0,6,20,5,0,2597,21738,24335
2015-06-20 21:00:00-04:00,0,6,21,5,0,2646,20323,22969
2015-06-20 22:00:00-04:00,0,6,22,5,0,3010,19643,22653
2015-06-20 23:00:00-04:00,0,6,23,5,0,3409,19762,23171
2015-06-21 00:00:00-04:00,0,6,0,6,0,3922,18070,21992
2015-06-21 01:00:00-04:00,0.01,6,1,6,0,3870,20238,24108
2015-06-21 02:00:00-04:00,0.07,6,2,6,0,4054,22594,26648
2015-06-21 03:00:00-04:00,0.03,6,3,6,0,3889,23371,27260
2015-06-21 04:00:00-04:00,0.03,6,4,6,0,2992,18793,21785
2015-06-21 05:00:00-04:00,0.03,6,5,6,0,3516,20205,23721
2015-06-21 06:00:00-04:00,0.03,6,6,6,0,3818,22269,26087
2015-06-21 07:00:00-04:00,0,6,7,6,0,4214,24163,28377
2015-06-21 08:00:00-04:00,0,6,8,6,0,4388,22700,27088
2015-06-21 09:00:00-04:00,0,6,9,6,0,4172,21391,25563
2015-06-21 10:00:00-04:00,0,6,10,6,0,3372,16446,19818
2015-06-21 11:00:00-04:00,0,6,11,6,0,2150,11734,13884
2015-06-21 12:00:00-04:00,0,6,12,6,0,1915,7999,9914
2015-06-21 13:00:00-04:00,0,6,13,6,0,1075,3764,4839
2015-06-21 14:00:00-04:00,0,6,14,6,0,728,3816,4544
2015-06-21 15:00:00-04:00,0,6,15,6,0,796,5039,5835
2015-06-21 16:00:00-04:00,0,6,16,6,0,958,7456,8414
2015-06-21 17:00:00-04:00,0,6,17,6,0,1311,11184,12495
2015-06-21 18:00:00-04:00,0,6,18,6,0,1811,15025,16836
2015-06-21 19:00:00-04:00,0,6,19,6,0,2124,17656,19780
2015-06-21 20:00:00-04:00,0,6,20,6,0,2391,18925,21316
2015-06-21 21:00:00-04:00,0,6,21,6,0,2527,19390,21917
2015-06-21 22:00:00-04:00,0.29,6,22,6,0,3006,19801,22807
2015-06-21 23:00:00-04:00,0,6,23,6,0,3264,18546,21810
2015-06-22 00:00:00-04:00,0,6,0,0,0,3446,18205,21651
2015-06-22 01:00:00-04:00,0,6,1,0,0,3482,19844,23326
2015-06-22 02:00:00-04:00,0,6,2,0,0,4022,22052,26074
2015-06-22 03:00:00-04:00,0,6,3,0,0,3006,18406,21412
2015-06-22 04:00:00-04:00,0,6,4,0,0,2354,16299,18653
2015-06-22 05:00:00-04:00,0,6,5,0,0,2675,18270,20945
2015-06-22 06:00:00-04:00,0,6,6,0,0,2778,18013,20791
2015-06-22 07:00:00-04:00,0,6,7,0,0,2588,14197,16785
2015-06-22 08:00:00-04:00,0,6,8,0,0,2034,8680,10714
2015-06-22 09:00:00-04:00,0,6,9,0,0,1336,5941,7277
2015-06-22 10:00:00-04:00,0,6,10,0,0,788,3400,4188
2015-06-22 11:00:00-04:00,0,6,11,0,0,529,2462,2991
2015-06-22 12:00:00-04:00,0,6,12,0,0,629,2563,3192
2015-06-22 13:00:00-04:00,0,6,13,0,0,545,4362,4907
2015-06-22 14:00:00-04:00,0,6,14,0,0,824,10904,11728
2015-06-22 15:00:00-04:00,0,6,15,0,0,1641,16888,18529
2015-06-22 16:00:00-04:00,0,6,16,0,0,2521,20741,23262
2015-06-22 17:00:00-04:00,0,6,17,0,0,2335,19522,21857
2015-06-22 18:00:00-04:00,0,6,18,0,0,1974,17324,19298
2015-06-22 19:00:00-04:00,0,6,19,0,0,1898,17838,19736
2015-06-22 20:00:00-04:00,0,6,20,0,0,1839,18461,20300
2015-06-22 21:00:00-04:00,0,6,21,0,0,1825,18705,20530
2015-06-22 22:00:00-04:00,0,6,22,0,0,2228,19703,21931
2015-06-22 23:00:00-04:00,0,6,23,0,0,2419,18820,21239
2015-06-23 00:00:00-04:00,0,6,0,1,0,2449,17438,19887
2015-06-23 01:00:00-04:00,0,6,1,1,0,2782,20172,22954
2015-06-23 02:00:00-04:00,0,6,2,1,0,3039,24582,27621
2015-06-23 03:00:00-04:00,0,6,3,1,0,2689,24270,26959
2015-06-23 04:00:00-04:00,0,6,4,1,0,1931,21328,23259
2015-06-23 05:00:00-04:00,0,6,5,1,0,2010,22920,24930
2015-06-23 06:00:00-04:00,0,6,6,1,0,2036,21659,23695
2015-06-23 07:00:00-04:00,0,6,7,1,0,1823,16166,17989
2015-06-23 08:00:00-04:00,0,6,8,1,0,1608,10199,11807
2015-06-23 09:00:00-04:00,0,6,9,1,0,1095,6207,7302
2015-06-23 10:00:00-04:00,0,6,10,1,0,609,3619,4228
2015-06-23 11:00:00-04:00,0,6,11,1,0,422,2476,2898
2015-06-23 12:00:00-04:00,0,6,12,1,0,453,2365,2818
2015-06-23 13:00:00-04:00,0,6,13,1,0,480,4107,4587
2015-06-23 14:00:00-04:00,0,6,14,1,0,743,11054,11797
2015-06-23 15:00:00-04:00,0,6,15,1,0,1573,17974,19547
2015-06-23 16:00:00-04:00,0,6,16,1,0,2575,22652,25227
2015-06-23 17:00:00-04:00,0,6,17,1,0,2523,22300,24823
2015-06-23 18:00:00-04:00,0.07,6,18,1,0,2154,20644,22798
2015-06-23 19:00:00-04:00,0,6,19,1,0,2241,20456,22697
2015-06-23 20:00:00-04:00,0,6,20,1,0,2239,21169,23408
2015-06-23 21:00:00-04:00,0,6,21,1,0,2150,20866,23016
2015-06-23 22:00:00-04:00,0,6,22,1,0,2379,21606,23985
2015-06-23 23:00:00-04:00,0,6,23,1,0,2665,19348,22013
2015-06-24 00:00:00-04:00,0,6,0,2,0,2703,16708,19411
2015-06-24 01:00:00-04:00,0,6,1,2,0,3227,20978,24205
2015-06-24 02:00:00-04:00,0,6,2,2,0,4323,26397,30720
2015-06-24 03:00:00-04:00,0,6,3,2,0,3457,25891,29348
2015-06-24 04:00:00-04:00,0,6,4,2,0,2130,22164,24294
2015-06-24 05:00:00-04:00,0,6,5,2,0,2071,25069,27140
2015-06-24 06:00:00-04:00,0,6,6,2,0,2024,23438,25462
2015-06-24 07:00:00-04:00,0,6,7,2,0,1903,18452,20355
2015-06-24 08:00:00-04:00,0,6,8,2,0,1720,12289,14009
2015-06-24 09:00:00-04:00,0,6,9,2,0,1197,7770,8967
2015-06-24 10:00:00-04:00,0,6,10,2,0,713,4393,5106
2015-06-24 11:00:00-04:00,0,6,11,2,0,518,3201,3719
2015-06-24 12:00:00-04:00,0,6,12,2,0,578,2928,3506
2015-06-24 13:00:00-04:00,0,6,13,2,0,488,4326,4814
2015-06-24 14:00:00-04:00,0,6,14,2,0,713,11120,11833
2015-06-24 15:00:00-04:00,0,6,15,2,0,1541,18396,19937
2015-06-24 16:00:00-04:00,0,6,16,2,0,2534,22921,25455
2015-06-24 17:00:00-04:00,0,6,17,2,0,2436,21330,23766
2015-06-24 18:00:00-04:00,0,6,18,2,0,2111,19113,21224
2015-06-24 19:00:00-04:00,0,6,19,2,0,1994,19788,21782
2015-06-24 20:00:00-04:00,0,6,20,2,0,2178,20314,22492
2015-06-24 21:00:00-04:00,0,6,21,2,0,2171,20242,22413
2015-06-24 22:00:00-04:00,0,6,22,2,0,2386,20576,22962
2015-06-24 23:00:00-04:00,0,6,23,2,0,2644,18935,21579
2015-06-25 00:00:00-04:00,0,6,0,3,0,2804,16283,19087
2015-06-25 01:00:00-04:00,0,6,1,3,0,2951,19530,22481
2015-06-25 02:00:00-04:00,0,6,2,3,0,3346,24200,27546
2015-06-25 03:00:00-04:00,0,6,3,3,0,3281,25772,29053
2015-06-25 04:00:00-04:00,0,6,4,3,0,2385,23589,25974
2015-06-25 05:00:00-04:00,0,6,5,3,0,2526,26838,29364
2015-06-25 06:00:00-04:00,0,6,6,3,0,2506,25978,28484
2015-06-25 07:00:00-04:00,0,6,7,3,0,2513,21538,24051
2015-06-25 08:00:00-04:00,0,6,8,3,0,2116,15545,17661
2015-06-25 09:00:00-04:00,0,6,9,3,0,1538,9356,10894
2015-06-25 10:00:00-04:00,0,6,10,3,0,949,5985,6934
2015-06-25 11:00:00-04:00,0,6,11,3,0,568,3887,4455
2015-06-25 12:00:00-04:00,0,6,12,3,0,573,3444,4017
2015-06-25 13:00:00-04:00,0,6,13,3,0,495,4507,5002
2015-06-25 14:00:00-04:00,0,6,14,3,0,741,11132,11873
2015-06-25 15:00:00-04:00,0,6,15,3,0,1565,18341,19906
2015-06-25 16:00:00-04:00,0,6,16,3,0,2507,22581,25088
2015-06-25 17:00:00-04:00,0,6,17,3,0,2547,21305,23852
2015-06-25 18:00:00-04:00,0,6,18,3,0,2143,19170,21313
2015-06-25 19:00:00-04:00,0,6,19,3,0,2115,19811,21926
2015-06-25 20:00:00-04:00,0,6,20,3,0,2137,20404,22541
2015-06-25 21:00:00-04:00,0,6,21,3,0,2147,20328,22475
2015-06-25 22:00:00-04:00,0,6,22,3,0,2532,20567,23099
2015-06-25 23:00:00-04:00,0,6,23,3,0,2773,18744,21517
2015-06-26 00:00:00-04:00,0,6,0,4,0,2914,15351,18265
2015-06-26 01:00:00-04:00,0,6,1,4,0,3252,19095,22347
2015-06-26 02:00:00-04:00,0,6,2,4,0,3651,23953,27604
2015-06-26 03:00:00-04:00,0,6,3,4,0,3418,25853,29271
2015-06-26 04:00:00-04:00,0,6,4,4,0,2672,23888,26560
2015-06-26 05:00:00-04:00,0,6,5,4,0,2896,27182,30078
2015-06-26 06:00:00-04:00,0,6,6,4,0,2817,25610,28427
2015-06-26 07:00:00-04:00,0,6,7,4,0,2796,23700,26496
2015-06-26 08:00:00-04:00,0,6,8,4,0,2508,19348,21856
2015-06-26 09:00:00-04:00,0,6,9,4,0,1948,13110,15058
2015-06-26 10:00:00-04:00,0,6,10,4,0,1254,8468,9722
2015-06-26 11:00:00-04:00,0,6,11,4,0,720,5701,6421
2015-06-26 12:00:00-04:00,0,6,12,4,0,652,4597,5249
2015-06-26 13:00:00-04:00,0,6,13,4,0,537,4907,5444
2015-06-26 14:00:00-04:00,0,6,14,4,0,806,10606,11412
2015-06-26 15:00:00-04:00,0,6,15,4,0,1577,16901,18478
2015-06-26 16:00:00-04:00,0,6,16,4,0,2370,21533,23903
2015-06-26 17:00:00-04:00,0,6,17,4,0,2460,20472,22932
2015-06-26 18:00:00-04:00,0,6,18,4,0,2144,18433,20577
2015-06-26 19:00:00-04:00,0,6,19,4,0,2241,19507,21748
2015-06-26 20:00:00-04:00,0,6,20,4,0,2074,20017,22091
2015-06-26 21:00:00-04:00,0,6,21,4,0,1911,18981,20892
2015-06-26 22:00:00-04:00,0,6,22,4,0,2392,19761,22153
2015-06-26 23:00:00-04:00,0,6,23,4,0,2890,17928,20818
2015-06-27 00:00:00-04:00,0,6,0,5,0,3263,14716,17979
2015-06-27 01:00:00-04:00,0,6,1,5,0,3521,18618,22139
2015-06-27 02:00:00-04:00,0,6,2,5,0,4025,24122,28147
2015-06-27 03:00:00-04:00,0,6,3,5,0,4124,26425,30549
2015-06-27 04:00:00-04:00,0,6,4,5,0,3132,23333,26465
2015-06-27 05:00:00-04:00,0,6,5,5,0,3478,25516,28994
2015-06-27 06:00:00-04:00,0,6,6,5,0,4024,26659,30683
2015-06-27 07:00:00-04:00,0,6,7,5,0,4320,26115,30435
2015-06-27 08:00:00-04:00,0,6,8,5,0,4511,24928,29439
2015-06-27 09:00:00-04:00,0,6,9,5,0,4054,22442,26496
2015-06-27 10:00:00-04:00,0,6,10,5,0,3181,18052,21233
2015-06-27 11:00:00-04:00,0,6,11,5,0,2295,14043,16338
2015-06-27 12:00:00-04:00,0,6,12,5,0,1931,9598,11529
2015-06-27 13:00:00-04:00,0,6,13,5,0,1058,4969,6027
2015-06-27 14:00:00-04:00,0,6,14,5,0,781,5276,6057
2015-06-27 15:00:00-04:00,0.01,6,15,5,0,934,7090,8024
2015-06-27 16:00:00-04:00,0.03,6,16,5,0,1216,10107,11323
2015-06-27 17:00:00-04:00,0.06,6,17,5,0,1654,14031,15685
2015-06-27 18:00:00-04:00,0.08,6,18,5,0,1960,16316,18276
2015-06-27 19:00:00-04:00,0.16,6,19,5,0,2232,18953,21185
2015-06-27 20:00:00-04:00,0.15,6,20,5,0,2448,20577,23025
2015-06-27 21:00:00-04:00,0.17,6,21,5,0,2536,20620,23156
2015-06-27 22:00:00-04:00,0.14,6,22,5,0,3040,20745,23785
2015-06-27 23:00:00-04:00,0.14,6,23,5,0,3769,22798,26567
2015-06-28 00:00:00-04:00,0.11,6,0,6,0,4461,19704,24165
2015-06-28 01:00:00-04:00,0.11,6,1,6,0,4687,21503,26190
2015-06-28 02:00:00-04:00,0.09,6,2,6,0,5360,25793,31153
2015-06-28 03:00:00-04:00,0.05,6,3,6,0,5403,27667,33070
2015-06-28 04:00:00-04:00,0.02,6,4,6,0,3929,23393,27322
2015-06-28 05:00:00-04:00,0,6,5,6,0,4320,25774,30094
2015-06-28 06:00:00-04:00,0,6,6,6,0,4368,25710,30078
2015-06-28 07:00:00-04:00,0,6,7,6,0,4755,25772,30527
2015-06-28 08:00:00-04:00,0,6,8,6,0,4619,23509,28128
2015-06-28 09:00:00-04:00,0,6,9,6,0,3861,20197,24058
2015-06-28 10:00:00-04:00,0,6,10,6,0,2789,16048,18837
2015-06-28 11:00:00-04:00,0,6,11,6,0,1946,12231,14177
2015-06-28 12:00:00-04:00,0,6,12,6,0,1507,7907,9414
2015-06-28 13:00:00-04:00,0,6,13,6,0,853,4102,4955
2015-06-28 14:00:00-04:00,0,6,14,6,0,674,4291,4965
2015-06-28 15:00:00-04:00,0,6,15,6,0,676,5536,6212
2015-06-28 16:00:00-04:00,0,6,16,6,0,900,8394,9294
2015-06-28 17:00:00-04:00,0,6,17,6,0,1330,12127,13457
2015-06-28 18:00:00-04:00,0,6,18,6,0,1792,16765,18557
2015-06-28 19:00:00-04:00,0,6,19,6,0,2116,17748,19864
2015-06-28 20:00:00-04:00,0,6,20,6,0,2291,19090,21381
2015-06-28 21:00:00-04:00,0,6,21,6,0,2270,17396,19666
2015-06-28 22:00:00-04:00,0,6,22,6,0,2574,16444,19018
2015-06-28 23:00:00-04:00,0,6,23,6,0,2798,15791,18589
2015-06-29 00:00:00-04:00,0,6,0,0,0,2936,15012,17948
2015-06-29 01:00:00-04:00,0,6,1,0,0,3129,16552,19681
2015-06-29 02:00:00-04:00,0,6,2,0,0,3064,16632,19696
2015-06-29 03:00:00-04:00,0,6,3,0,0,2914,16788,19702
2015-06-29 04:00:00-04:00,0,6,4,0,0,2219,15560,17779
2015-06-29 05:00:00-04:00,0,6,5,0,0,2383,17578,19961
2015-06-29 06:00:00-04:00,0,6,6,0,0,2452,17391,19843
2015-06-29 07:00:00-04:00,0,6,7,0,0,2539,15344,17883
2015-06-29 08:00:00-04:00,0,6,8,0,0,2034,10696,12730
2015-06-29 09:00:00-04:00,0,6,9,0,0,1495,6983,8478
2015-06-29 10:00:00-04:00,0,6,10,0,0,887,4781,5668
2015-06-29 11:00:00-04:00,0,6,11,0,0,593,3292,3885
2015-06-29 12:00:00-04:00,0,6,12,0,0,653,3334,3987
2015-06-29 13:00:00-04:00,0,6,13,0,0,564,4660,5224
2015-06-29 14:00:00-04:00,0,6,14,0,0,798,10846,11644
2015-06-29 15:00:00-04:00,0,6,15,0,0,1341,16001,17342
2015-06-29 16:00:00-04:00,0,6,16,0,0,2222,19744,21966
2015-06-29 17:00:00-04:00,0,6,17,0,0,2223,19537,21760
2015-06-29 18:00:00-04:00,0,6,18,0,0,1838,17142,18980
2015-06-29 19:00:00-04:00,0,6,19,0,0,1742,16872,18614
2015-06-29 20:00:00-04:00,0,6,20,0,0,1769,17480,19249
2015-06-29 21:00:00-04:00,0,6,21,0,0,1702,17331,19033
2015-06-29 22:00:00-04:00,0,6,22,0,0,1963,18193,20156
2015-06-29 23:00:00-04:00,0,6,23,0,0,2174,17232,19406
2015-06-30 00:00:00-04:00,0,6,0,1,0,2251,15187,17438
2015-06-30 01:00:00-04:00,0,6,1,1,0,2420,17435,19855
2015-06-30 02:00:00-04:00,0,6,2,1,0,2728,21906,24634
2015-06-30 03:00:00-04:00,0,6,3,1,0,2599,22388,24987
2015-06-30 04:00:00-04:00,0,6,4,1,0,1836,20396,22232
2015-06-30 05:00:00-04:00,0,6,5,1,0,1929,21929,23858
2015-06-30 06:00:00-04:00,0,6,6,1,0,1843,20561,22404
2015-06-30 07:00:00-04:00,0,6,7,1,0,1793,15882,17675
2015-06-30 08:00:00-04:00,0,6,8,1,0,1426,10253,11679
2015-06-30 09:00:00-04:00,0,6,9,1,0,1114,5965,7079
2015-06-30 10:00:00-04:00,0,6,10,1,0,622,3727,4349
2015-06-30 11:00:00-04:00,0,6,11,1,0,373,2407,2780
2015-06-30 12:00:00-04:00,0,6,12,1,0,433,2507,2940
2015-06-30 13:00:00-04:00,0,6,13,1,0,399,4056,4455
2015-06-30 14:00:00-04:00,0,6,14,1,0,701,11005,11706
2015-06-30 15:00:00-04:00,0,6,15,1,0,1284,16590,17874
2015-06-30 16:00:00-04:00,0,6,16,1,0,2110,20556,22666
2015-06-30 17:00:00-04:00,0,6,17,1,0,2287,20286,22573
2015-06-30 18:00:00-04:00,0,6,18,1,0,1900,18278,20178
2015-06-30 19:00:00-04:00,0,6,19,1,0,1804,17970,19774
2015-06-30 20:00:00-04:00,0,6,20,1,0,1790,18703,20493
2015-06-30 21:00:00-04:00,0,6,21,1,0,1821,18466,20287
2015-06-30 22:00:00-04:00,0,6,22,1,0,2023,19015,21038
2015-06-30 23:00:00-04:00,0,6,23,1,0,2319,17536,19855
2015-07-01 00:00:00-04:00,0,7,0,2,0,2506,15091,17597
2015-07-01 01:00:00-04:00,0,7,1,2,0,2706,18051,20757
2015-07-01 02:00:00-04:00,0,7,2,2,0,3218,21969,25187
2015-07-01 03:00:00-04:00,0,7,3,2,0,3078,24508,27586
2015-07-01 04:00:00-04:00,0.34,7,4,2,0,2229,21555,23784
2015-07-01 05:00:00-04:00,0.01,7,5,2,0,2381,24336,26717
2015-07-01 06:00:00-04:00,0,7,6,2,0,2235,22815,25050
2015-07-01 07:00:00-04:00,0,7,7,2,0,2222,18595,20817
2015-07-01 08:00:00-04:00,0,7,8,2,0,1937,13706,15643
2015-07-01 09:00:00-04:00,0,7,9,2,0,1355,7666,9021
2015-07-01 10:00:00-04:00,0,7,10,2,0,724,4759,5483
2015-07-01 11:00:00-04:00,0,7,11,2,0,459,3215,3674
2015-07-01 12:00:00-04:00,0,7,12,2,0,483,3150,3633
2015-07-01 13:00:00-04:00,0,7,13,2,0,489,4078,4567
2015-07-01 14:00:00-04:00,0,7,14,2,0,768,10867,11635
2015-07-01 15:00:00-04:00,0,7,15,2,0,1383,17005,18388
2015-07-01 16:00:00-04:00,0,7,16,2,0,2364,21247,23611
2015-07-01 17:00:00-04:00,0,7,17,2,0,2424,20440,22864
2015-07-01 18:00:00-04:00,0,7,18,2,0,2014,18296,20310
2015-07-01 19:00:00-04:00,0,7,19,2,0,1998,17997,19995
2015-07-01 20:00:00-04:00,0,7,20,2,0,2060,18763,20823
2015-07-01 21:00:00-04:00,0,7,21,2,0,1985,18963,20948
2015-07-01 22:00:00-04:00,0,7,22,2,0,2348,18745,21093
2015-07-01 23:00:00-04:00,0,7,23,2,0,2603,17605,20208
2015-07-02 00:00:00-04:00,0,7,0,3,0,3109,15266,18375
2015-07-02 01:00:00-04:00,0,7,1,3,0,3405,18721,22126
2015-07-02 02:00:00-04:00,0,7,2,3,0,3914,24324,28238
2015-07-02 03:00:00-04:00,0,7,3,3,0,3680,25336,29016
2015-07-02 04:00:00-04:00,0,7,4,3,0,2638,22616,25254
2015-07-02 05:00:00-04:00,0,7,5,3,0,2477,23990,26467
2015-07-02 06:00:00-04:00,0,7,6,3,0,2639,23588,26227
2015-07-02 07:00:00-04:00,0,7,7,3,0,2378,19741,22119
2015-07-02 08:00:00-04:00,0,7,8,3,0,2093,14262,16355
2015-07-02 09:00:00-04:00,0,7,9,3,0,1617,8911,10528
2015-07-02 10:00:00-04:00,0,7,10,3,0,896,5712,6608
2015-07-02 11:00:00-04:00,0,7,11,3,0,570,3886,4456
2015-07-02 12:00:00-04:00,0,7,12,3,0,581,3505,4086
2015-07-02 13:00:00-04:00,0,7,13,3,0,480,4332,4812
2015-07-02 14:00:00-04:00,0,7,14,3,0,771,9836,10607
2015-07-02 15:00:00-04:00,0,7,15,3,0,1324,15017,16341
2015-07-02 16:00:00-04:00,0,7,16,3,0,2248,19423,21671
2015-07-02 17:00:00-04:00,0,7,17,3,0,2416,18568,20984
2015-07-02 18:00:00-04:00,0,7,18,3,0,2098,16308,18406
2015-07-02 19:00:00-04:00,0,7,19,3,0,2050,16604,18654
2015-07-02 20:00:00-04:00,0,7,20,3,0,2160,18008,20168
2015-07-02 21:00:00-04:00,0,7,21,3,0,2204,18363,20567
2015-07-02 22:00:00-04:00,0,7,22,3,0,2643,18923,21566
2015-07-02 23:00:00-04:00,0,7,23,3,0,3017,17698,20715
2015-07-03 00:00:00-04:00,0,7,0,4,1,3190,15023,18213
2015-07-03 01:00:00-04:00,0,7,1,4,1,3243,18220,21463
2015-07-03 02:00:00-04:00,0,7,2,4,1,3502,21968,25470
2015-07-03 03:00:00-04:00,0,7,3,4,1,3319,21886,25205
2015-07-03 04:00:00-04:00,0,7,4,4,1,2656,20762,23418
2015-07-03 05:00:00-04:00,0,7,5,4,1,2740,19710,22450
2015-07-03 06:00:00-04:00,0,7,6,4,1,2788,20001,22789
2015-07-03 07:00:00-04:00,0,7,7,4,1,2921,19027,21948
2015-07-03 08:00:00-04:00,0,7,8,4,1,2683,16755,19438
2015-07-03 09:00:00-04:00,0,7,9,4,1,2325,13262,15587
2015-07-03 10:00:00-04:00,0,7,10,4,1,1605,10216,11821
2015-07-03 11:00:00-04:00,0,7,11,4,1,980,7437,8417
2015-07-03 12:00:00-04:00,0,7,12,4,1,897,5414,6311
2015-07-03 13:00:00-04:00,0,7,13,4,1,666,3819,4485
2015-07-03 14:00:00-04:00,0,7,14,4,1,701,5439,6140
2015-07-03 15:00:00-04:00,0,7,15,4,1,953,6974,7927
2015-07-03 16:00:00-04:00,0,7,16,4,1,1306,8835,10141
2015-07-03 17:00:00-04:00,0,7,17,4,1,1496,10991,12487
2015-07-03 18:00:00-04:00,0,7,18,4,1,1739,12628,14367
2015-07-03 19:00:00-04:00,0,7,19,4,1,1853,13648,15501
2015-07-03 20:00:00-04:00,0,7,20,4,1,1822,14607,16429
2015-07-03 21:00:00-04:00,0,7,21,4,1,1783,15076,16859
2015-07-03 22:00:00-04:00,0,7,22,4,1,2323,15355,17678
2015-07-03 23:00:00-04:00,0,7,23,4,1,2778,15680,18458
2015-07-04 00:00:00-04:00,0,7,0,5,0,3045,15082,18127
2015-07-04 01:00:00-04:00,0,7,1,5,0,3053,16133,19186
2015-07-04 02:00:00-04:00,0,7,2,5,0,3247,17139,20386
2015-07-04 03:00:00-04:00,0,7,3,5,0,3256,17382,20638
2015-07-04 04:00:00-04:00,0,7,4,5,0,2660,14652,17312
2015-07-04 05:00:00-04:00,0,7,5,5,0,2970,14948,17918
2015-07-04 06:00:00-04:00,0,7,6,5,0,3367,16478,19845
2015-07-04 07:00:00-04:00,0,7,7,5,0,3694,16226,19920
2015-07-04 08:00:00-04:00,0,7,8,5,0,3735,15311,19046
2015-07-04 09:00:00-04:00,0,7,9,5,0,3453,12796,16249
2015-07-04 10:00:00-04:00,0,7,10,5,0,2722,10951,13673
2015-07-04 11:00:00-04:00,0,7,11,5,0,1921,8690,10611
2015-07-04 12:00:00-04:00,0,7,12,5,0,1707,6121,7828
2015-07-04 13:00:00-04:00,0,7,13,5,0,985,2944,3929
2015-07-04 14:00:00-04:00,0,7,14,5,0,651,2918,3569
2015-07-04 15:00:00-04:00,0,7,15,5,0,591,3601,4192
2015-07-04 16:00:00-04:00,0,7,16,5,0,634,4333,4967
2015-07-04 17:00:00-04:00,0,7,17,5,0,876,6554,7430
2015-07-04 18:00:00-04:00,0,7,18,5,0,1149,8451,9600
2015-07-04 19:00:00-04:00,0,7,19,5,0,1340,9882,11222
2015-07-04 20:00:00-04:00,0,7,20,5,0,1579,12946,14525
2015-07-04 21:00:00-04:00,0,7,21,5,0,1984,14631,16615
2015-07-04 22:00:00-04:00,0,7,22,5,0,2362,12103,14465
2015-07-04 23:00:00-04:00,0,7,23,5,0,2630,11877,14507
2015-07-05 00:00:00-04:00,0,7,0,6,0,2919,12578,15497
2015-07-05 01:00:00-04:00,0,7,1,6,0,2834,13270,16104
2015-07-05 02:00:00-04:00,0,7,2,6,0,3188,14495,17683
2015-07-05 03:00:00-04:00,0,7,3,6,0,3319,14162,17481
2015-07-05 04:00:00-04:00,0,7,4,6,0,2646,12991,15637
2015-07-05 05:00:00-04:00,0,7,5,6,0,2785,12202,14987
2015-07-05 06:00:00-04:00,0,7,6,6,0,3476,14500,17976
2015-07-05 07:00:00-04:00,0,7,7,6,0,4282,16046,20328
2015-07-05 08:00:00-04:00,0,7,8,6,0,4594,15023,19617
2015-07-05 09:00:00-04:00,0,7,9,6,0,4187,13076,17263
2015-07-05 10:00:00-04:00,0,7,10,6,0,3317,10004,13321
2015-07-05 11:00:00-04:00,0,7,11,6,0,2312,7774,10086
2015-07-05 12:00:00-04:00,0,7,12,6,0,1854,5657,7511
2015-07-05 13:00:00-04:00,0,7,13,6,0,1033,2922,3955
2015-07-05 14:00:00-04:00,0,7,14,6,0,670,3104,3774
2015-07-05 15:00:00-04:00,0,7,15,6,0,597,3941,4538
2015-07-05 16:00:00-04:00,0,7,16,6,0,681,5155,5836
2015-07-05 17:00:00-04:00,0,7,17,6,0,995,7567,8562
2015-07-05 18:00:00-04:00,0,7,18,6,0,1263,10430,11693
2015-07-05 19:00:00-04:00,0,7,19,6,0,1684,12249,13933
2015-07-05 20:00:00-04:00,0,7,20,6,0,1932,13582,15514
2015-07-05 21:00:00-04:00,0,7,21,6,0,1910,14169,16079
2015-07-05 22:00:00-04:00,0,7,22,6,0,2275,14980,17255
2015-07-05 23:00:00-04:00,0,7,23,6,0,2526,14861,17387
2015-07-06 00:00:00-04:00,0,7,0,0,0,2632,14939,17571
2015-07-06 01:00:00-04:00,0,7,1,0,0,2574,16113,18687
2015-07-06 02:00:00-04:00,0,7,2,0,0,2858,17156,20014
2015-07-06 03:00:00-04:00,0,7,3,0,0,2599,16095,18694
2015-07-06 04:00:00-04:00,0,7,4,0,0,1982,13666,15648
2015-07-06 05:00:00-04:00,0,7,5,0,0,2303,16612,18915
2015-07-06 06:00:00-04:00,0,7,6,0,0,2275,14541,16816
2015-07-06 07:00:00-04:00,0,7,7,0,0,2139,11939,14078
2015-07-06 08:00:00-04:00,0,7,8,0,0,1718,8167,9885
2015-07-06 09:00:00-04:00,0,7,9,0,0,1036,4352,5388
2015-07-06 10:00:00-04:00,0,7,10,0,0,693,2750,3443
2015-07-06 11:00:00-04:00,0,7,11,0,0,482,1833,2315
2015-07-06 12:00:00-04:00,0,7,12,0,0,558,2092,2650
2015-07-06 13:00:00-04:00,0,7,13,0,0,521,3651,4172
2015-07-06 14:00:00-04:00,0,7,14,0,0,712,9308,10020
2015-07-06 15:00:00-04:00,0,7,15,0,0,1396,14107,15503
2015-07-06 16:00:00-04:00,0,7,16,0,0,2234,18656,20890
2015-07-06 17:00:00-04:00,0,7,17,0,0,2187,17183,19370
2015-07-06 18:00:00-04:00,0,7,18,0,0,1834,14652,16486
2015-07-06 19:00:00-04:00,0,7,19,0,0,1723,14465,16188
2015-07-06 20:00:00-04:00,0,7,20,0,0,1715,15134,16849
2015-07-06 21:00:00-04:00,0,7,21,0,0,1657,15755,17412
2015-07-06 22:00:00-04:00,0,7,22,0,0,1948,16458,18406
2015-07-06 23:00:00-04:00,0,7,23,0,0,2146,16670,18816
2015-07-07 00:00:00-04:00,0,7,0,1,0,2265,15396,17661
2015-07-07 01:00:00-04:00,0,7,1,1,0,2494,17779,20273
2015-07-07 02:00:00-04:00,0,7,2,1,0,2747,20721,23468
2015-07-07 03:00:00-04:00,0,7,3,1,0,2562,20500,23062
2015-07-07 04:00:00-04:00,0,7,4,1,0,1868,17865,19733
2015-07-07 05:00:00-04:00,0,7,5,1,0,1810,18205,20015
2015-07-07 06:00:00-04:00,0,7,6,1,0,1700,17013,18713
2015-07-07 07:00:00-04:00,0,7,7,1,0,1601,12814,14415
2015-07-07 08:00:00-04:00,0,7,8,1,0,1283,8661,9944
2015-07-07 09:00:00-04:00,0,7,9,1,0,899,5152,6051
2015-07-07 10:00:00-04:00,0,7,10,1,0,562,3031,3593
2015-07-07 11:00:00-04:00,0,7,11,1,0,388,2164,2552
2015-07-07 12:00:00-04:00,0,7,12,1,0,378,2151,2529
2015-07-07 13:00:00-04:00,0,7,13,1,0,400,4010,4410
2015-07-07 14:00:00-04:00,0,7,14,1,0,704,9982,10686
2015-07-07 15:00:00-04:00,0,7,15,1,0,1422,16441,17863
2015-07-07 16:00:00-04:00,0,7,16,1,0,2274,21003,23277
2015-07-07 17:00:00-04:00,0,7,17,1,0,2271,20007,22278
2015-07-07 18:00:00-04:00,0,7,18,1,0,1884,17240,19124
2015-07-07 19:00:00-04:00,0,7,19,1,0,1822,17374,19196
2015-07-07 20:00:00-04:00,0,7,20,1,0,1864,18410,20274
2015-07-07 21:00:00-04:00,0,7,21,1,0,1814,18231,20045
2015-07-07 22:00:00-04:00,0,7,22,1,0,2062,18762,20824
2015-07-07 23:00:00-04:00,0,7,23,1,0,2250,17828,20078
2015-07-08 00:00:00-04:00,0,7,0,2,0,2353,15891,18244
2015-07-08 01:00:00-04:00,0,7,1,2,0,2650,20114,22764
2015-07-08 02:00:00-04:00,0,7,2,2,0,2873,23389,26262
2015-07-08 03:00:00-04:00,0,7,3,2,0,2761,23689,26450
2015-07-08 04:00:00-04:00,0,7,4,2,0,2113,21191,23304
2015-07-08 05:00:00-04:00,0,7,5,2,0,2140,23210,25350
2015-07-08 06:00:00-04:00,0,7,6,2,0,2160,22018,24178
2015-07-08 07:00:00-04:00,0,7,7,2,0,2045,17630,19675
2015-07-08 08:00:00-04:00,0,7,8,2,0,1543,11830,13373
2015-07-08 09:00:00-04:00,0,7,9,2,0,1078,6516,7594
2015-07-08 10:00:00-04:00,0,7,10,2,0,621,3982,4603
2015-07-08 11:00:00-04:00,0,7,11,2,0,370,2636,3006
2015-07-08 12:00:00-04:00,0,7,12,2,0,411,2543,2954
2015-07-08 13:00:00-04:00,0,7,13,2,0,422,3981,4403
2015-07-08 14:00:00-04:00,0,7,14,2,0,710,10369,11079
2015-07-08 15:00:00-04:00,0,7,15,2,0,1343,17150,18493
2015-07-08 16:00:00-04:00,0.06,7,16,2,0,2330,21910,24240
2015-07-08 17:00:00-04:00,0.03,7,17,2,0,2304,21529,23833
2015-07-08 18:00:00-04:00,0,7,18,2,0,2077,18706,20783
2015-07-08 19:00:00-04:00,0,7,19,2,0,1995,18884,20879
2015-07-08 20:00:00-04:00,0,7,20,2,0,1948,19145,21093
2015-07-08 21:00:00-04:00,0,7,21,2,0,2021,19478,21499
2015-07-08 22:00:00-04:00,0,7,22,2,0,2164,19805,21969
2015-07-08 23:00:00-04:00,0,7,23,2,0,2480,19485,21965
2015-07-09 00:00:00-04:00,0,7,0,3,0,2867,16379,19246
2015-07-09 01:00:00-04:00,0,7,1,3,0,3143,18946,22089
2015-07-09 02:00:00-04:00,0,7,2,3,0,3083,23795,26878
2015-07-09 03:00:00-04:00,0,7,3,3,0,2897,25586,28483
2015-07-09 04:00:00-04:00,0,7,4,3,0,2144,22647,24791
2015-07-09 05:00:00-04:00,0,7,5,3,0,2335,24571,26906
2015-07-09 06:00:00-04:00,0,7,6,3,0,2399,23944,26343
2015-07-09 07:00:00-04:00,0,7,7,3,0,2227,19369,21596
2015-07-09 08:00:00-04:00,0,7,8,3,0,1882,13427,15309
2015-07-09 09:00:00-04:00,0,7,9,3,0,1251,8499,9750
2015-07-09 10:00:00-04:00,0,7,10,3,0,743,4910,5653
2015-07-09 11:00:00-04:00,0,7,11,3,0,518,3311,3829
2015-07-09 12:00:00-04:00,0,7,12,3,0,472,2905,3377
2015-07-09 13:00:00-04:00,0,7,13,3,0,489,4249,4738
2015-07-09 14:00:00-04:00,0,7,14,3,0,782,10268,11050
2015-07-09 15:00:00-04:00,0,7,15,3,0,1478,18349,19827
2015-07-09 16:00:00-04:00,0,7,16,3,0,2539,23312,25851
2015-07-09 17:00:00-04:00,0,7,17,3,0,2377,21151,23528
2015-07-09 18:00:00-04:00,0,7,18,3,0,2015,17994,20009
2015-07-09 19:00:00-04:00,0,7,19,3,0,1919,17752,19671
2015-07-09 20:00:00-04:00,0.04,7,20,3,0,1908,18666,20574
2015-07-09 21:00:00-04:00,0.19,7,21,3,0,1872,18516,20388
2015-07-09 22:00:00-04:00,0.06,7,22,3,0,2143,19202,21345
2015-07-09 23:00:00-04:00,0,7,23,3,0,2388,17952,20340
2015-07-10 00:00:00-04:00,0,7,0,4,0,2568,15350,17918
2015-07-10 01:00:00-04:00,0,7,1,4,0,2840,18835,21675
2015-07-10 02:00:00-04:00,0,7,2,4,0,3227,24142,27369
2015-07-10 03:00:00-04:00,0,7,3,4,0,3083,26312,29395
2015-07-10 04:00:00-04:00,0,7,4,4,0,3033,26027,29060
2015-07-10 05:00:00-04:00,0,7,5,4,0,3921,28882,32803
2015-07-10 06:00:00-04:00,0,7,6,4,0,3166,23910,27076
2015-07-10 07:00:00-04:00,0,7,7,4,0,2603,21735,24338
2015-07-10 08:00:00-04:00,0,7,8,4,0,2228,17697,19925
2015-07-10 09:00:00-04:00,0,7,9,4,0,1720,11924,13644
2015-07-10 10:00:00-04:00,0,7,10,4,0,981,7383,8364
2015-07-10 11:00:00-04:00,0,7,11,4,0,588,4851,5439
2015-07-10 12:00:00-04:00,0,7,12,4,0,578,4008,4586
2015-07-10 13:00:00-04:00,0,7,13,4,0,538,4580,5118
2015-07-10 14:00:00-04:00,0,7,14,4,0,813,10096,10909
2015-07-10 15:00:00-04:00,0,7,15,4,0,1383,15926,17309
2015-07-10 16:00:00-04:00,0,7,16,4,0,2301,19850,22151
2015-07-10 17:00:00-04:00,0,7,17,4,0,2209,18744,20953
2015-07-10 18:00:00-04:00,0,7,18,4,0,2023,16535,18558
2015-07-10 19:00:00-04:00,0,7,19,4,0,1875,16409,18284
2015-07-10 20:00:00-04:00,0,7,20,4,0,1863,18035,19898
2015-07-10 21:00:00-04:00,0,7,21,4,0,1771,17663,19434
2015-07-10 22:00:00-04:00,0,7,22,4,0,2289,18819,21108
2015-07-10 23:00:00-04:00,0,7,23,4,0,2808,17819,20627
2015-07-11 00:00:00-04:00,0,7,0,5,0,3031,15654,18685
2015-07-11 01:00:00-04:00,0,7,1,5,0,3406,19255,22661
2015-07-11 02:00:00-04:00,0,7,2,5,0,3948,23961,27909
2015-07-11 03:00:00-04:00,0,7,3,5,0,3685,25084,28769
2015-07-11 04:00:00-04:00,0,7,4,5,0,3040,22694,25734
2015-07-11 05:00:00-04:00,0,7,5,5,0,3265,23547,26812
2015-07-11 06:00:00-04:00,0,7,6,5,0,3675,24930,28605
2015-07-11 07:00:00-04:00,0,7,7,5,0,3989,25550,29539
2015-07-11 08:00:00-04:00,0,7,8,5,0,4152,23967,28119
2015-07-11 09:00:00-04:00,0,7,9,5,0,3850,21413,25263
2015-07-11 10:00:00-04:00,0,7,10,5,0,3016,17075,20091
2015-07-11 11:00:00-04:00,0,7,11,5,0,2133,12644,14777
2015-07-11 12:00:00-04:00,0,7,12,5,0,1778,8164,9942
2015-07-11 13:00:00-04:00,0,7,13,5,0,945,4174,5119
2015-07-11 14:00:00-04:00,0,7,14,5,0,742,4763,5505
2015-07-11 15:00:00-04:00,0,7,15,5,0,871,6699,7570
2015-07-11 16:00:00-04:00,0,7,16,5,0,1197,9492,10689
2015-07-11 17:00:00-04:00,0,7,17,5,0,1577,13453,15030
2015-07-11 18:00:00-04:00,0,7,18,5,0,1993,16025,18018
2015-07-11 19:00:00-04:00,0,7,19,5,0,2161,18000,20161
2015-07-11 20:00:00-04:00,0,7,20,5,0,2378,19214,21592
2015-07-11 21:00:00-04:00,0,7,21,5,0,2407,19413,21820
2015-07-11 22:00:00-04:00,0,7,22,5,0,2782,18883,21665
2015-07-11 23:00:00-04:00,0,7,23,5,0,3197,19430,22627
2015-07-12 00:00:00-04:00,0,7,0,6,0,3491,18604,22095
2015-07-12 01:00:00-04:00,0,7,1,6,0,3570,20574,24144
2015-07-12 02:00:00-04:00,0,7,2,6,0,4014,22760,26774
2015-07-12 03:00:00-04:00,0,7,3,6,0,3878,23578,27456
2015-07-12 04:00:00-04:00,0,7,4,6,0,3221,20469,23690
2015-07-12 05:00:00-04:00,0,7,5,6,0,3567,21380,24947
2015-07-12 06:00:00-04:00,0,7,6,6,0,3995,23028,27023
2015-07-12 07:00:00-04:00,0,7,7,6,0,4488,24000,28488
2015-07-12 08:00:00-04:00,0,7,8,6,0,4640,23475,28115
2015-07-12 09:00:00-04:00,0,7,9,6,0,4148,21571,25719
2015-07-12 10:00:00-04:00,0,7,10,6,0,3399,17117,20516
2015-07-12 11:00:00-04:00,0,7,11,6,0,2413,13368,15781
2015-07-12 12:00:00-04:00,0,7,12,6,0,1940,8842,10782
2015-07-12 13:00:00-04:00,0,7,13,6,0,1019,4097,5116
2015-07-12 14:00:00-04:00,0,7,14,6,0,669,3815,4484
2015-07-12 15:00:00-04:00,0,7,15,6,0,696,5200,5896
2015-07-12 16:00:00-04:00,0,7,16,6,0,774,7108,7882
2015-07-12 17:00:00-04:00,0,7,17,6,0,1186,10823,12009
2015-07-12 18:00:00-04:00,0,7,18,6,0,1594,14462,16056
2015-07-12 19:00:00-04:00,0,7,19,6,0,1883,17263,19146
2015-07-12 20:00:00-04:00,0,7,20,6,0,2129,18188,20317
2015-07-12 21:00:00-04:00,0,7,21,6,0,2251,19669,21920
2015-07-12 22:00:00-04:00,0,7,22,6,0,2608,19531,22139
2015-07-12 23:00:00-04:00,0,7,23,6,0,2850,18804,21654
2015-07-13 00:00:00-04:00,0,7,0,0,0,2967,18113,21080
2015-07-13 01:00:00-04:00,0,7,1,0,0,2955,19400,22355
2015-07-13 02:00:00-04:00,0,7,2,0,0,3151,20338,23489
2015-07-13 03:00:00-04:00,0,7,3,0,0,2826,18930,21756
2015-07-13 04:00:00-04:00,0,7,4,0,0,2222,16324,18546
2015-07-13 05:00:00-04:00,0,7,5,0,0,2477,18442,20919
2015-07-13 06:00:00-04:00,0,7,6,0,0,2486,16571,19057
2015-07-13 07:00:00-04:00,0,7,7,0,0,2395,12760,15155
2015-07-13 08:00:00-04:00,0,7,8,0,0,1970,8605,10575
2015-07-13 09:00:00-04:00,0,7,9,0,0,1321,4720,6041
2015-07-13 10:00:00-04:00,0,7,10,0,0,784,2958,3742
2015-07-13 11:00:00-04:00,0,7,11,0,0,522,2181,2703
2015-07-13 12:00:00-04:00,0,7,12,0,0,593,2506,3099
2015-07-13 13:00:00-04:00,0,7,13,0,0,510,4133,4643
2015-07-13 14:00:00-04:00,0,7,14,0,0,773,10463,11236
2015-07-13 15:00:00-04:00,0,7,15,0,0,1430,16323,17753
2015-07-13 16:00:00-04:00,0,7,16,0,0,2288,19587,21875
2015-07-13 17:00:00-04:00,0,7,17,0,0,2155,18688,20843
2015-07-13 18:00:00-04:00,0,7,18,0,0,1761,16493,18254
2015-07-13 19:00:00-04:00,0,7,19,0,0,1641,16408,18049
2015-07-13 20:00:00-04:00,0,7,20,0,0,1730,17296,19026
2015-07-13 21:00:00-04:00,0,7,21,0,0,1677,17412,19089
2015-07-13 22:00:00-04:00,0,7,22,0,0,1958,18284,20242
2015-07-13 23:00:00-04:00,0,7,23,0,0,2127,18130,20257
2015-07-14 00:00:00-04:00,0,7,0,1,0,2197,16710,18907
2015-07-14 01:00:00-04:00,0,7,1,1,0,2496,19063,21559
2015-07-14 02:00:00-04:00,0,7,2,1,0,2566,22602,25168
2015-07-14 03:00:00-04:00,0,7,3,1,0,2428,22650,25078
2015-07-14 04:00:00-04:00,0,7,4,1,0,1895,19942,21837
2015-07-14 05:00:00-04:00,0,7,5,1,0,1821,21207,23028
2015-07-14 06:00:00-04:00,0,7,6,1,0,1785,19205,20990
2015-07-14 07:00:00-04:00,0,7,7,1,0,1547,14596,16143
2015-07-14 08:00:00-04:00,0,7,8,1,0,1299,9626,10925
2015-07-14 09:00:00-04:00,0,7,9,1,0,842,5526,6368
2015-07-14 10:00:00-04:00,0,7,10,1,0,530,3629,4159
2015-07-14 11:00:00-04:00,0.01,7,11,1,0,388,2396,2784
2015-07-14 12:00:00-04:00,0.02,7,12,1,0,439,2376,2815
2015-07-14 13:00:00-04:00,0.91,7,13,1,0,439,4190,4629
2015-07-14 14:00:00-04:00,0.02,7,14,1,0,722,10781,11503
2015-07-14 15:00:00-04:00,0,7,15,1,0,1353,16859,18212
2015-07-14 16:00:00-04:00,0,7,16,1,0,2083,20417,22500
2015-07-14 17:00:00-04:00,0,7,17,1,0,2155,20492,22647
2015-07-14 18:00:00-04:00,0,7,18,1,0,2039,19666,21705
2015-07-14 19:00:00-04:00,0,7,19,1,0,1754,18339,20093
2015-07-14 20:00:00-04:00,0,7,20,1,0,1945,21168,23113
2015-07-14 21:00:00-04:00,0,7,21,1,0,2212,20888,23100
2015-07-14 22:00:00-04:00,0,7,22,1,0,2205,18915,21120
2015-07-14 23:00:00-04:00,0,7,23,1,0,2209,16977,19186
2015-07-15 00:00:00-04:00,0,7,0,2,0,2307,15059,17366
2015-07-15 01:00:00-04:00,0,7,1,2,0,2578,19654,22232
2015-07-15 02:00:00-04:00,0,7,2,2,0,2916,24261,27177
2015-07-15 03:00:00-04:00,0,7,3,2,0,2508,24594,27102
2015-07-15 04:00:00-04:00,0,7,4,2,0,1972,22801,24773
2015-07-15 05:00:00-04:00,0,7,5,2,0,2103,25034,27137
2015-07-15 06:00:00-04:00,0,7,6,2,0,2112,23297,25409
2015-07-15 07:00:00-04:00,0,7,7,2,0,1909,18621,20530
2015-07-15 08:00:00-04:00,0.01,7,8,2,0,1556,12866,14422
2015-07-15 09:00:00-04:00,0,7,9,2,0,1049,7778,8827
2015-07-15 10:00:00-04:00,0,7,10,2,0,636,4696,5332
2015-07-15 11:00:00-04:00,0,7,11,2,0,379,3051,3430
2015-07-15 12:00:00-04:00,0,7,12,2,0,418,2783,3201
2015-07-15 13:00:00-04:00,0,7,13,2,0,403,4287,4690
2015-07-15 14:00:00-04:00,0,7,14,2,0,761,11107,11868
2015-07-15 15:00:00-04:00,0,7,15,2,0,1475,18228,19703
2015-07-15 16:00:00-04:00,0,7,16,2,0,2415,22320,24735
2015-07-15 17:00:00-04:00,0,7,17,2,0,2390,21293,23683
2015-07-15 18:00:00-04:00,0,7,18,2,0,2096,20337,22433
2015-07-15 19:00:00-04:00,0,7,19,2,0,2070,19884,21954
2015-07-15 20:00:00-04:00,0,7,20,2,0,1935,20013,21948
2015-07-15 21:00:00-04:00,0,7,21,2,0,1829,17881,19710
2015-07-15 22:00:00-04:00,0,7,22,2,0,2081,18593,20674
2015-07-15 23:00:00-04:00,0,7,23,2,0,2220,17760,19980
2015-07-16 00:00:00-04:00,0,7,0,3,0,2395,15953,18348
2015-07-16 01:00:00-04:00,0,7,1,3,0,2808,19516,22324
2015-07-16 02:00:00-04:00,0,7,2,3,0,3096,25003,28099
2015-07-16 03:00:00-04:00,0,7,3,3,0,2841,26819,29660
2015-07-16 04:00:00-04:00,0,7,4,3,0,2234,23534,25768
2015-07-16 05:00:00-04:00,0,7,5,3,0,2351,25625,27976
2015-07-16 06:00:00-04:00,0,7,6,3,0,2419,24485,26904
2015-07-16 07:00:00-04:00,0,7,7,3,0,2402,20943,23345
2015-07-16 08:00:00-04:00,0,7,8,3,0,1982,14468,16450
2015-07-16 09:00:00-04:00,0,7,9,3,0,1325,8664,9989
2015-07-16 10:00:00-04:00,0,7,10,3,0,763,5376,6139
2015-07-16 11:00:00-04:00,0,7,11,3,0,505,3569,4074
2015-07-16 12:00:00-04:00,0,7,12,3,0,509,3145,3654
2015-07-16 13:00:00-04:00,0,7,13,3,0,479,4281,4760
2015-07-16 14:00:00-04:00,0,7,14,3,0,774,11307,12081
2015-07-16 15:00:00-04:00,0,7,15,3,0,1460,18234,19694
2015-07-16 16:00:00-04:00,0,7,16,3,0,2279,21422,23701
2015-07-16 17:00:00-04:00,0,7,17,3,0,2278,20369,22647
2015-07-16 18:00:00-04:00,0,7,18,3,0,1927,18469,20396
2015-07-16 19:00:00-04:00,0,7,19,3,0,1784,18180,19964
2015-07-16 20:00:00-04:00,0,7,20,3,0,1967,19353,21320
2015-07-16 21:00:00-04:00,0,7,21,3,0,1817,19139,20956
2015-07-16 22:00:00-04:00,0,7,22,3,0,2130,19648,21778
2015-07-16 23:00:00-04:00,0,7,23,3,0,2296,18394,20690
2015-07-17 00:00:00-04:00,0,7,0,4,0,2594,14843,17437
2015-07-17 01:00:00-04:00,0,7,1,4,0,2995,17974,20969
2015-07-17 02:00:00-04:00,0,7,2,4,0,3218,22301,25519
2015-07-17 03:00:00-04:00,0,7,3,4,0,3005,24506,27511
2015-07-17 04:00:00-04:00,0,7,4,4,0,2381,23130,25511
2015-07-17 05:00:00-04:00,0,7,5,4,0,2596,25730,28326
2015-07-17 06:00:00-04:00,0,7,6,4,0,2638,25313,27951
2015-07-17 07:00:00-04:00,0,7,7,4,0,2766,22325,25091
2015-07-17 08:00:00-04:00,0,7,8,4,0,2373,19041,21414
2015-07-17 09:00:00-04:00,0,7,9,4,0,1736,13168,14904
2015-07-17 10:00:00-04:00,0,7,10,4,0,1196,8545,9741
2015-07-17 11:00:00-04:00,0,7,11,4,0,828,5625,6453
2015-07-17 12:00:00-04:00,0,7,12,4,0,610,4429,5039
2015-07-17 13:00:00-04:00,0,7,13,4,0,565,4723,5288
2015-07-17 14:00:00-04:00,0,7,14,4,0,682,9944,10626
2015-07-17 15:00:00-04:00,0,7,15,4,0,1211,14353,15564
2015-07-17 16:00:00-04:00,0,7,16,4,0,1759,16397,18156
2015-07-17 17:00:00-04:00,0,7,17,4,0,1875,16817,18692
2015-07-17 18:00:00-04:00,0,7,18,4,0,1657,16037,17694
2015-07-17 19:00:00-04:00,0,7,19,4,0,1676,16403,18079
2015-07-17 20:00:00-04:00,0,7,20,4,0,1587,17250,18837
2015-07-17 21:00:00-04:00,0,7,21,4,0,1690,17075,18765
2015-07-17 22:00:00-04:00,0,7,22,4,0,1864,15898,17762
2015-07-17 23:00:00-04:00,0,7,23,4,0,2155,14686,16841
2015-07-18 00:00:00-04:00,0,7,0,5,0,2317,13512,15829
2015-07-18 01:00:00-04:00,0,7,1,5,0,2588,15937,18525
2015-07-18 02:00:00-04:00,0,7,2,5,0,3000,18903,21903
2015-07-18 03:00:00-04:00,0,7,3,5,0,3179,21264,24443
2015-07-18 04:00:00-04:00,0,7,4,5,0,2959,20594,23553
2015-07-18 05:00:00-04:00,0,7,5,5,0,3135,21331,24466
2015-07-18 06:00:00-04:00,0,7,6,5,0,3264,21963,25227
2015-07-18 07:00:00-04:00,0,7,7,5,0,3396,21150,24546
2015-07-18 08:00:00-04:00,0.01,7,8,5,0,3370,20145,23515
2015-07-18 09:00:00-04:00,0.17,7,9,5,0,3137,18871,22008
2015-07-18 10:00:00-04:00,0,7,10,5,0,2676,15984,18660
2015-07-18 11:00:00-04:00,0,7,11,5,0,2099,12411,14510
2015-07-18 12:00:00-04:00,0,7,12,5,0,1576,7850,9426
2015-07-18 13:00:00-04:00,0,7,13,5,0,964,4363,5327
2015-07-18 14:00:00-04:00,0,7,14,5,0,752,5068,5820
2015-07-18 15:00:00-04:00,0,7,15,5,0,868,7086,7954
2015-07-18 16:00:00-04:00,0,7,16,5,0,1316,10827,12143
2015-07-18 17:00:00-04:00,0,7,17,5,0,1670,13932,15602
2015-07-18 18:00:00-04:00,0,7,18,5,0,1760,15382,17142
2015-07-18 19:00:00-04:00,0,7,19,5,0,2007,17474,19481
2015-07-18 20:00:00-04:00,0,7,20,5,0,2140,18722,20862
2015-07-18 21:00:00-04:00,0,7,21,5,0,2294,19270,21564
2015-07-18 22:00:00-04:00,0,7,22,5,0,2548,19086,21634
2015-07-18 23:00:00-04:00,0,7,23,5,0,3048,19613,22661
2015-07-19 00:00:00-04:00,0,7,0,6,0,3232,18232,21464
2015-07-19 01:00:00-04:00,0,7,1,6,0,3432,20091,23523
2015-07-19 02:00:00-04:00,0,7,2,6,0,3790,23556,27346
2015-07-19 03:00:00-04:00,0,7,3,6,0,4027,24646,28673
2015-07-19 04:00:00-04:00,0,7,4,6,0,3805,21506,25311
2015-07-19 05:00:00-04:00,0,7,5,6,0,4069,21755,25824
2015-07-19 06:00:00-04:00,0,7,6,6,0,4247,23436,27683
2015-07-19 07:00:00-04:00,0,7,7,6,0,4540,24518,29058
2015-07-19 08:00:00-04:00,0,7,8,6,0,4526,23197,27723
2015-07-19 09:00:00-04:00,0,7,9,6,0,4047,20911,24958
2015-07-19 10:00:00-04:00,0,7,10,6,0,3487,17733,21220
2015-07-19 11:00:00-04:00,0,7,11,6,0,2835,13711,16546
2015-07-19 12:00:00-04:00,0,7,12,6,0,2043,9211,11254
2015-07-19 13:00:00-04:00,0,7,13,6,0,1035,4407,5442
2015-07-19 14:00:00-04:00,0,7,14,6,0,631,4528,5159
2015-07-19 15:00:00-04:00,0,7,15,6,0,717,5798,6515
2015-07-19 16:00:00-04:00,0,7,16,6,0,874,8430,9304
2015-07-19 17:00:00-04:00,0,7,17,6,0,1299,12086,13385
2015-07-19 18:00:00-04:00,0,7,18,6,0,1769,16289,18058
2015-07-19 19:00:00-04:00,0,7,19,6,0,2062,19439,21501
2015-07-19 20:00:00-04:00,0,7,20,6,0,2389,21310,23699
2015-07-19 21:00:00-04:00,0,7,21,6,0,2450,21765,24215
2015-07-19 22:00:00-04:00,0,7,22,6,0,2898,21958,24856
2015-07-19 23:00:00-04:00,0,7,23,6,0,3163,21080,24243
2015-07-20 00:00:00-04:00,0,7,0,0,0,3242,19996,23238
2015-07-20 01:00:00-04:00,0,7,1,0,0,3059,20687,23746
2015-07-20 02:00:00-04:00,0,7,2,0,0,3306,22078,25384
2015-07-20 03:00:00-04:00,0,7,3,0,0,3291,21269,24560
2015-07-20 04:00:00-04:00,0,7,4,0,0,2907,18835,21742
2015-07-20 05:00:00-04:00,0,7,5,0,0,2943,18813,21756
2015-07-20 06:00:00-04:00,0,7,6,0,0,2811,17331,20142
2015-07-20 07:00:00-04:00,0,7,7,0,0,2591,14613,17204
2015-07-20 08:00:00-04:00,0,7,8,0,0,1938,9379,11317
2015-07-20 09:00:00-04:00,0,7,9,0,0,1289,5199,6488
2015-07-20 10:00:00-04:00,0,7,10,0,0,806,3187,3993
2015-07-20 11:00:00-04:00,0,7,11,0,0,635,2291,2926
2015-07-20 12:00:00-04:00,0,7,12,0,0,584,2654,3238
2015-07-20 13:00:00-04:00,0,7,13,0,0,532,4488,5020
2015-07-20 14:00:00-04:00,0,7,14,0,0,739,11020,11759
2015-07-20 15:00:00-04:00,0,7,15,0,0,1526,17043,18569
2015-07-20 16:00:00-04:00,0,7,16,0,0,2322,20146,22468
2015-07-20 17:00:00-04:00,0,7,17,0,0,2377,19379,21756
2015-07-20 18:00:00-04:00,0,7,18,0,0,1930,17899,19829
2015-07-20 19:00:00-04:00,0,7,19,0,0,1848,18032,19880
2015-07-20 20:00:00-04:00,0,7,20,0,0,1872,19130,21002
2015-07-20 21:00:00-04:00,0,7,21,0,0,1867,18993,20860
2015-07-20 22:00:00-04:00,0,7,22,0,0,1962,19576,21538
2015-07-20 23:00:00-04:00,0,7,23,0,0,2216,19002,21218
2015-07-21 00:00:00-04:00,0,7,0,1,0,2394,17067,19461
2015-07-21 01:00:00-04:00,0,7,1,1,0,2630,20507,23137
2015-07-21 02:00:00-04:00,0,7,2,1,0,2923,23987,26910
2015-07-21 03:00:00-04:00,0,7,3,1,0,2910,25199,28109
2015-07-21 04:00:00-04:00,0,7,4,1,0,2277,22760,25037
2015-07-21 05:00:00-04:00,0,7,5,1,0,2200,22356,24556
2015-07-21 06:00:00-04:00,0,7,6,1,0,1931,20106,22037
2015-07-21 07:00:00-04:00,0,7,7,1,0,1658,14811,16469
2015-07-21 08:00:00-04:00,0,7,8,1,0,1256,9746,11002
2015-07-21 09:00:00-04:00,0,7,9,1,0,875,5595,6470
2015-07-21 10:00:00-04:00,0,7,10,1,0,590,3459,4049
2015-07-21 11:00:00-04:00,0,7,11,1,0,441,2264,2705
2015-07-21 12:00:00-04:00,0,7,12,1,0,455,2360,2815
2015-07-21 13:00:00-04:00,0,7,13,1,0,456,4107,4563
2015-07-21 14:00:00-04:00,0,7,14,1,0,738,11050,11788
2015-07-21 15:00:00-04:00,0,7,15,1,0,1429,17873,19302
2015-07-21 16:00:00-04:00,0,7,16,1,0,2354,22205,24559
2015-07-21 17:00:00-04:00,0,7,17,1,0,2328,20980,23308
2015-07-21 18:00:00-04:00,0,7,18,1,0,1952,19021,20973
2015-07-21 19:00:00-04:00,0,7,19,1,0,1806,18767,20573
2015-07-21 20:00:00-04:00,0,7,20,1,0,1782,19549,21331
2015-07-21 21:00:00-04:00,0,7,21,1,0,1790,19213,21003
2015-07-21 22:00:00-04:00,0,7,22,1,0,1952,18878,20830
2015-07-21 23:00:00-04:00,0,7,23,1,0,2146,16075,18221
2015-07-22 00:00:00-04:00,0,7,0,2,0,2332,13561,15893
2015-07-22 01:00:00-04:00,0,7,1,2,0,2612,15658,18270
2015-07-22 02:00:00-04:00,0,7,2,2,0,3037,21410,24447
2015-07-22 03:00:00-04:00,0,7,3,2,0,3076,24168,27244
2015-07-22 04:00:00-04:00,0,7,4,2,0,2488,23392,25880
2015-07-22 05:00:00-04:00,0,7,5,2,0,2503,24296,26799
2015-07-22 06:00:00-04:00,0,7,6,2,0,2371,22883,25254
2015-07-22 07:00:00-04:00,0,7,7,2,0,2052,18526,20578
2015-07-22 08:00:00-04:00,0,7,8,2,0,1750,13147,14897
2015-07-22 09:00:00-04:00,0,7,9,2,0,1229,7322,8551
2015-07-22 10:00:00-04:00,0,7,10,2,0,754,4608,5362
2015-07-22 11:00:00-04:00,0,7,11,2,0,447,3064,3511
2015-07-22 12:00:00-04:00,0,7,12,2,0,440,2704,3144
2015-07-22 13:00:00-04:00,0,7,13,2,0,386,4221,4607
2015-07-22 14:00:00-04:00,0,7,14,2,0,715,10962,11677
2015-07-22 15:00:00-04:00,0,7,15,2,0,1374,17717,19091
2015-07-22 16:00:00-04:00,0,7,16,2,0,2342,21545,23887
2015-07-22 17:00:00-04:00,0,7,17,2,0,2217,20520,22737
2015-07-22 18:00:00-04:00,0,7,18,2,0,1936,18475,20411
2015-07-22 19:00:00-04:00,0,7,19,2,0,1750,18606,20356
2015-07-22 20:00:00-04:00,0,7,20,2,0,1762,19281,21043
2015-07-22 21:00:00-04:00,0,7,21,2,0,1798,19098,20896
2015-07-22 22:00:00-04:00,0,7,22,2,0,2031,19476,21507
2015-07-22 23:00:00-04:00,0,7,23,2,0,2255,18203,20458
2015-07-23 00:00:00-04:00,0,7,0,3,0,2458,14954,17412
2015-07-23 01:00:00-04:00,0,7,1,3,0,2594,18201,20795
2015-07-23 02:00:00-04:00,0,7,2,3,0,3090,22154,25244
2015-07-23 03:00:00-04:00,0,7,3,3,0,2990,23630,26620
2015-07-23 04:00:00-04:00,0,7,4,3,0,2620,23594,26214
2015-07-23 05:00:00-04:00,0,7,5,3,0,2807,25109,27916
2015-07-23 06:00:00-04:00,0,7,6,3,0,2673,24636,27309
2015-07-23 07:00:00-04:00,0,7,7,3,0,2449,20851,23300
2015-07-23 08:00:00-04:00,0,7,8,3,0,1972,14685,16657
2015-07-23 09:00:00-04:00,0,7,9,3,0,1399,8874,10273
2015-07-23 10:00:00-04:00,0,7,10,3,0,843,5702,6545
2015-07-23 11:00:00-04:00,0,7,11,3,0,562,3579,4141
2015-07-23 12:00:00-04:00,0,7,12,3,0,524,3129,3653
2015-07-23 13:00:00-04:00,0,7,13,3,0,512,4328,4840
2015-07-23 14:00:00-04:00,0,7,14,3,0,789,11167,11956
2015-07-23 15:00:00-04:00,0,7,15,3,0,1433,17645,19078
2015-07-23 16:00:00-04:00,0,7,16,3,0,2306,21479,23785
2015-07-23 17:00:00-04:00,0,7,17,3,0,2235,20337,22572
2015-07-23 18:00:00-04:00,0,7,18,3,0,1969,18465,20434
2015-07-23 19:00:00-04:00,0,7,19,3,0,1849,18297,20146
2015-07-23 20:00:00-04:00,0,7,20,3,0,1813,19864,21677
2015-07-23 21:00:00-04:00,0,7,21,3,0,1837,19180,21017
2015-07-23 22:00:00-04:00,0,7,22,3,0,2109,19606,21715
2015-07-23 23:00:00-04:00,0,7,23,3,0,2255,17984,20239
2015-07-24 00:00:00-04:00,0,7,0,4,0,2509,14713,17222
2015-07-24 01:00:00-04:00,0,7,1,4,0,2722,18246,20968
2015-07-24 02:00:00-04:00,0,7,2,4,0,3262,22621,25883
2015-07-24 03:00:00-04:00,0,7,3,4,0,3201,25562,28763
2015-07-24 04:00:00-04:00,0,7,4,4,0,2859,24492,27351
2015-07-24 05:00:00-04:00,0,7,5,4,0,3046,25714,28760
2015-07-24 06:00:00-04:00,0,7,6,4,0,2930,25098,28028
2015-07-24 07:00:00-04:00,0,7,7,4,0,2742,23335,26077
2015-07-24 08:00:00-04:00,0,7,8,4,0,2345,19165,21510
2015-07-24 09:00:00-04:00,0,7,9,4,0,1772,12748,14520
2015-07-24 10:00:00-04:00,0,7,10,4,0,1211,8326,9537
2015-07-24 11:00:00-04:00,0,7,11,4,0,819,5492,6311
2015-07-24 12:00:00-04:00,0,7,12,4,0,698,4343,5041
2015-07-24 13:00:00-04:00,0,7,13,4,0,525,4894,5419
2015-07-24 14:00:00-04:00,0,7,14,4,0,798,10579,11377
2015-07-24 15:00:00-04:00,0,7,15,4,0,1443,16357,17800
2015-07-24 16:00:00-04:00,0,7,16,4,0,2406,20601,23007
2015-07-24 17:00:00-04:00,0,7,17,4,0,2272,19420,21692
2015-07-24 18:00:00-04:00,0,7,18,4,0,1932,17016,18948
2015-07-24 19:00:00-04:00,0,7,19,4,0,1913,17177,19090
2015-07-24 20:00:00-04:00,0,7,20,4,0,1737,18089,19826
2015-07-24 21:00:00-04:00,0,7,21,4,0,1693,18065,19758
2015-07-24 22:00:00-04:00,0,7,22,4,0,2129,18542,20671
2015-07-24 23:00:00-04:00,0,7,23,4,0,2600,17408,20008
2015-07-25 00:00:00-04:00,0,7,0,5,0,2859,15097,17956
2015-07-25 01:00:00-04:00,0,7,1,5,0,3187,19130,22317
2015-07-25 02:00:00-04:00,0,7,2,5,0,3806,23303,27109
2015-07-25 03:00:00-04:00,0,7,3,5,0,3856,24741,28597
2015-07-25 04:00:00-04:00,0,7,4,5,0,3494,22771,26265
2015-07-25 05:00:00-04:00,0,7,5,5,0,3794,22412,26206
2015-07-25 06:00:00-04:00,0,7,6,5,0,3835,23835,27670
2015-07-25 07:00:00-04:00,0,7,7,5,0,4166,24367,28533
2015-07-25 08:00:00-04:00,0,7,8,5,0,4069,22843,26912
2015-07-25 09:00:00-04:00,0,7,9,5,0,3649,19817,23466
2015-07-25 10:00:00-04:00,0,7,10,5,0,3113,16811,19924
2015-07-25 11:00:00-04:00,0,7,11,5,0,2542,12855,15397
2015-07-25 12:00:00-04:00,0,7,12,5,0,1893,7934,9827
2015-07-25 13:00:00-04:00,0,7,13,5,0,1018,4139,5157
2015-07-25 14:00:00-04:00,0,7,14,5,0,785,5218,6003
2015-07-25 15:00:00-04:00,0,7,15,5,0,930,6861,7791
2015-07-25 16:00:00-04:00,0,7,16,5,0,1235,9310,10545
2015-07-25 17:00:00-04:00,0,7,17,5,0,1536,13233,14769
2015-07-25 18:00:00-04:00,0,7,18,5,0,1828,15262,17090
2015-07-25 19:00:00-04:00,0,7,19,5,0,1999,17405,19404
2015-07-25 20:00:00-04:00,0,7,20,5,0,2184,18018,20202
2015-07-25 21:00:00-04:00,0,7,21,5,0,2380,18443,20823
2015-07-25 22:00:00-04:00,0,7,22,5,0,2796,17969,20765
2015-07-25 23:00:00-04:00,0,7,23,5,0,2973,18324,21297
2015-07-26 00:00:00-04:00,0,7,0,6,0,3169,17335,20504
2015-07-26 01:00:00-04:00,0,7,1,6,0,3268,18726,21994
2015-07-26 02:00:00-04:00,0,7,2,6,0,3696,20863,24559
2015-07-26 03:00:00-04:00,0,7,3,6,0,3989,21514,25503
2015-07-26 04:00:00-04:00,0,7,4,6,0,3814,18878,22692
2015-07-26 05:00:00-04:00,0,7,5,6,0,4085,19810,23895
2015-07-26 06:00:00-04:00,0,7,6,6,0,4654,21785,26439
2015-07-26 07:00:00-04:00,0,7,7,6,0,4767,23681,28448
2015-07-26 08:00:00-04:00,0,7,8,6,0,4450,21453,25903
2015-07-26 09:00:00-04:00,0,7,9,6,0,4084,19250,23334
2015-07-26 10:00:00-04:00,0,7,10,6,0,3639,16809,20448
2015-07-26 11:00:00-04:00,0,7,11,6,0,2850,13107,15957
2015-07-26 12:00:00-04:00,0,7,12,6,0,1961,8302,10263
2015-07-26 13:00:00-04:00,0,7,13,6,0,1071,3869,4940
2015-07-26 14:00:00-04:00,0,7,14,6,0,702,3928,4630
2015-07-26 15:00:00-04:00,0,7,15,6,0,698,5009,5707
2015-07-26 16:00:00-04:00,0.05,7,16,6,0,850,6841,7691
2015-07-26 17:00:00-04:00,0,7,17,6,0,1170,10400,11570
2015-07-26 18:00:00-04:00,0,7,18,6,0,1572,13839,15411
2015-07-26 19:00:00-04:00,0,7,19,6,0,1835,16725,18560
2015-07-26 20:00:00-04:00,0,7,20,6,0,2034,17618,19652
2015-07-26 21:00:00-04:00,0,7,21,6,0,2204,18501,20705
2015-07-26 22:00:00-04:00,0,7,22,6,0,2450,19080,21530
2015-07-26 23:00:00-04:00,0,7,23,6,0,2654,19243,21897
2015-07-27 00:00:00-04:00,0,7,0,0,0,2769,17371,20140
2015-07-27 01:00:00-04:00,0,7,1,0,0,2772,18234,21006
2015-07-27 02:00:00-04:00,0,7,2,0,0,3013,19612,22625
2015-07-27 03:00:00-04:00,0,7,3,0,0,2875,19115,21990
2015-07-27 04:00:00-04:00,0,7,4,0,0,2599,16732,19331
2015-07-27 05:00:00-04:00,0,7,5,0,0,2688,16788,19476
2015-07-27 06:00:00-04:00,0,7,6,0,0,2578,15428,18006
2015-07-27 07:00:00-04:00,0,7,7,0,0,2251,12283,14534
2015-07-27 08:00:00-04:00,0,7,8,0,0,1796,8259,10055
2015-07-27 09:00:00-04:00,0,7,9,0,0,1100,4730,5830
2015-07-27 10:00:00-04:00,0,7,10,0,0,793,3130,3923
2015-07-27 11:00:00-04:00,0,7,11,0,0,577,2323,2900
2015-07-27 12:00:00-04:00,0,7,12,0,0,569,2446,3015
2015-07-27 13:00:00-04:00,0,7,13,0,0,514,4123,4637
2015-07-27 14:00:00-04:00,0,7,14,0,0,722,10515,11237
2015-07-27 15:00:00-04:00,0,7,15,0,0,1390,16133,17523
2015-07-27 16:00:00-04:00,0,7,16,0,0,2218,19359,21577
2015-07-27 17:00:00-04:00,0,7,17,0,0,2141,18562,20703
2015-07-27 18:00:00-04:00,0,7,18,0,0,1753,16418,18171
2015-07-27 19:00:00-04:00,0,7,19,0,0,1665,16746,18411
2015-07-27 20:00:00-04:00,0,7,20,0,0,1600,17392,18992
2015-07-27 21:00:00-04:00,0,7,21,0,0,1615,17472,19087
2015-07-27 22:00:00-04:00,0,7,22,0,0,1842,17850,19692
2015-07-27 23:00:00-04:00,0,7,23,0,0,2017,17563,19580
2015-07-28 00:00:00-04:00,0,7,0,1,0,2183,15959,18142
2015-07-28 01:00:00-04:00,0,7,1,1,0,2439,18596,21035
2015-07-28 02:00:00-04:00,0,7,2,1,0,2589,22165,24754
2015-07-28 03:00:00-04:00,0,7,3,1,0,2453,22797,25250
2015-07-28 04:00:00-04:00,0,7,4,1,0,2234,20875,23109
2015-07-28 05:00:00-04:00,0,7,5,1,0,2080,20547,22627
2015-07-28 06:00:00-04:00,0,7,6,1,0,1831,19344,21175
2015-07-28 07:00:00-04:00,0,7,7,1,0,1700,15325,17025
2015-07-28 08:00:00-04:00,0,7,8,1,0,1290,9406,10696
2015-07-28 09:00:00-04:00,0,7,9,1,0,912,5702,6614
2015-07-28 10:00:00-04:00,0,7,10,1,0,634,3384,4018
2015-07-28 11:00:00-04:00,0,7,11,1,0,432,2292,2724
2015-07-28 12:00:00-04:00,0,7,12,1,0,400,2446,2846
2015-07-28 13:00:00-04:00,0,7,13,1,0,392,4001,4393
2015-07-28 14:00:00-04:00,0,7,14,1,0,753,11157,11910
2015-07-28 15:00:00-04:00,0,7,15,1,0,1414,17858,19272
2015-07-28 16:00:00-04:00,0,7,16,1,0,2288,21201,23489
2015-07-28 17:00:00-04:00,0,7,17,1,0,2183,19757,21940
2015-07-28 18:00:00-04:00,0,7,18,1,0,1917,18094,20011
2015-07-28 19:00:00-04:00,0,7,19,1,0,1787,18172,19959
2015-07-28 20:00:00-04:00,0,7,20,1,0,1752,19081,20833
2015-07-28 21:00:00-04:00,0,7,21,1,0,1775,19158,20933
2015-07-28 22:00:00-04:00,0,7,22,1,0,2018,19805,21823
2015-07-28 23:00:00-04:00,0,7,23,1,0,2221,18494,20715
2015-07-29 00:00:00-04:00,0,7,0,2,0,2401,16082,18483
2015-07-29 01:00:00-04:00,0,7,1,2,0,2538,19079,21617
2015-07-29 02:00:00-04:00,0,7,2,2,0,2893,23372,26265
2015-07-29 03:00:00-04:00,0,7,3,2,0,2793,25225,28018
2015-07-29 04:00:00-04:00,0,7,4,2,0,2496,23769,26265
2015-07-29 05:00:00-04:00,0,7,5,2,0,2510,25077,27587
2015-07-29 06:00:00-04:00,0,7,6,2,0,2280,23391,25671
2015-07-29 07:00:00-04:00,0,7,7,2,0,2118,18231,20349
2015-07-29 08:00:00-04:00,0,7,8,2,0,1616,11987,13603
2015-07-29 09:00:00-04:00,0,7,9,2,0,1036,6765,7801
2015-07-29 10:00:00-04:00,0,7,10,2,0,709,4240,4949
2015-07-29 11:00:00-04:00,0,7,11,2,0,458,2846,3304
2015-07-29 12:00:00-04:00,0,7,12,2,0,462,2712,3174
2015-07-29 13:00:00-04:00,0,7,13,2,0,412,4084,4496
2015-07-29 14:00:00-04:00,0,7,14,2,0,714,10957,11671
2015-07-29 15:00:00-04:00,0,7,15,2,0,1417,18261,19678
2015-07-29 16:00:00-04:00,0,7,16,2,0,2375,21708,24083
2015-07-29 17:00:00-04:00,0,7,17,2,0,2375,20638,23013
2015-07-29 18:00:00-04:00,0,7,18,2,0,2020,18870,20890
2015-07-29 19:00:00-04:00,0,7,19,2,0,1924,18956,20880
2015-07-29 20:00:00-04:00,0,7,20,2,0,1819,19736,21555
2015-07-29 21:00:00-04:00,0,7,21,2,0,1764,19327,21091
2015-07-29 22:00:00-04:00,0,7,22,2,0,1980,19865,21845
2015-07-29 23:00:00-04:00,0,7,23,2,0,2264,18783,21047
2015-07-30 00:00:00-04:00,0,7,0,3,0,2460,16256,18716
2015-07-30 01:00:00-04:00,0,7,1,3,0,2738,19794,22532
2015-07-30 02:00:00-04:00,0,7,2,3,0,3230,25159,28389
2015-07-30 03:00:00-04:00,0,7,3,3,0,3318,28064,31382
2015-07-30 04:00:00-04:00,0,7,4,3,0,2869,26147,29016
2015-07-30 05:00:00-04:00,0,7,5,3,0,2858,26158,29016
2015-07-30 06:00:00-04:00,0,7,6,3,0,2627,24402,27029
2015-07-30 07:00:00-04:00,0,7,7,3,0,2375,20208,22583
2015-07-30 08:00:00-04:00,0,7,8,3,0,1859,13916,15775
2015-07-30 09:00:00-04:00,0.01,7,9,3,0,1374,8239,9613
2015-07-30 10:00:00-04:00,0,7,10,3,0,905,5305,6210
2015-07-30 11:00:00-04:00,0,7,11,3,0,615,3370,3985
2015-07-30 12:00:00-04:00,0,7,12,3,0,565,3045,3610
2015-07-30 13:00:00-04:00,0.05,7,13,3,0,467,4417,4884
2015-07-30 14:00:00-04:00,0.71,7,14,3,0,765,11306,12071
2015-07-30 15:00:00-04:00,0.57,7,15,3,0,1525,18678,20203
2015-07-30 16:00:00-04:00,0.19,7,16,3,0,2549,22191,24740
2015-07-30 17:00:00-04:00,0.09,7,17,3,0,2406,20552,22958
2015-07-30 18:00:00-04:00,0,7,18,3,0,2039,18566,20605
2015-07-30 19:00:00-04:00,0,7,19,3,0,1855,18516,20371
2015-07-30 20:00:00-04:00,0,7,20,3,0,1988,20661,22649
2015-07-30 21:00:00-04:00,0,7,21,3,0,2050,20904,22954
2015-07-30 22:00:00-04:00,0,7,22,3,0,2514,20154,22668
2015-07-30 23:00:00-04:00,0,7,23,3,0,2422,15720,18142
2015-07-31 00:00:00-04:00,0,7,0,4,0,3384,12754,16138
2015-07-31 01:00:00-04:00,0,7,1,4,0,3116,14921,18037
2015-07-31 02:00:00-04:00,0,7,2,4,0,3151,20215,23366
2015-07-31 03:00:00-04:00,0,7,3,4,0,3049,23443,26492
2015-07-31 04:00:00-04:00,0,7,4,4,0,2838,23291,26129
2015-07-31 05:00:00-04:00,0,7,5,4,0,2744,24790,27534
2015-07-31 06:00:00-04:00,0,7,6,4,0,2558,24308,26866
2015-07-31 07:00:00-04:00,0,7,7,4,0,2497,21582,24079
2015-07-31 08:00:00-04:00,0,7,8,4,0,2187,17974,20161
2015-07-31 09:00:00-04:00,0,7,9,4,0,1512,11325,12837
2015-07-31 10:00:00-04:00,0,7,10,4,0,1123,7942,9065
2015-07-31 11:00:00-04:00,0,7,11,4,0,784,5067,5851
2015-07-31 12:00:00-04:00,0,7,12,4,0,672,4303,4975
2015-07-31 13:00:00-04:00,0,7,13,4,0,553,4861,5414
2015-07-31 14:00:00-04:00,0,7,14,4,0,776,10464,11240
2015-07-31 15:00:00-04:00,0,7,15,4,0,1450,16271,17721
2015-07-31 16:00:00-04:00,0,7,16,4,0,2412,20235,22647
2015-07-31 17:00:00-04:00,0,7,17,4,0,2459,19267,21726
2015-07-31 18:00:00-04:00,0,7,18,4,0,2173,17627,19800
2015-07-31 19:00:00-04:00,0,7,19,4,0,2038,17565,19603
2015-07-31 20:00:00-04:00,0,7,20,4,0,2038,17873,19911
2015-07-31 21:00:00-04:00,0,7,21,4,0,1891,18057,19948
2015-07-31 22:00:00-04:00,0,7,22,4,0,2332,18235,20567
2015-07-31 23:00:00-04:00,0,7,23,4,0,2810,16722,19532
2015-08-01 00:00:00-04:00,0,8,0,5,0,3115,14194,17309
2015-08-01 01:00:00-04:00,0,8,1,5,0,3452,17644,21096
2015-08-01 02:00:00-04:00,0,8,2,5,0,3914,22825,26739
2015-08-01 03:00:00-04:00,0,8,3,5,0,4127,25220,29347
2015-08-01 04:00:00-04:00,0,8,4,5,0,3885,23046,26931
2015-08-01 05:00:00-04:00,0,8,5,5,0,3984,23100,27084
2015-08-01 06:00:00-04:00,0,8,6,5,0,4111,23666,27777
2015-08-01 07:00:00-04:00,0,8,7,5,0,4353,24332,28685
2015-08-01 08:00:00-04:00,0,8,8,5,0,4165,22510,26675
2015-08-01 09:00:00-04:00,0,8,9,5,0,3851,20092,23943
2015-08-01 10:00:00-04:00,0,8,10,5,0,3220,16932,20152
2015-08-01 11:00:00-04:00,0,8,11,5,0,2547,12719,15266
2015-08-01 12:00:00-04:00,0,8,12,5,0,1863,8044,9907
2015-08-01 13:00:00-04:00,0,8,13,5,0,1062,4297,5359
2015-08-01 14:00:00-04:00,0,8,14,5,0,817,5052,5869
2015-08-01 15:00:00-04:00,0,8,15,5,0,944,6820,7764
2015-08-01 16:00:00-04:00,0,8,16,5,0,1242,9542,10784
2015-08-01 17:00:00-04:00,0,8,17,5,0,1708,13338,15046
2015-08-01 18:00:00-04:00,0,8,18,5,0,2009,15528,17537
2015-08-01 19:00:00-04:00,0,8,19,5,0,2211,16888,19099
2015-08-01 20:00:00-04:00,0,8,20,5,0,2389,17921,20310
2015-08-01 21:00:00-04:00,0,8,21,5,0,2391,19166,21557
2015-08-01 22:00:00-04:00,0,8,22,5,0,2733,18230,20963
2015-08-01 23:00:00-04:00,0,8,23,5,0,3100,18450,21550
2015-08-02 00:00:00-04:00,0,8,0,6,0,3250,17791,21041
2015-08-02 01:00:00-04:00,0,8,1,6,0,3317,19737,23054
2015-08-02 02:00:00-04:00,0,8,2,6,0,3720,21601,25321
2015-08-02 03:00:00-04:00,0,8,3,6,0,4075,22187,26262
2015-08-02 04:00:00-04:00,0,8,4,6,0,3979,19784,23763
2015-08-02 05:00:00-04:00,0,8,5,6,0,4136,20085,24221
2015-08-02 06:00:00-04:00,0,8,6,6,0,4419,21110,25529
2015-08-02 07:00:00-04:00,0,8,7,6,0,4554,21904,26458
2015-08-02 08:00:00-04:00,0,8,8,6,0,4459,20994,25453
2015-08-02 09:00:00-04:00,0,8,9,6,0,4227,19192,23419
2015-08-02 10:00:00-04:00,0,8,10,6,0,3527,16456,19983
2015-08-02 11:00:00-04:00,0,8,11,6,0,2783,12445,15228
2015-08-02 12:00:00-04:00,0,8,12,6,0,2140,8100,10240
2015-08-02 13:00:00-04:00,0,8,13,6,0,1117,3876,4993
2015-08-02 14:00:00-04:00,0,8,14,6,0,678,3941,4619
2015-08-02 15:00:00-04:00,0,8,15,6,0,712,5348,6060
2015-08-02 16:00:00-04:00,0,8,16,6,0,922,8307,9229
2015-08-02 17:00:00-04:00,0,8,17,6,0,1308,10798,12106
2015-08-02 18:00:00-04:00,0,8,18,6,0,1613,14013,15626
2015-08-02 19:00:00-04:00,0,8,19,6,0,1956,16396,18352
2015-08-02 20:00:00-04:00,0,8,20,6,0,2076,17325,19401
2015-08-02 21:00:00-04:00,0,8,21,6,0,2143,17970,20113
2015-08-02 22:00:00-04:00,0,8,22,6,0,2377,18554,20931
2015-08-02 23:00:00-04:00,0,8,23,6,0,2665,17697,20362
2015-08-03 00:00:00-04:00,0,8,0,0,0,2773,17413,20186
2015-08-03 01:00:00-04:00,0,8,1,0,0,2834,18438,21272
2015-08-03 02:00:00-04:00,0,8,2,0,0,3002,19558,22560
2015-08-03 03:00:00-04:00,0,8,3,0,0,2917,18283,21200
2015-08-03 04:00:00-04:00,0,8,4,0,0,2689,17434,20123
2015-08-03 05:00:00-04:00,0,8,5,0,0,2816,17165,19981
2015-08-03 06:00:00-04:00,0,8,6,0,0,2601,15763,18364
2015-08-03 07:00:00-04:00,0,8,7,0,0,2365,13075,15440
2015-08-03 08:00:00-04:00,0,8,8,0,0,1761,8357,10118
2015-08-03 09:00:00-04:00,0,8,9,0,0,1120,4838,5958
2015-08-03 10:00:00-04:00,0,8,10,0,0,768,3102,3870
2015-08-03 11:00:00-04:00,0,8,11,0,0,594,2229,2823
2015-08-03 12:00:00-04:00,0,8,12,0,0,561,2509,3070
2015-08-03 13:00:00-04:00,0,8,13,0,0,569,4350,4919
2015-08-03 14:00:00-04:00,0,8,14,0,0,771,10223,10994
2015-08-03 15:00:00-04:00,0,8,15,0,0,1415,15945,17360
2015-08-03 16:00:00-04:00,0,8,16,0,0,2274,19823,22097
2015-08-03 17:00:00-04:00,0,8,17,0,0,2280,18710,20990
2015-08-03 18:00:00-04:00,0,8,18,0,0,1924,16792,18716
2015-08-03 19:00:00-04:00,0,8,19,0,0,1780,16067,17847
2015-08-03 20:00:00-04:00,0,8,20,0,0,1833,17120,18953
2015-08-03 21:00:00-04:00,0,8,21,0,0,1822,17386,19208
2015-08-03 22:00:00-04:00,0,8,22,0,0,1959,18215,20174
2015-08-03 23:00:00-04:00,0,8,23,0,0,2199,17966,20165
2015-08-04 00:00:00-04:00,0,8,0,1,0,2352,16303,18655
2015-08-04 01:00:00-04:00,0,8,1,1,0,2494,18784,21278
2015-08-04 02:00:00-04:00,0,8,2,1,0,2741,22880,25621
2015-08-04 03:00:00-04:00,0,8,3,1,0,2595,22826,25421
2015-08-04 04:00:00-04:00,0.24,8,4,1,0,2301,21396,23697
2015-08-04 05:00:00-04:00,0.06,8,5,1,0,2098,21126,23224
2015-08-04 06:00:00-04:00,0,8,6,1,0,1922,18273,20195
2015-08-04 07:00:00-04:00,0,8,7,1,0,1626,13599,15225
2015-08-04 08:00:00-04:00,0,8,8,1,0,1325,9089,10414
2015-08-04 09:00:00-04:00,0,8,9,1,0,870,5520,6390
2015-08-04 10:00:00-04:00,0,8,10,1,0,579,3512,4091
2015-08-04 11:00:00-04:00,0,8,11,1,0,437,2499,2936
2015-08-04 12:00:00-04:00,0,8,12,1,0,452,2522,2974
2015-08-04 13:00:00-04:00,0,8,13,1,0,394,4077,4471
2015-08-04 14:00:00-04:00,0,8,14,1,0,720,10754,11474
2015-08-04 15:00:00-04:00,0,8,15,1,0,1342,16874,18216
2015-08-04 16:00:00-04:00,0,8,16,1,0,2163,21022,23185
2015-08-04 17:00:00-04:00,0,8,17,1,0,2283,20239,22522
2015-08-04 18:00:00-04:00,0,8,18,1,0,1967,18158,20125
2015-08-04 19:00:00-04:00,0,8,19,1,0,1811,17566,19377
2015-08-04 20:00:00-04:00,0,8,20,1,0,1885,18686,20571
2015-08-04 21:00:00-04:00,0,8,21,1,0,1738,18871,20609
2015-08-04 22:00:00-04:00,0,8,22,1,0,1970,19592,21562
2015-08-04 23:00:00-04:00,0,8,23,1,0,2167,18342,20509
2015-08-05 00:00:00-04:00,0,8,0,2,0,2239,15263,17502
2015-08-05 01:00:00-04:00,0,8,1,2,0,2591,18474,21065
2015-08-05 02:00:00-04:00,0,8,2,2,0,2933,23553,26486
2015-08-05 03:00:00-04:00,0,8,3,2,0,2911,23918,26829
2015-08-05 04:00:00-04:00,0,8,4,2,0,2492,23203,25695
2015-08-05 05:00:00-04:00,0,8,5,2,0,2393,23909,26302
2015-08-05 06:00:00-04:00,0,8,6,2,0,2509,22805,25314
2015-08-05 07:00:00-04:00,0,8,7,2,0,2082,18017,20099
2015-08-05 08:00:00-04:00,0,8,8,2,0,1591,12306,13897
2015-08-05 09:00:00-04:00,0,8,9,2,0,1190,7239,8429
2015-08-05 10:00:00-04:00,0,8,10,2,0,687,4343,5030
2015-08-05 11:00:00-04:00,0,8,11,2,0,453,3014,3467
2015-08-05 12:00:00-04:00,0,8,12,2,0,414,2703,3117
2015-08-05 13:00:00-04:00,0,8,13,2,0,395,4160,4555
2015-08-05 14:00:00-04:00,0,8,14,2,0,725,10773,11498
2015-08-05 15:00:00-04:00,0,8,15,2,0,1408,17340,18748
2015-08-05 16:00:00-04:00,0,8,16,2,0,2280,21214,23494
2015-08-05 17:00:00-04:00,0,8,17,2,0,2297,19937,22234
2015-08-05 18:00:00-04:00,0,8,18,2,0,1941,19014,20955
2015-08-05 19:00:00-04:00,0,8,19,2,0,1857,18431,20288
2015-08-05 20:00:00-04:00,0,8,20,2,0,1743,19020,20763
2015-08-05 21:00:00-04:00,0,8,21,2,0,1758,18974,20732
2015-08-05 22:00:00-04:00,0,8,22,2,0,1858,19138,20996
2015-08-05 23:00:00-04:00,0,8,23,2,0,2142,17759,19901
2015-08-06 00:00:00-04:00,0,8,0,3,0,2344,15101,17445
2015-08-06 01:00:00-04:00,0,8,1,3,0,2658,19350,22008
2015-08-06 02:00:00-04:00,0,8,2,3,0,3055,23386,26441
2015-08-06 03:00:00-04:00,0,8,3,3,0,2964,24907,27871
2015-08-06 04:00:00-04:00,0,8,4,3,0,2577,24691,27268
2015-08-06 05:00:00-04:00,0,8,5,3,0,2553,25029,27582
2015-08-06 06:00:00-04:00,0,8,6,3,0,2555,24018,26573
2015-08-06 07:00:00-04:00,0,8,7,3,0,2313,19795,22108
2015-08-06 08:00:00-04:00,0,8,8,3,0,1770,13604,15374
2015-08-06 09:00:00-04:00,0,8,9,3,0,1234,7877,9111
2015-08-06 10:00:00-04:00,0,8,10,3,0,838,5030,5868
2015-08-06 11:00:00-04:00,0,8,11,3,0,614,3295,3909
2015-08-06 12:00:00-04:00,0,8,12,3,0,535,2911,3446
2015-08-06 13:00:00-04:00,0,8,13,3,0,437,3994,4431
2015-08-06 14:00:00-04:00,0,8,14,3,0,795,10575,11370
2015-08-06 15:00:00-04:00,0,8,15,3,0,1434,16947,18381
2015-08-06 16:00:00-04:00,0,8,16,3,0,2279,20855,23134
2015-08-06 17:00:00-04:00,0,8,17,3,0,2235,19573,21808
2015-08-06 18:00:00-04:00,0,8,18,3,0,1891,17634,19525
2015-08-06 19:00:00-04:00,0,8,19,3,0,1758,17650,19408
2015-08-06 20:00:00-04:00,0,8,20,3,0,1780,18504,20284
2015-08-06 21:00:00-04:00,0,8,21,3,0,1827,18388,20215
2015-08-06 22:00:00-04:00,0,8,22,3,0,1988,18465,20453
2015-08-06 23:00:00-04:00,0,8,23,3,0,2332,17458,19790
2015-08-07 00:00:00-04:00,0,8,0,4,0,2411,14598,17009
2015-08-07 01:00:00-04:00,0,8,1,4,0,2742,18190,20932
2015-08-07 02:00:00-04:00,0,8,2,4,0,3209,23327,26536
2015-08-07 03:00:00-04:00,0,8,3,4,0,3062,25234,28296
2015-08-07 04:00:00-04:00,0,8,4,4,0,3020,25510,28530
2015-08-07 05:00:00-04:00,0,8,5,4,0,2927,25101,28028
2015-08-07 06:00:00-04:00,0,8,6,4,0,2962,24061,27023
2015-08-07 07:00:00-04:00,0,8,7,4,0,2697,22221,24918
2015-08-07 08:00:00-04:00,0,8,8,4,0,2185,17397,19582
2015-08-07 09:00:00-04:00,0,8,9,4,0,1595,12058,13653
2015-08-07 10:00:00-04:00,0,8,10,4,0,1145,7929,9074
2015-08-07 11:00:00-04:00,0,8,11,4,0,753,5301,6054
2015-08-07 12:00:00-04:00,0,8,12,4,0,626,4148,4774
2015-08-07 13:00:00-04:00,0,8,13,4,0,507,4575,5082
2015-08-07 14:00:00-04:00,0,8,14,4,0,787,9940,10727
2015-08-07 15:00:00-04:00,0,8,15,4,0,1371,15432,16803
2015-08-07 16:00:00-04:00,0,8,16,4,0,2331,19080,21411
2015-08-07 17:00:00-04:00,0,8,17,4,0,2267,18340,20607
2015-08-07 18:00:00-04:00,0,8,18,4,0,1935,16377,18312
2015-08-07 19:00:00-04:00,0,8,19,4,0,1848,16675,18523
2015-08-07 20:00:00-04:00,0,8,20,4,0,1731,17424,19155
2015-08-07 21:00:00-04:00,0,8,21,4,0,1773,17559,19332
2015-08-07 22:00:00-04:00,0,8,22,4,0,2002,17864,19866
2015-08-07 23:00:00-04:00,0,8,23,4,0,2446,16824,19270
2015-08-08 00:00:00-04:00,0,8,0,5,0,2741,14577,17318
2015-08-08 01:00:00-04:00,0,8,1,5,0,3115,18052,21167
2015-08-08 02:00:00-04:00,0,8,2,5,0,3605,22943,26548
2015-08-08 03:00:00-04:00,0,8,3,5,0,3689,23706,27395
2015-08-08 04:00:00-04:00,0,8,4,5,0,3603,21930,25533
2015-08-08 05:00:00-04:00,0,8,5,5,0,3736,22205,25941
2015-08-08 06:00:00-04:00,0,8,6,5,0,3904,23319,27223
2015-08-08 07:00:00-04:00,0,8,7,5,0,4081,23275,27356
2015-08-08 08:00:00-04:00,0,8,8,5,0,4133,22449,26582
2015-08-08 09:00:00-04:00,0,8,9,5,0,3618,18605,22223
2015-08-08 10:00:00-04:00,0,8,10,5,0,3133,15823,18956
2015-08-08 11:00:00-04:00,0,8,11,5,0,2460,11778,14238
2015-08-08 12:00:00-04:00,0,8,12,5,0,1910,7581,9491
2015-08-08 13:00:00-04:00,0,8,13,5,0,967,3963,4930
2015-08-08 14:00:00-04:00,0,8,14,5,0,796,4746,5542
2015-08-08 15:00:00-04:00,0,8,15,5,0,900,6422,7322
2015-08-08 16:00:00-04:00,0,8,16,5,0,1221,8467,9688
2015-08-08 17:00:00-04:00,0,8,17,5,0,1672,12027,13699
2015-08-08 18:00:00-04:00,0,8,18,5,0,1981,15132,17113
2015-08-08 19:00:00-04:00,0,8,19,5,0,2127,15970,18097
2015-08-08 20:00:00-04:00,0,8,20,5,0,2151,16227,18378
2015-08-08 21:00:00-04:00,0,8,21,5,0,2219,16641,18860
2015-08-08 22:00:00-04:00,0,8,22,5,0,2583,16457,19040
2015-08-08 23:00:00-04:00,0,8,23,5,0,2852,16595,19447
2015-08-09 00:00:00-04:00,0,8,0,6,0,3115,16769,19884
2015-08-09 01:00:00-04:00,0,8,1,6,0,3267,18469,21736
2015-08-09 02:00:00-04:00,0,8,2,6,0,3604,19755,23359
2015-08-09 03:00:00-04:00,0,8,3,6,0,3772,20541,24313
2015-08-09 04:00:00-04:00,0,8,4,6,0,3620,18197,21817
2015-08-09 05:00:00-04:00,0,8,5,6,0,4002,19061,23063
2015-08-09 06:00:00-04:00,0,8,6,6,0,4266,20420,24686
2015-08-09 07:00:00-04:00,0,8,7,6,0,4458,21454,25912
2015-08-09 08:00:00-04:00,0,8,8,6,0,4382,20228,24610
2015-08-09 09:00:00-04:00,0,8,9,6,0,3813,18148,21961
2015-08-09 10:00:00-04:00,0,8,10,6,0,3436,15502,18938
2015-08-09 11:00:00-04:00,0,8,11,6,0,2721,11873,14594
2015-08-09 12:00:00-04:00,0,8,12,6,0,2002,7775,9777
2015-08-09 13:00:00-04:00,0,8,13,6,0,1044,3844,4888
2015-08-09 14:00:00-04:00,0,8,14,6,0,717,3967,4684
2015-08-09 15:00:00-04:00,0,8,15,6,0,634,4810,5444
2015-08-09 16:00:00-04:00,0,8,16,6,0,852,6487,7339
2015-08-09 17:00:00-04:00,0,8,17,6,0,1251,9394,10645
2015-08-09 18:00:00-04:00,0,8,18,6,0,1563,12777,14340
2015-08-09 19:00:00-04:00,0,8,19,6,0,1830,14820,16650
2015-08-09 20:00:00-04:00,0,8,20,6,0,1892,15439,17331
2015-08-09 21:00:00-04:00,0,8,21,6,0,2134,15918,18052
2015-08-09 22:00:00-04:00,0,8,22,6,0,2340,15780,18120
2015-08-09 23:00:00-04:00,0,8,23,6,0,2604,15608,18212
2015-08-10 00:00:00-04:00,0,8,0,0,0,2736,15529,18265
2015-08-10 01:00:00-04:00,0,8,1,0,0,2703,16398,19101
2015-08-10 02:00:00-04:00,0,8,2,0,0,2844,17363,20207
2015-08-10 03:00:00-04:00,0,8,3,0,0,2823,16727,19550
2015-08-10 04:00:00-04:00,0,8,4,0,0,2709,16180,18889
2015-08-10 05:00:00-04:00,0,8,5,0,0,2652,16564,19216
2015-08-10 06:00:00-04:00,0,8,6,0,0,2431,14447,16878
2015-08-10 07:00:00-04:00,0,8,7,0,0,2196,12037,14233
2015-08-10 08:00:00-04:00,0,8,8,0,0,1653,7567,9220
2015-08-10 09:00:00-04:00,0,8,9,0,0,1154,4488,5642
2015-08-10 10:00:00-04:00,0,8,10,0,0,720,2996,3716
2015-08-10 11:00:00-04:00,0,8,11,0,0,583,2099,2682
2015-08-10 12:00:00-04:00,0,8,12,0,0,565,2308,2873
2015-08-10 13:00:00-04:00,0,8,13,0,0,487,3832,4319
2015-08-10 14:00:00-04:00,0,8,14,0,0,738,9903,10641
2015-08-10 15:00:00-04:00,0,8,15,0,0,1392,15204,16596
2015-08-10 16:00:00-04:00,0,8,16,0,0,2161,18264,20425
2015-08-10 17:00:00-04:00,0,8,17,0,0,2149,17245,19394
2015-08-10 18:00:00-04:00,0,8,18,0,0,1805,15109,16914
2015-08-10 19:00:00-04:00,0,8,19,0,0,1568,15342,16910
2015-08-10 20:00:00-04:00,0,8,20,0,0,1483,15681,17164
2015-08-10 21:00:00-04:00,0,8,21,0,0,1504,15974,17478
2015-08-10 22:00:00-04:00,0,8,22,0,0,1767,16694,18461
2015-08-10 23:00:00-04:00,0,8,23,0,0,1877,16415,18292
2015-08-11 00:00:00-04:00,0,8,0,1,0,2041,15072,17113
2015-08-11 01:00:00-04:00,0,8,1,1,0,2232,17433,19665
2015-08-11 02:00:00-04:00,0,8,2,1,0,2495,20974,23469
2015-08-11 03:00:00-04:00,0,8,3,1,0,2405,21304,23709
2015-08-11 04:00:00-04:00,0,8,4,1,0,2109,19669,21778
2015-08-11 05:00:00-04:00,0.05,8,5,1,0,1979,18731,20710
2015-08-11 06:00:00-04:00,0.18,8,6,1,0,1783,16577,18360
2015-08-11 07:00:00-04:00,0.44,8,7,1,0,1578,12125,13703
2015-08-11 08:00:00-04:00,0.15,8,8,1,0,1200,8240,9440
2015-08-11 09:00:00-04:00,0.03,8,9,1,0,820,4758,5578
2015-08-11 10:00:00-04:00,0.32,8,10,1,0,497,3188,3685
2015-08-11 11:00:00-04:00,0.01,8,11,1,0,347,2219,2566
2015-08-11 12:00:00-04:00,0,8,12,1,0,364,2248,2612
2015-08-11 13:00:00-04:00,0,8,13,1,0,391,3949,4340
2015-08-11 14:00:00-04:00,0,8,14,1,0,810,11883,12693
2015-08-11 15:00:00-04:00,0,8,15,1,0,1687,18645,20332
2015-08-11 16:00:00-04:00,0,8,16,1,0,2511,20886,23397
2015-08-11 17:00:00-04:00,0,8,17,1,0,2482,19833,22315
2015-08-11 18:00:00-04:00,0,8,18,1,0,2163,18918,21081
2015-08-11 19:00:00-04:00,0,8,19,1,0,1694,16172,17866
2015-08-11 20:00:00-04:00,0,8,20,1,0,1566,16098,17664
2015-08-11 21:00:00-04:00,0,8,21,1,0,1530,16320,17850
2015-08-11 22:00:00-04:00,0,8,22,1,0,1767,17579,19346
2015-08-11 23:00:00-04:00,0,8,23,1,0,1983,16714,18697
2015-08-12 00:00:00-04:00,0,8,0,2,0,2197,15544,17741
2015-08-12 01:00:00-04:00,0,8,1,2,0,2591,18434,21025
2015-08-12 02:00:00-04:00,0,8,2,2,0,2653,22295,24948
2015-08-12 03:00:00-04:00,0,8,3,2,0,2723,22922,25645
2015-08-12 04:00:00-04:00,0,8,4,2,0,2320,21889,24209
2015-08-12 05:00:00-04:00,0,8,5,2,0,2159,22207,24366
2015-08-12 06:00:00-04:00,0,8,6,2,0,2013,20396,22409
2015-08-12 07:00:00-04:00,0,8,7,2,0,1780,15872,17652
2015-08-12 08:00:00-04:00,0,8,8,2,0,1394,10762,12156
2015-08-12 09:00:00-04:00,0,8,9,2,0,876,6406,7282
2015-08-12 10:00:00-04:00,0,8,10,2,0,632,4111,4743
2015-08-12 11:00:00-04:00,0,8,11,2,0,436,2626,3062
2015-08-12 12:00:00-04:00,0,8,12,2,0,424,2507,2931
2015-08-12 13:00:00-04:00,0,8,13,2,0,364,3801,4165
2015-08-12 14:00:00-04:00,0,8,14,2,0,671,10151,10822
2015-08-12 15:00:00-04:00,0,8,15,2,0,1357,16091,17448
2015-08-12 16:00:00-04:00,0,8,16,2,0,2125,19928,22053
2015-08-12 17:00:00-04:00,0,8,17,2,0,2144,19265,21409
2015-08-12 18:00:00-04:00,0,8,18,2,0,1874,17148,19022
2015-08-12 19:00:00-04:00,0,8,19,2,0,1671,17111,18782
2015-08-12 20:00:00-04:00,0,8,20,2,0,1715,18276,19991
2015-08-12 21:00:00-04:00,0,8,21,2,0,1654,18344,19998
2015-08-12 22:00:00-04:00,0,8,22,2,0,1875,18484,20359
2015-08-12 23:00:00-04:00,0,8,23,2,0,2096,17400,19496
2015-08-13 00:00:00-04:00,0,8,0,3,0,2377,14639,17016
2015-08-13 01:00:00-04:00,0,8,1,3,0,2692,17668,20360
2015-08-13 02:00:00-04:00,0,8,2,3,0,3103,22389,25492
2015-08-13 03:00:00-04:00,0,8,3,3,0,2917,23672,26589
2015-08-13 04:00:00-04:00,0,8,4,3,0,2691,24591,27282
2015-08-13 05:00:00-04:00,0,8,5,3,0,2718,23869,26587
2015-08-13 06:00:00-04:00,0,8,6,3,0,2699,22541,25240
2015-08-13 07:00:00-04:00,0,8,7,3,0,2477,18543,21020
2015-08-13 08:00:00-04:00,0,8,8,3,0,1971,12416,14387
2015-08-13 09:00:00-04:00,0,8,9,3,0,1357,7704,9061
2015-08-13 10:00:00-04:00,0,8,10,3,0,842,4980,5822
2015-08-13 11:00:00-04:00,0,8,11,3,0,546,3281,3827
2015-08-13 12:00:00-04:00,0,8,12,3,0,516,2795,3311
2015-08-13 13:00:00-04:00,0,8,13,3,0,420,3877,4297
2015-08-13 14:00:00-04:00,0,8,14,3,0,779,10051,10830
2015-08-13 15:00:00-04:00,0,8,15,3,0,1359,16105,17464
2015-08-13 16:00:00-04:00,0,8,16,3,0,2219,20035,22254
2015-08-13 17:00:00-04:00,0,8,17,3,0,2317,19048,21365
2015-08-13 18:00:00-04:00,0,8,18,3,0,1983,17352,19335
2015-08-13 19:00:00-04:00,0,8,19,3,0,1909,16835,18744
2015-08-13 20:00:00-04:00,0,8,20,3,0,1821,17737,19558
2015-08-13 21:00:00-04:00,0,8,21,3,0,1827,17939,19766
2015-08-13 22:00:00-04:00,0,8,22,3,0,2061,18691,20752
2015-08-13 23:00:00-04:00,0,8,23,3,0,2296,17539,19835
2015-08-14 00:00:00-04:00,0,8,0,4,0,2477,15138,17615
2015-08-14 01:00:00-04:00,0,8,1,4,0,2789,18202,20991
2015-08-14 02:00:00-04:00,0,8,2,4,0,3064,22775,25839
2015-08-14 03:00:00-04:00,0,8,3,4,0,3154,24547,27701
2015-08-14 04:00:00-04:00,0,8,4,4,0,2992,24153,27145
2015-08-14 05:00:00-04:00,0,8,5,4,0,2936,24614,27550
2015-08-14 06:00:00-04:00,0,8,6,4,0,2891,23875,26766
2015-08-14 07:00:00-04:00,0,8,7,4,0,2636,21303,23939
2015-08-14 08:00:00-04:00,0,8,8,4,0,2251,16712,18963
2015-08-14 09:00:00-04:00,0,8,9,4,0,1572,11231,12803
2015-08-14 10:00:00-04:00,0,8,10,4,0,1180,7462,8642
2015-08-14 11:00:00-04:00,0,8,11,4,0,758,4998,5756
2015-08-14 12:00:00-04:00,0,8,12,4,0,608,3805,4413
2015-08-14 13:00:00-04:00,0,8,13,4,0,463,4199,4662
2015-08-14 14:00:00-04:00,0,8,14,4,0,773,9324,10097
2015-08-14 15:00:00-04:00,0,8,15,4,0,1372,14612,15984
2015-08-14 16:00:00-04:00,0,8,16,4,0,2145,18671,20816
2015-08-14 17:00:00-04:00,0,8,17,4,0,2372,18349,20721
2015-08-14 18:00:00-04:00,0,8,18,4,0,1978,17022,19000
2015-08-14 19:00:00-04:00,0,8,19,4,0,1965,16938,18903
2015-08-14 20:00:00-04:00,0,8,20,4,0,1843,17344,19187
2015-08-14 21:00:00-04:00,0,8,21,4,0,1831,17169,19000
2015-08-14 22:00:00-04:00,0,8,22,4,0,2084,17746,19830
2015-08-14 23:00:00-04:00,0,8,23,4,0,2542,16221,18763
2015-08-15 00:00:00-04:00,0,8,0,5,0,2863,13969,16832
2015-08-15 01:00:00-04:00,0,8,1,5,0,3272,17659,20931
2015-08-15 02:00:00-04:00,0,8,2,5,0,3701,21681,25382
2015-08-15 03:00:00-04:00,0,8,3,5,0,3848,23417,27265
2015-08-15 04:00:00-04:00,0,8,4,5,0,3735,22278,26013
2015-08-15 05:00:00-04:00,0,8,5,5,0,3793,22130,25923
2015-08-15 06:00:00-04:00,0,8,6,5,0,3906,22394,26300
2015-08-15 07:00:00-04:00,0,8,7,5,0,4133,22594,26727
2015-08-15 08:00:00-04:00,0,8,8,5,0,4019,20825,24844
2015-08-15 09:00:00-04:00,0,8,9,5,0,3566,18407,21973
2015-08-15 10:00:00-04:00,0,8,10,5,0,3097,15450,18547
2015-08-15 11:00:00-04:00,0,8,11,5,0,2516,11360,13876
2015-08-15 12:00:00-04:00,0,8,12,5,0,1789,7423,9212
2015-08-15 13:00:00-04:00,0,8,13,5,0,943,3707,4650
2015-08-15 14:00:00-04:00,0,8,14,5,0,778,4939,5717
2015-08-15 15:00:00-04:00,0,8,15,5,0,836,6943,7779
2015-08-15 16:00:00-04:00,0,8,16,5,0,1191,9242,10433
2015-08-15 17:00:00-04:00,0,8,17,5,0,1576,12800,14376
2015-08-15 18:00:00-04:00,0,8,18,5,0,1798,15075,16873
2015-08-15 19:00:00-04:00,0,8,19,5,0,2108,16764,18872
2015-08-15 20:00:00-04:00,0,8,20,5,0,2289,17220,19509
2015-08-15 21:00:00-04:00,0,8,21,5,0,2360,18045,20405
2015-08-15 22:00:00-04:00,0,8,22,5,0,2646,17921,20567
2015-08-15 23:00:00-04:00,0,8,23,5,0,2943,17858,20801
2015-08-16 00:00:00-04:00,0,8,0,6,0,3273,16712,19985
2015-08-16 01:00:00-04:00,0,8,1,6,0,3343,18575,21918
2015-08-16 02:00:00-04:00,0,8,2,6,0,3667,20122,23789
2015-08-16 03:00:00-04:00,0,8,3,6,0,3820,21064,24884
2015-08-16 04:00:00-04:00,0,8,4,6,0,3823,18920,22743
2015-08-16 05:00:00-04:00,0,8,5,6,0,4045,19125,23170
2015-08-16 06:00:00-04:00,0,8,6,6,0,4278,20431,24709
2015-08-16 07:00:00-04:00,0,8,7,6,0,4550,21451,26001
2015-08-16 08:00:00-04:00,0,8,8,6,0,4476,20263,24739
2015-08-16 09:00:00-04:00,0,8,9,6,0,4001,17826,21827
2015-08-16 10:00:00-04:00,0,8,10,6,0,3466,15153,18619
2015-08-16 11:00:00-04:00,0,8,11,6,0,2775,11445,14220
2015-08-16 12:00:00-04:00,0,8,12,6,0,2038,7538,9576
2015-08-16 13:00:00-04:00,0,8,13,6,0,1083,3629,4712
2015-08-16 14:00:00-04:00,0,8,14,6,0,720,4114,4834
2015-08-16 15:00:00-04:00,0,8,15,6,0,731,5249,5980
2015-08-16 16:00:00-04:00,0,8,16,6,0,879,8034,8913
2015-08-16 17:00:00-04:00,0,8,17,6,0,1234,10384,11618
2015-08-16 18:00:00-04:00,0,8,18,6,0,1513,13485,14998
2015-08-16 19:00:00-04:00,0,8,19,6,0,1928,15557,17485
2015-08-16 20:00:00-04:00,0,8,20,6,0,2156,17124,19280
2015-08-16 21:00:00-04:00,0,8,21,6,0,2126,17783,19909
2015-08-16 22:00:00-04:00,0,8,22,6,0,2527,18134,20661
2015-08-16 23:00:00-04:00,0,8,23,6,0,2658,17176,19834
2015-08-17 00:00:00-04:00,0,8,0,0,0,2689,16945,19634
2015-08-17 01:00:00-04:00,0,8,1,0,0,2811,18524,21335
2015-08-17 02:00:00-04:00,0,8,2,0,0,2898,18925,21823
2015-08-17 03:00:00-04:00,0,8,3,0,0,2775,17627,20402
2015-08-17 04:00:00-04:00,0,8,4,0,0,2681,16747,19428
2015-08-17 05:00:00-04:00,0,8,5,0,0,2636,16655,19291
2015-08-17 06:00:00-04:00,0,8,6,0,0,2518,14962,17480
2015-08-17 07:00:00-04:00,0,8,7,0,0,2070,12020,14090
2015-08-17 08:00:00-04:00,0,8,8,0,0,1618,7854,9472
2015-08-17 09:00:00-04:00,0,8,9,0,0,1081,4723,5804
2015-08-17 10:00:00-04:00,0,8,10,0,0,735,3095,3830
2015-08-17 11:00:00-04:00,0,8,11,0,0,570,2089,2659
2015-08-17 12:00:00-04:00,0,8,12,0,0,591,2365,2956
2015-08-17 13:00:00-04:00,0,8,13,0,0,489,3807,4296
2015-08-17 14:00:00-04:00,0,8,14,0,0,744,9455,10199
2015-08-17 15:00:00-04:00,0,8,15,0,0,1364,14453,15817
2015-08-17 16:00:00-04:00,0,8,16,0,0,2164,18403,20567
2015-08-17 17:00:00-04:00,0,8,17,0,0,2194,18359,20553
2015-08-17 18:00:00-04:00,0,8,18,0,0,1936,16327,18263
2015-08-17 19:00:00-04:00,0,8,19,0,0,1813,16271,18084
2015-08-17 20:00:00-04:00,0,8,20,0,0,1781,17263,19044
2015-08-17 21:00:00-04:00,0,8,21,0,0,1813,17463,19276
2015-08-17 22:00:00-04:00,0,8,22,0,0,1982,18258,20240
2015-08-17 23:00:00-04:00,0,8,23,0,0,1966,17500,19466
2015-08-18 00:00:00-04:00,0,8,0,1,0,2176,16229,18405
2015-08-18 01:00:00-04:00,0,8,1,1,0,2398,18792,21190
2015-08-18 02:00:00-04:00,0,8,2,1,0,2644,22368,25012
2015-08-18 03:00:00-04:00,0,8,3,1,0,2604,22036,24640
2015-08-18 04:00:00-04:00,0,8,4,1,0,2363,20798,23161
2015-08-18 05:00:00-04:00,0,8,5,1,0,2118,19900,22018
2015-08-18 06:00:00-04:00,0,8,6,1,0,1986,17334,19320
2015-08-18 07:00:00-04:00,0,8,7,1,0,1745,13105,14850
2015-08-18 08:00:00-04:00,0,8,8,1,0,1264,8710,9974
2015-08-18 09:00:00-04:00,0,8,9,1,0,919,5417,6336
2015-08-18 10:00:00-04:00,0,8,10,1,0,574,3444,4018
2015-08-18 11:00:00-04:00,0,8,11,1,0,435,2253,2688
2015-08-18 12:00:00-04:00,0,8,12,1,0,404,2399,2803
2015-08-18 13:00:00-04:00,0,8,13,1,0,360,4274,4634
2015-08-18 14:00:00-04:00,0,8,14,1,0,714,10099,10813
2015-08-18 15:00:00-04:00,0,8,15,1,0,1313,15879,17192
2015-08-18 16:00:00-04:00,0,8,16,1,0,2124,20416,22540
2015-08-18 17:00:00-04:00,0,8,17,1,0,2160,19489,21649
2015-08-18 18:00:00-04:00,0,8,18,1,0,1992,17803,19795
2015-08-18 19:00:00-04:00,0,8,19,1,0,1794,17783,19577
2015-08-18 20:00:00-04:00,0,8,20,1,0,1720,18420,20140
2015-08-18 21:00:00-04:00,0,8,21,1,0,1726,18785,20511
2015-08-18 22:00:00-04:00,0,8,22,1,0,1863,19509,21372
2015-08-18 23:00:00-04:00,0,8,23,1,0,2000,18415,20415
2015-08-19 00:00:00-04:00,0,8,0,2,0,2227,15576,17803
2015-08-19 01:00:00-04:00,0,8,1,2,0,2439,18977,21416
2015-08-19 02:00:00-04:00,0,8,2,2,0,2765,23811,26576
2015-08-19 03:00:00-04:00,0,8,3,2,0,2799,23981,26780
2015-08-19 04:00:00-04:00,0,8,4,2,0,2558,23193,25751
2015-08-19 05:00:00-04:00,0,8,5,2,0,2439,23151,25590
2015-08-19 06:00:00-04:00,0,8,6,2,0,2303,21825,24128
2015-08-19 07:00:00-04:00,0,8,7,2,0,2064,17072,19136
2015-08-19 08:00:00-04:00,0,8,8,2,0,1538,10752,12290
2015-08-19 09:00:00-04:00,0,8,9,2,0,1099,6571,7670
2015-08-19 10:00:00-04:00,0,8,10,2,0,710,4256,4966
2015-08-19 11:00:00-04:00,0,8,11,2,0,500,2740,3240
2015-08-19 12:00:00-04:00,0,8,12,2,0,429,2445,2874
2015-08-19 13:00:00-04:00,0,8,13,2,0,381,3626,4007
2015-08-19 14:00:00-04:00,0,8,14,2,0,691,9690,10381
2015-08-19 15:00:00-04:00,0,8,15,2,0,1292,16230,17522
2015-08-19 16:00:00-04:00,0,8,16,2,0,2161,20776,22937
2015-08-19 17:00:00-04:00,0,8,17,2,0,2269,20178,22447
2015-08-19 18:00:00-04:00,0,8,18,2,0,1958,18320,20278
2015-08-19 19:00:00-04:00,0,8,19,2,0,1901,18506,20407
2015-08-19 20:00:00-04:00,0,8,20,2,0,1878,19255,21133
2015-08-19 21:00:00-04:00,0,8,21,2,0,1846,19227,21073
2015-08-19 22:00:00-04:00,0,8,22,2,0,1921,19111,21032
2015-08-19 23:00:00-04:00,0,8,23,2,0,2132,17693,19825
2015-08-20 00:00:00-04:00,0,8,0,3,0,2439,15059,17498
2015-08-20 01:00:00-04:00,0,8,1,3,0,2655,18330,20985
2015-08-20 02:00:00-04:00,0,8,2,3,0,2945,23264,26209
2015-08-20 03:00:00-04:00,0,8,3,3,0,2896,24816,27712
2015-08-20 04:00:00-04:00,0,8,4,3,0,2701,24135,26836
2015-08-20 05:00:00-04:00,0,8,5,3,0,2515,24227,26742
2015-08-20 06:00:00-04:00,0,8,6,3,0,2445,22440,24885
2015-08-20 07:00:00-04:00,0,8,7,3,0,2301,18710,21011
2015-08-20 08:00:00-04:00,0,8,8,3,0,1870,12504,14374
2015-08-20 09:00:00-04:00,0,8,9,3,0,1240,7624,8864
2015-08-20 10:00:00-04:00,0,8,10,3,0,798,5073,5871
2015-08-20 11:00:00-04:00,0,8,11,3,0,572,3192,3764
2015-08-20 12:00:00-04:00,0,8,12,3,0,561,2904,3465
2015-08-20 13:00:00-04:00,0,8,13,3,0,428,4031,4459
2015-08-20 14:00:00-04:00,0,8,14,3,0,752,10259,11011
2015-08-20 15:00:00-04:00,0,8,15,3,0,1437,16385,17822
2015-08-20 16:00:00-04:00,0,8,16,3,0,2316,20917,23233
2015-08-20 17:00:00-04:00,0,8,17,3,0,2412,20102,22514
2015-08-20 18:00:00-04:00,0,8,18,3,0,2064,17730,19794
2015-08-20 19:00:00-04:00,0,8,19,3,0,1854,18298,20152
2015-08-20 20:00:00-04:00,0,8,20,3,0,1957,18553,20510
2015-08-20 21:00:00-04:00,0,8,21,3,0,1799,18473,20272
2015-08-20 22:00:00-04:00,0,8,22,3,0,1980,18928,20908
2015-08-20 23:00:00-04:00,0,8,23,3,0,2297,17524,19821
2015-08-21 00:00:00-04:00,0,8,0,4,0,2425,14920,17345
2015-08-21 01:00:00-04:00,0.02,8,1,4,0,2844,18802,21646
2015-08-21 02:00:00-04:00,0.07,8,2,4,0,3301,23284,26585
2015-08-21 03:00:00-04:00,0.12,8,3,4,0,3281,24861,28142
2015-08-21 04:00:00-04:00,0.13,8,4,4,0,2899,24328,27227
2015-08-21 05:00:00-04:00,0.03,8,5,4,0,2851,24067,26918
2015-08-21 06:00:00-04:00,0,8,6,4,0,2957,23996,26953
2015-08-21 07:00:00-04:00,0,8,7,4,0,2843,21562,24405
2015-08-21 08:00:00-04:00,0,8,8,4,0,2430,17006,19436
2015-08-21 09:00:00-04:00,0,8,9,4,0,1889,12143,14032
2015-08-21 10:00:00-04:00,0,8,10,4,0,1387,7917,9304
2015-08-21 11:00:00-04:00,0,8,11,4,0,890,4963,5853
2015-08-21 12:00:00-04:00,0,8,12,4,0,690,3812,4502
2015-08-21 13:00:00-04:00,0,8,13,4,0,510,4152,4662
2015-08-21 14:00:00-04:00,0,8,14,4,0,770,9414,10184
2015-08-21 15:00:00-04:00,0,8,15,4,0,1378,14456,15834
2015-08-21 16:00:00-04:00,0,8,16,4,0,2201,18197,20398
2015-08-21 17:00:00-04:00,0,8,17,4,0,2246,17995,20241
2015-08-21 18:00:00-04:00,0,8,18,4,0,1898,15731,17629
2015-08-21 19:00:00-04:00,0,8,19,4,0,1668,16154,17822
2015-08-21 20:00:00-04:00,0,8,20,4,0,1739,17120,18859
2015-08-21 21:00:00-04:00,0,8,21,4,0,1685,17443,19128
2015-08-21 22:00:00-04:00,0,8,22,4,0,2021,18582,20603
2015-08-21 23:00:00-04:00,0,8,23,4,0,2521,18691,21212
2015-08-22 00:00:00-04:00,0,8,0,5,0,2802,16083,18885
2015-08-22 01:00:00-04:00,0,8,1,5,0,3244,19055,22299
2015-08-22 02:00:00-04:00,0,8,2,5,0,3640,22540,26180
2015-08-22 03:00:00-04:00,0,8,3,5,0,3950,23676,27626
2015-08-22 04:00:00-04:00,0,8,4,5,0,3798,21532,25330
2015-08-22 05:00:00-04:00,0,8,5,5,0,3555,20597,24152
2015-08-22 06:00:00-04:00,0,8,6,5,0,3818,21669,25487
2015-08-22 07:00:00-04:00,0,8,7,5,0,4240,22124,26364
2015-08-22 08:00:00-04:00,0,8,8,5,0,4105,20379,24484
2015-08-22 09:00:00-04:00,0,8,9,5,0,3612,18099,21711
2015-08-22 10:00:00-04:00,0,8,10,5,0,3077,15096,18173
2015-08-22 11:00:00-04:00,0,8,11,5,0,2530,11440,13970
2015-08-22 12:00:00-04:00,0,8,12,5,0,1881,7113,8994
2015-08-22 13:00:00-04:00,0,8,13,5,0,991,3894,4885
2015-08-22 14:00:00-04:00,0,8,14,5,0,764,4425,5189
2015-08-22 15:00:00-04:00,0,8,15,5,0,884,6498,7382
2015-08-22 16:00:00-04:00,0,8,16,5,0,1160,8735,9895
2015-08-22 17:00:00-04:00,0,8,17,5,0,1550,11803,13353
2015-08-22 18:00:00-04:00,0,8,18,5,0,1795,14416,16211
2015-08-22 19:00:00-04:00,0,8,19,5,0,2056,15709,17765
2015-08-22 20:00:00-04:00,0,8,20,5,0,2147,16477,18624
2015-08-22 21:00:00-04:00,0,8,21,5,0,2329,17555,19884
2015-08-22 22:00:00-04:00,0,8,22,5,0,2616,16636,19252
2015-08-22 23:00:00-04:00,0,8,23,5,0,2814,16881,19695
2015-08-23 00:00:00-04:00,0,8,0,6,0,3167,16166,19333
2015-08-23 01:00:00-04:00,0,8,1,6,0,3147,18099,21246
2015-08-23 02:00:00-04:00,0,8,2,6,0,3567,20062,23629
2015-08-23 03:00:00-04:00,0,8,3,6,0,3653,19886,23539
2015-08-23 04:00:00-04:00,0,8,4,6,0,3823,18614,22437
2015-08-23 05:00:00-04:00,0,8,5,6,0,3957,18760,22717
2015-08-23 06:00:00-04:00,0,8,6,6,0,4373,19519,23892
2015-08-23 07:00:00-04:00,0,8,7,6,0,4499,21173,25672
2015-08-23 08:00:00-04:00,0,8,8,6,0,4316,19923,24239
2015-08-23 09:00:00-04:00,0,8,9,6,0,4034,18038,22072
2015-08-23 10:00:00-04:00,0,8,10,6,0,3447,15249,18696
2015-08-23 11:00:00-04:00,0,8,11,6,0,2861,11699,14560
2015-08-23 12:00:00-04:00,0,8,12,6,0,2263,7532,9795
2015-08-23 13:00:00-04:00,0,8,13,6,0,1018,3570,4588
2015-08-23 14:00:00-04:00,0,8,14,6,0,747,3722,4469
2015-08-23 15:00:00-04:00,0,8,15,6,0,679,4560,5239
2015-08-23 16:00:00-04:00,0,8,16,6,0,787,6184,6971
2015-08-23 17:00:00-04:00,0,8,17,6,0,1144,9038,10182
2015-08-23 18:00:00-04:00,0,8,18,6,0,1457,12283,13740
2015-08-23 19:00:00-04:00,0,8,19,6,0,1829,14656,16485
2015-08-23 20:00:00-04:00,0,8,20,6,0,1937,16118,18055
2015-08-23 21:00:00-04:00,0,8,21,6,0,1938,16325,18263
2015-08-23 22:00:00-04:00,0,8,22,6,0,2351,17157,19508
2015-08-23 23:00:00-04:00,0,8,23,6,0,2590,16816,19406
2015-08-24 00:00:00-04:00,0,8,0,0,0,2614,16290,18904
2015-08-24 01:00:00-04:00,0,8,1,0,0,2666,17097,19763
2015-08-24 02:00:00-04:00,0,8,2,0,0,2857,17830,20687
2015-08-24 03:00:00-04:00,0,8,3,0,0,2702,16381,19083
2015-08-24 04:00:00-04:00,0,8,4,0,0,2740,15586,18326
2015-08-24 05:00:00-04:00,0,8,5,0,0,2611,15229,17840
2015-08-24 06:00:00-04:00,0,8,6,0,0,2597,13728,16325
2015-08-24 07:00:00-04:00,0,8,7,0,0,2292,11229,13521
2015-08-24 08:00:00-04:00,0,8,8,0,0,1787,7278,9065
2015-08-24 09:00:00-04:00,0,8,9,0,0,1161,4498,5659
2015-08-24 10:00:00-04:00,0,8,10,0,0,763,3045,3808
2015-08-24 11:00:00-04:00,0,8,11,0,0,629,2107,2736
2015-08-24 12:00:00-04:00,0,8,12,0,0,553,2340,2893
2015-08-24 13:00:00-04:00,0,8,13,0,0,468,3962,4430
2015-08-24 14:00:00-04:00,0,8,14,0,0,761,9413,10174
2015-08-24 15:00:00-04:00,0,8,15,0,0,1376,14718,16094
2015-08-24 16:00:00-04:00,0,8,16,0,0,2253,18168,20421
2015-08-24 17:00:00-04:00,0,8,17,0,0,2108,17166,19274
2015-08-24 18:00:00-04:00,0,8,18,0,0,1730,14805,16535
2015-08-24 19:00:00-04:00,0,8,19,0,0,1634,14699,16333
2015-08-24 20:00:00-04:00,0,8,20,0,0,1614,15583,17197
2015-08-24 21:00:00-04:00,0,8,21,0,0,1614,15987,17601
2015-08-24 22:00:00-04:00,0,8,22,0,0,1691,16557,18248
2015-08-24 23:00:00-04:00,0,8,23,0,0,1905,15947,17852
2015-08-25 00:00:00-04:00,0,8,0,1,0,2014,15402,17416
2015-08-25 01:00:00-04:00,0,8,1,1,0,2231,18259,20490
2015-08-25 02:00:00-04:00,0,8,2,1,0,2405,20961,23366
2015-08-25 03:00:00-04:00,0,8,3,1,0,2388,20532,22920
2015-08-25 04:00:00-04:00,0,8,4,1,0,2095,19536,21631
2015-08-25 05:00:00-04:00,0,8,5,1,0,1972,18164,20136
2015-08-25 06:00:00-04:00,0,8,6,1,0,1882,16253,18135
2015-08-25 07:00:00-04:00,0,8,7,1,0,1686,12211,13897
2015-08-25 08:00:00-04:00,0,8,8,1,0,1304,8101,9405
2015-08-25 09:00:00-04:00,0,8,9,1,0,885,4755,5640
2015-08-25 10:00:00-04:00,0,8,10,1,0,593,3052,3645
2015-08-25 11:00:00-04:00,0,8,11,1,0,409,1995,2404
2015-08-25 12:00:00-04:00,0,8,12,1,0,379,2028,2407
2015-08-25 13:00:00-04:00,0,8,13,1,0,352,3551,3903
2015-08-25 14:00:00-04:00,0,8,14,1,0,684,9389,10073
2015-08-25 15:00:00-04:00,0,8,15,1,0,1306,14764,16070
2015-08-25 16:00:00-04:00,0,8,16,1,0,1980,18853,20833
2015-08-25 17:00:00-04:00,0,8,17,1,0,2066,18363,20429
2015-08-25 18:00:00-04:00,0,8,18,1,0,1793,16261,18054
2015-08-25 19:00:00-04:00,0,8,19,1,0,1604,16232,17836
2015-08-25 20:00:00-04:00,0,8,20,1,0,1707,17193,18900
2015-08-25 21:00:00-04:00,0,8,21,1,0,1640,17432,19072
2015-08-25 22:00:00-04:00,0,8,22,1,0,1843,18753,20596
2015-08-25 23:00:00-04:00,0,8,23,1,0,1933,17409,19342
2015-08-26 00:00:00-04:00,0,8,0,2,0,2093,15648,17741
2015-08-26 01:00:00-04:00,0,8,1,2,0,2334,18373,20707
2015-08-26 02:00:00-04:00,0,8,2,2,0,2865,23012,25877
2015-08-26 03:00:00-04:00,0,8,3,2,0,2551,22770,25321
2015-08-26 04:00:00-04:00,0,8,4,2,0,2384,21761,24145
2015-08-26 05:00:00-04:00,0,8,5,2,0,2260,21519,23779
2015-08-26 06:00:00-04:00,0,8,6,2,0,2124,20191,22315
2015-08-26 07:00:00-04:00,0,8,7,2,0,1899,15538,17437
2015-08-26 08:00:00-04:00,0,8,8,2,0,1508,10198,11706
2015-08-26 09:00:00-04:00,0,8,9,2,0,1002,6142,7144
2015-08-26 10:00:00-04:00,0,8,10,2,0,621,3861,4482
2015-08-26 11:00:00-04:00,0,8,11,2,0,439,2633,3072
2015-08-26 12:00:00-04:00,0,8,12,2,0,466,2389,2855
2015-08-26 13:00:00-04:00,0,8,13,2,0,360,3450,3810
2015-08-26 14:00:00-04:00,0,8,14,2,0,685,9172,9857
2015-08-26 15:00:00-04:00,0,8,15,2,0,1290,14767,16057
2015-08-26 16:00:00-04:00,0,8,16,2,0,2078,18774,20852
2015-08-26 17:00:00-04:00,0,8,17,2,0,2131,18246,20377
2015-08-26 18:00:00-04:00,0,8,18,2,0,1772,16536,18308
2015-08-26 19:00:00-04:00,0,8,19,2,0,1558,16221,17779
2015-08-26 20:00:00-04:00,0,8,20,2,0,1656,17368,19024
2015-08-26 21:00:00-04:00,0,8,21,2,0,1629,17215,18844
2015-08-26 22:00:00-04:00,0,8,22,2,0,1842,17837,19679
2015-08-26 23:00:00-04:00,0,8,23,2,0,2003,16802,18805
2015-08-27 00:00:00-04:00,0,8,0,3,0,2159,15308,17467
2015-08-27 01:00:00-04:00,0,8,1,3,0,2399,18078,20477
2015-08-27 02:00:00-04:00,0,8,2,3,0,2720,22075,24795
2015-08-27 03:00:00-04:00,0,8,3,3,0,2731,23506,26237
2015-08-27 04:00:00-04:00,0,8,4,3,0,2552,22999,25551
2015-08-27 05:00:00-04:00,0,8,5,3,0,2427,23083,25510
2015-08-27 06:00:00-04:00,0,8,6,3,0,2388,21960,24348
2015-08-27 07:00:00-04:00,0,8,7,3,0,2153,17877,20030
2015-08-27 08:00:00-04:00,0,8,8,3,0,1641,12170,13811
2015-08-27 09:00:00-04:00,0,8,9,3,0,1213,7322,8535
2015-08-27 10:00:00-04:00,0,8,10,3,0,747,4571,5318
2015-08-27 11:00:00-04:00,0,8,11,3,0,552,3085,3637
2015-08-27 12:00:00-04:00,0,8,12,3,0,478,2696,3174
2015-08-27 13:00:00-04:00,0,8,13,3,0,396,3587,3983
2015-08-27 14:00:00-04:00,0,8,14,3,0,737,9522,10259
2015-08-27 15:00:00-04:00,0,8,15,3,0,1388,14850,16238
2015-08-27 16:00:00-04:00,0,8,16,3,0,2101,19084,21185
2015-08-27 17:00:00-04:00,0,8,17,3,0,2170,18203,20373
2015-08-27 18:00:00-04:00,0,8,18,3,0,1866,16308,18174
2015-08-27 19:00:00-04:00,0,8,19,3,0,1631,16072,17703
2015-08-27 20:00:00-04:00,0,8,20,3,0,1764,17026,18790
2015-08-27 21:00:00-04:00,0,8,21,3,0,1748,17297,19045
2015-08-27 22:00:00-04:00,0,8,22,3,0,1870,18048,19918
2015-08-27 23:00:00-04:00,0,8,23,3,0,2025,17016,19041
2015-08-28 00:00:00-04:00,0,8,0,4,0,2268,14636,16904
2015-08-28 01:00:00-04:00,0,8,1,4,0,2580,18076,20656
2015-08-28 02:00:00-04:00,0,8,2,4,0,2962,23204,26166
2015-08-28 03:00:00-04:00,0,8,3,4,0,2942,24176,27118
2015-08-28 04:00:00-04:00,0,8,4,4,0,2846,23866,26712
2015-08-28 05:00:00-04:00,0,8,5,4,0,2779,24095,26874
2015-08-28 06:00:00-04:00,0,8,6,4,0,2821,23329,26150
2015-08-28 07:00:00-04:00,0,8,7,4,0,2586,20128,22714
2015-08-28 08:00:00-04:00,0,8,8,4,0,2081,15463,17544
2015-08-28 09:00:00-04:00,0,8,9,4,0,1625,10665,12290
2015-08-28 10:00:00-04:00,0,8,10,4,0,1077,7069,8146
2015-08-28 11:00:00-04:00,0,8,11,4,0,714,4756,5470
2015-08-28 12:00:00-04:00,0,8,12,4,0,646,3747,4393
2015-08-28 13:00:00-04:00,0,8,13,4,0,452,3734,4186
2015-08-28 14:00:00-04:00,0,8,14,4,0,742,8874,9616
2015-08-28 15:00:00-04:00,0,8,15,4,0,1370,13625,14995
2015-08-28 16:00:00-04:00,0,8,16,4,0,2032,17394,19426
2015-08-28 17:00:00-04:00,0,8,17,4,0,2170,17189,19359
2015-08-28 18:00:00-04:00,0,8,18,4,0,1893,15213,17106
2015-08-28 19:00:00-04:00,0,8,19,4,0,1768,15673,17441
2015-08-28 20:00:00-04:00,0,8,20,4,0,1697,16994,18691
2015-08-28 21:00:00-04:00,0,8,21,4,0,1600,17050,18650
2015-08-28 22:00:00-04:00,0,8,22,4,0,2060,17876,19936
2015-08-28 23:00:00-04:00,0,8,23,4,0,2448,17081,19529
2015-08-29 00:00:00-04:00,0,8,0,5,0,2664,15300,17964
2015-08-29 01:00:00-04:00,0,8,1,5,0,3106,18522,21628
2015-08-29 02:00:00-04:00,0,8,2,5,0,3507,21953,25460
2015-08-29 03:00:00-04:00,0,8,3,5,0,3450,23273,26723
2015-08-29 04:00:00-04:00,0,8,4,5,0,3642,21736,25378
2015-08-29 05:00:00-04:00,0,8,5,5,0,3418,20811,24229
2015-08-29 06:00:00-04:00,0,8,6,5,0,3727,21443,25170
2015-08-29 07:00:00-04:00,0,8,7,5,0,3946,21683,25629
2015-08-29 08:00:00-04:00,0,8,8,5,0,3919,20324,24243
2015-08-29 09:00:00-04:00,0,8,9,5,0,3512,17868,21380
2015-08-29 10:00:00-04:00,0,8,10,5,0,2985,14908,17893
2015-08-29 11:00:00-04:00,0,8,11,5,0,2332,11369,13701
2015-08-29 12:00:00-04:00,0,8,12,5,0,1740,6970,8710
2015-08-29 13:00:00-04:00,0,8,13,5,0,934,3555,4489
2015-08-29 14:00:00-04:00,0,8,14,5,0,747,4681,5428
2015-08-29 15:00:00-04:00,0,8,15,5,0,848,6723,7571
2015-08-29 16:00:00-04:00,0,8,16,5,0,1081,8615,9696
2015-08-29 17:00:00-04:00,0,8,17,5,0,1485,12104,13589
2015-08-29 18:00:00-04:00,0,8,18,5,0,1656,14123,15779
2015-08-29 19:00:00-04:00,0,8,19,5,0,1877,15350,17227
2015-08-29 20:00:00-04:00,0,8,20,5,0,2100,16869,18969
2015-08-29 21:00:00-04:00,0,8,21,5,0,2126,16951,19077
2015-08-29 22:00:00-04:00,0,8,22,5,0,2405,16750,19155
2015-08-29 23:00:00-04:00,0,8,23,5,0,2679,17469,20148
2015-08-30 00:00:00-04:00,0,8,0,6,0,2774,16394,19168
2015-08-30 01:00:00-04:00,0,8,1,6,0,3019,18145,21164
2015-08-30 02:00:00-04:00,0,8,2,6,0,3396,19996,23392
2015-08-30 03:00:00-04:00,0,8,3,6,0,3692,20924,24616
2015-08-30 04:00:00-04:00,0,8,4,6,0,3794,18799,22593
2015-08-30 05:00:00-04:00,0,8,5,6,0,3791,18784,22575
2015-08-30 06:00:00-04:00,0,8,6,6,0,3954,20295,24249
2015-08-30 07:00:00-04:00,0,8,7,6,0,4291,21062,25353
2015-08-30 08:00:00-04:00,0,8,8,6,0,4148,19947,24095
2015-08-30 09:00:00-04:00,0,8,9,6,0,3839,17956,21795
2015-08-30 10:00:00-04:00,0,8,10,6,0,3384,15450,18834
2015-08-30 11:00:00-04:00,0,8,11,6,0,2850,11847,14697
2015-08-30 12:00:00-04:00,0,8,12,6,0,2032,7529,9561
2015-08-30 13:00:00-04:00,0,8,13,6,0,978,3473,4451
2015-08-30 14:00:00-04:00,0,8,14,6,0,657,3751,4408
2015-08-30 15:00:00-04:00,0,8,15,6,0,696,4954,5650
2015-08-30 16:00:00-04:00,0,8,16,6,0,790,6722,7512
2015-08-30 17:00:00-04:00,0,8,17,6,0,1116,9590,10706
2015-08-30 18:00:00-04:00,0,8,18,6,0,1509,13155,14664
2015-08-30 19:00:00-04:00,0,8,19,6,0,1728,15412,17140
2015-08-30 20:00:00-04:00,0,8,20,6,0,1968,16969,18937
2015-08-30 21:00:00-04:00,0,8,21,6,0,1957,17687,19644
2015-08-30 22:00:00-04:00,0.08,8,22,6,0,2394,18221,20615
2015-08-30 23:00:00-04:00,0,8,23,6,0,2520,17271,19791
2015-08-31 00:00:00-04:00,0,8,0,0,0,2570,17093,19663
2015-08-31 01:00:00-04:00,0,8,1,0,0,2725,17782,20507
2015-08-31 02:00:00-04:00,0,8,2,0,0,2860,19116,21976
2015-08-31 03:00:00-04:00,0,8,3,0,0,2768,17806,20574
2015-08-31 04:00:00-04:00,0,8,4,0,0,2717,16681,19398
2015-08-31 05:00:00-04:00,0,8,5,0,0,2646,17135,19781
2015-08-31 06:00:00-04:00,0,8,6,0,0,2559,15799,18358
2015-08-31 07:00:00-04:00,0,8,7,0,0,2078,11213,13291
2015-08-31 08:00:00-04:00,0,8,8,0,0,1488,7156,8644
2015-08-31 09:00:00-04:00,0,8,9,0,0,1024,4262,5286
2015-08-31 10:00:00-04:00,0,8,10,0,0,708,2721,3429
2015-08-31 11:00:00-04:00,0,8,11,0,0,530,1824,2354
2015-08-31 12:00:00-04:00,0,8,12,0,0,534,2068,2602
2015-08-31 13:00:00-04:00,0,8,13,0,0,432,3415,3847
2015-08-31 14:00:00-04:00,0,8,14,0,0,806,9250,10056
2015-08-31 15:00:00-04:00,0,8,15,0,0,1419,14675,16094
2015-08-31 16:00:00-04:00,0,8,16,0,0,2226,18260,20486
2015-08-31 17:00:00-04:00,0,8,17,0,0,2200,17513,19713
2015-08-31 18:00:00-04:00,0,8,18,0,0,1816,15364,17180
2015-08-31 19:00:00-04:00,0,8,19,0,0,1616,15455,17071
2015-08-31 20:00:00-04:00,0,8,20,0,0,1666,16174,17840
2015-08-31 21:00:00-04:00,0,8,21,0,0,1662,16560,18222
2015-08-31 22:00:00-04:00,0,8,22,0,0,1941,17560,19501
2015-08-31 23:00:00-04:00,0,8,23,0,0,2121,17302,19423
2015-09-01 00:00:00-04:00,0,9,0,1,0,2292,15604,17896
2015-09-01 01:00:00-04:00,0,9,1,1,0,2514,18121,20635
2015-09-01 02:00:00-04:00,0,9,2,1,0,2663,21301,23964
2015-09-01 03:00:00-04:00,0,9,3,1,0,2618,21592,24210
2015-09-01 04:00:00-04:00,0,9,4,1,0,2364,19909,22273
2015-09-01 05:00:00-04:00,0,9,5,1,0,2113,18567,20680
2015-09-01 06:00:00-04:00,0,9,6,1,0,1867,16171,18038
2015-09-01 07:00:00-04:00,0,9,7,1,0,1646,11618,13264
2015-09-01 08:00:00-04:00,0,9,8,1,0,1294,8387,9681
2015-09-01 09:00:00-04:00,0,9,9,1,0,853,5005,5858
2015-09-01 10:00:00-04:00,0,9,10,1,0,538,3061,3599
2015-09-01 11:00:00-04:00,0,9,11,1,0,367,2225,2592
2015-09-01 12:00:00-04:00,0,9,12,1,0,385,2097,2482
2015-09-01 13:00:00-04:00,0,9,13,1,0,336,3498,3834
2015-09-01 14:00:00-04:00,0,9,14,1,0,666,9578,10244
2015-09-01 15:00:00-04:00,0,9,15,1,0,1396,15792,17188
2015-09-01 16:00:00-04:00,0,9,16,1,0,2226,19604,21830
2015-09-01 17:00:00-04:00,0,9,17,1,0,2287,19052,21339
2015-09-01 18:00:00-04:00,0,9,18,1,0,1910,16922,18832
2015-09-01 19:00:00-04:00,0,9,19,1,0,1785,16841,18626
2015-09-01 20:00:00-04:00,0,9,20,1,0,1820,17768,19588
2015-09-01 21:00:00-04:00,0,9,21,1,0,1847,17845,19692
2015-09-01 22:00:00-04:00,0,9,22,1,0,1981,18563,20544
2015-09-01 23:00:00-04:00,0,9,23,1,0,2151,17738,19889
2015-09-02 00:00:00-04:00,0,9,0,2,0,2334,15874,18208
2015-09-02 01:00:00-04:00,0,9,1,2,0,2506,18523,21029
2015-09-02 02:00:00-04:00,0,9,2,2,0,2916,22853,25769
2015-09-02 03:00:00-04:00,0,9,3,2,0,2773,23072,25845
2015-09-02 04:00:00-04:00,0,9,4,2,0,2581,22295,24876
2015-09-02 05:00:00-04:00,0,9,5,2,0,2375,21747,24122
2015-09-02 06:00:00-04:00,0,9,6,2,0,2281,19366,21647
2015-09-02 07:00:00-04:00,0,9,7,2,0,1945,15079,17024
2015-09-02 08:00:00-04:00,0,9,8,2,0,1413,9651,11064
2015-09-02 09:00:00-04:00,0,9,9,2,0,1010,5627,6637
2015-09-02 10:00:00-04:00,0,9,10,2,0,623,3655,4278
2015-09-02 11:00:00-04:00,0,9,11,2,0,422,2466,2888
2015-09-02 12:00:00-04:00,0,9,12,2,0,422,2260,2682
2015-09-02 13:00:00-04:00,0,9,13,2,0,348,3489,3837
2015-09-02 14:00:00-04:00,0,9,14,2,0,710,9510,10220
2015-09-02 15:00:00-04:00,0,9,15,2,0,1407,15766,17173
2015-09-02 16:00:00-04:00,0,9,16,2,0,2266,20477,22743
2015-09-02 17:00:00-04:00,0,9,17,2,0,2285,19454,21739
2015-09-02 18:00:00-04:00,0,9,18,2,0,1915,17621,19536
2015-09-02 19:00:00-04:00,0,9,19,2,0,1859,17598,19457
2015-09-02 20:00:00-04:00,0,9,20,2,0,1888,18574,20462
2015-09-02 21:00:00-04:00,0,9,21,2,0,1889,18631,20520
2015-09-02 22:00:00-04:00,0,9,22,2,0,2027,19117,21144
2015-09-02 23:00:00-04:00,0,9,23,2,0,2141,17997,20138
2015-09-03 00:00:00-04:00,0,9,0,3,0,2315,15472,17787
2015-09-03 01:00:00-04:00,0,9,1,3,0,2650,18514,21164
2015-09-03 02:00:00-04:00,0,9,2,3,0,3005,22944,25949
2015-09-03 03:00:00-04:00,0,9,3,3,0,2898,24545,27443
2015-09-03 04:00:00-04:00,0,9,4,3,0,2780,23518,26298
2015-09-03 05:00:00-04:00,0,9,5,3,0,2593,22852,25445
2015-09-03 06:00:00-04:00,0,9,6,3,0,2354,21725,24079
2015-09-03 07:00:00-04:00,0,9,7,3,0,2204,16896,19100
2015-09-03 08:00:00-04:00,0,9,8,3,0,1676,11834,13510
2015-09-03 09:00:00-04:00,0,9,9,3,0,1043,6977,8020
2015-09-03 10:00:00-04:00,0,9,10,3,0,727,4489,5216
2015-09-03 11:00:00-04:00,0,9,11,3,0,502,2855,3357
2015-09-03 12:00:00-04:00,0,9,12,3,0,457,2547,3004
2015-09-03 13:00:00-04:00,0,9,13,3,0,411,3683,4094
2015-09-03 14:00:00-04:00,0,9,14,3,0,792,9567,10359
2015-09-03 15:00:00-04:00,0,9,15,3,0,1466,16048,17514
2015-09-03 16:00:00-04:00,0,9,16,3,0,2309,20051,22360
2015-09-03 17:00:00-04:00,0,9,17,3,0,2440,19136,21576
2015-09-03 18:00:00-04:00,0,9,18,3,0,2108,17364,19472
2015-09-03 19:00:00-04:00,0,9,19,3,0,1948,17635,19583
2015-09-03 20:00:00-04:00,0,9,20,3,0,2033,18436,20469
2015-09-03 21:00:00-04:00,0,9,21,3,0,2031,18753,20784
2015-09-03 22:00:00-04:00,0,9,22,3,0,2302,19816,22118
2015-09-03 23:00:00-04:00,0,9,23,3,0,2450,18300,20750
2015-09-04 00:00:00-04:00,0,9,0,4,0,2660,15667,18327
2015-09-04 01:00:00-04:00,0,9,1,4,0,2987,19077,22064
2015-09-04 02:00:00-04:00,0,9,2,4,0,3342,23026,26368
2015-09-04 03:00:00-04:00,0,9,3,4,0,3241,24260,27501
2015-09-04 04:00:00-04:00,0,9,4,4,0,3095,23465,26560
2015-09-04 05:00:00-04:00,0,9,5,4,0,2881,23007,25888
2015-09-04 06:00:00-04:00,0,9,6,4,0,2816,22436,25252
2015-09-04 07:00:00-04:00,0,9,7,4,0,2655,19861,22516
2015-09-04 08:00:00-04:00,0,9,8,4,0,2119,15396,17515
2015-09-04 09:00:00-04:00,0,9,9,4,0,1624,10649,12273
2015-09-04 10:00:00-04:00,0,9,10,4,0,1077,7270,8347
2015-09-04 11:00:00-04:00,0,9,11,4,0,765,4855,5620
2015-09-04 12:00:00-04:00,0,9,12,4,0,707,3932,4639
2015-09-04 13:00:00-04:00,0,9,13,4,0,472,4047,4519
2015-09-04 14:00:00-04:00,0,9,14,4,0,793,9151,9944
2015-09-04 15:00:00-04:00,0,9,15,4,0,1425,13428,14853
2015-09-04 16:00:00-04:00,0,9,16,4,0,2134,17017,19151
2015-09-04 17:00:00-04:00,0,9,17,4,0,2255,17265,19520
2015-09-04 18:00:00-04:00,0,9,18,4,0,2069,16195,18264
2015-09-04 19:00:00-04:00,0,9,19,4,0,1998,16381,18379
2015-09-04 20:00:00-04:00,0,9,20,4,0,1919,17896,19815
2015-09-04 21:00:00-04:00,0,9,21,4,0,1859,18312,20171
2015-09-04 22:00:00-04:00,0,9,22,4,0,2293,19102,21395
2015-09-04 23:00:00-04:00,0,9,23,4,0,2717,18220,20937
2015-09-05 00:00:00-04:00,0,9,0,5,0,3032,15911,18943
2015-09-05 01:00:00-04:00,0,9,1,5,0,3213,18631,21844
2015-09-05 02:00:00-04:00,0,9,2,5,0,3532,20746,24278
2015-09-05 03:00:00-04:00,0,9,3,5,0,3585,21545,25130
2015-09-05 04:00:00-04:00,0,9,4,5,0,3518,18877,22395
2015-09-05 05:00:00-04:00,0,9,5,5,0,3404,18174,21578
2015-09-05 06:00:00-04:00,0,9,6,5,0,3634,19434,23068
2015-09-05 07:00:00-04:00,0,9,7,5,0,3953,19781,23734
2015-09-05 08:00:00-04:00,0,9,8,5,0,3763,18723,22486
2015-09-05 09:00:00-04:00,0,9,9,5,0,3365,15314,18679
2015-09-05 10:00:00-04:00,0,9,10,5,0,2894,13122,16016
2015-09-05 11:00:00-04:00,0,9,11,5,0,2142,9529,11671
2015-09-05 12:00:00-04:00,0,9,12,5,0,1687,6657,8344
2015-09-05 13:00:00-04:00,0,9,13,5,0,866,3565,4431
2015-09-05 14:00:00-04:00,0,9,14,5,0,770,4456,5226
2015-09-05 15:00:00-04:00,0,9,15,5,0,777,6142,6919
2015-09-05 16:00:00-04:00,0,9,16,5,0,1085,8008,9093
2015-09-05 17:00:00-04:00,0,9,17,5,0,1422,11010,12432
2015-09-05 18:00:00-04:00,0,9,18,5,0,1637,13331,14968
2015-09-05 19:00:00-04:00,0,9,19,5,0,1841,14824,16665
2015-09-05 20:00:00-04:00,0,9,20,5,0,2080,15715,17795
2015-09-05 21:00:00-04:00,0,9,21,5,0,2027,16164,18191
2015-09-05 22:00:00-04:00,0,9,22,5,0,2428,16304,18732
2015-09-05 23:00:00-04:00,0,9,23,5,0,2658,16213,18871
2015-09-06 00:00:00-04:00,0,9,0,6,0,2870,15979,18849
2015-09-06 01:00:00-04:00,0,9,1,6,0,2970,17374,20344
2015-09-06 02:00:00-04:00,0,9,2,6,0,3165,18514,21679
2015-09-06 03:00:00-04:00,0,9,3,6,0,3469,19555,23024
2015-09-06 04:00:00-04:00,0,9,4,6,0,3615,17381,20996
2015-09-06 05:00:00-04:00,0,9,5,6,0,3554,16847,20401
2015-09-06 06:00:00-04:00,0,9,6,6,0,3749,17928,21677
2015-09-06 07:00:00-04:00,0,9,7,6,0,3995,18986,22981
2015-09-06 08:00:00-04:00,0,9,8,6,0,3806,16990,20796
2015-09-06 09:00:00-04:00,0,9,9,6,0,3505,14452,17957
2015-09-06 10:00:00-04:00,0,9,10,6,0,2978,12143,15121
2015-09-06 11:00:00-04:00,0,9,11,6,0,2297,9427,11724
2015-09-06 12:00:00-04:00,0,9,12,6,0,2022,6702,8724
2015-09-06 13:00:00-04:00,0,9,13,6,0,983,3128,4111
2015-09-06 14:00:00-04:00,0,9,14,6,0,708,3210,3918
2015-09-06 15:00:00-04:00,0,9,15,6,0,622,4460,5082
2015-09-06 16:00:00-04:00,0,9,16,6,0,771,6087,6858
2015-09-06 17:00:00-04:00,0,9,17,6,0,1139,8950,10089
2015-09-06 18:00:00-04:00,0,9,18,6,0,1428,12247,13675
2015-09-06 19:00:00-04:00,0,9,19,6,0,1686,14163,15849
2015-09-06 20:00:00-04:00,0,9,20,6,0,1870,14939,16809
2015-09-06 21:00:00-04:00,0,9,21,6,0,1839,15784,17623
2015-09-06 22:00:00-04:00,0,9,22,6,0,2212,16364,18576
2015-09-06 23:00:00-04:00,0,9,23,6,0,2393,15713,18106
2015-09-07 00:00:00-04:00,0,9,0,0,1,2573,15641,18214
2015-09-07 01:00:00-04:00,0,9,1,0,1,2673,16620,19293
2015-09-07 02:00:00-04:00,0,9,2,0,1,2844,17179,20023
2015-09-07 03:00:00-04:00,0,9,3,0,1,2791,16270,19061
2015-09-07 04:00:00-04:00,0,9,4,0,1,2879,15480,18359
2015-09-07 05:00:00-04:00,0,9,5,0,1,2876,14991,17867
2015-09-07 06:00:00-04:00,0,9,6,0,1,2997,14997,17994
2015-09-07 07:00:00-04:00,0,9,7,0,1,3231,15024,18255
2015-09-07 08:00:00-04:00,0,9,8,0,1,2809,12933,15742
2015-09-07 09:00:00-04:00,0,9,9,0,1,2329,9522,11851
2015-09-07 10:00:00-04:00,0,9,10,0,1,1744,7281,9025
2015-09-07 11:00:00-04:00,0,9,11,0,1,1371,5251,6622
2015-09-07 12:00:00-04:00,0,9,12,0,1,1166,3869,5035
2015-09-07 13:00:00-04:00,0,9,13,0,1,735,2727,3462
2015-09-07 14:00:00-04:00,0,9,14,0,1,696,3622,4318
2015-09-07 15:00:00-04:00,0,9,15,0,1,628,4706,5334
2015-09-07 16:00:00-04:00,0,9,16,0,1,784,6025,6809
2015-09-07 17:00:00-04:00,0,9,17,0,1,989,8294,9283
2015-09-07 18:00:00-04:00,0,9,18,0,1,1185,11230,12415
2015-09-07 19:00:00-04:00,0,9,19,0,1,1328,13306,14634
2015-09-07 20:00:00-04:00,0,9,20,0,1,1546,15075,16621
2015-09-07 21:00:00-04:00,0,9,21,0,1,1603,15719,17322
2015-09-07 22:00:00-04:00,0,9,22,0,1,1973,17190,19163
2015-09-07 23:00:00-04:00,0,9,23,0,1,2273,17123,19396
2015-09-08 00:00:00-04:00,0,9,0,1,0,2363,16493,18856
2015-09-08 01:00:00-04:00,0,9,1,1,0,2459,18002,20461
2015-09-08 02:00:00-04:00,0,9,2,1,0,2698,18610,21308
2015-09-08 03:00:00-04:00,0,9,3,1,0,2440,18173,20613
2015-09-08 04:00:00-04:00,0,9,4,1,0,2466,17001,19467
2015-09-08 05:00:00-04:00,0,9,5,1,0,2318,16325,18643
2015-09-08 06:00:00-04:00,0,9,6,1,0,2233,14615,16848
2015-09-08 07:00:00-04:00,0,9,7,1,0,1941,11228,13169
2015-09-08 08:00:00-04:00,0,9,8,1,0,1365,7082,8447
2015-09-08 09:00:00-04:00,0,9,9,1,0,843,3935,4778
2015-09-08 10:00:00-04:00,0,9,10,1,0,559,2384,2943
2015-09-08 11:00:00-04:00,0,9,11,1,0,408,1609,2017
2015-09-08 12:00:00-04:00,0,9,12,1,0,430,1982,2412
2015-09-08 13:00:00-04:00,0,9,13,1,0,421,4226,4647
2015-09-08 14:00:00-04:00,0,9,14,1,0,762,10811,11573
2015-09-08 15:00:00-04:00,0,9,15,1,0,1619,18375,19994
2015-09-08 16:00:00-04:00,0,9,16,1,0,2318,20864,23182
2015-09-08 17:00:00-04:00,0,9,17,1,0,2280,20255,22535
2015-09-08 18:00:00-04:00,0,9,18,1,0,2007,18589,20596
2015-09-08 19:00:00-04:00,0,9,19,1,0,1897,18880,20777
2015-09-08 20:00:00-04:00,0,9,20,1,0,1918,19508,21426
2015-09-08 21:00:00-04:00,0,9,21,1,0,1910,20037,21947
2015-09-08 22:00:00-04:00,0,9,22,1,0,2068,20698,22766
2015-09-08 23:00:00-04:00,0,9,23,1,0,2294,19847,22141
2015-09-09 00:00:00-04:00,0,9,0,2,0,2494,17118,19612
2015-09-09 01:00:00-04:00,0,9,1,2,0,2708,20150,22858
2015-09-09 02:00:00-04:00,0,9,2,2,0,2973,24498,27471
2015-09-09 03:00:00-04:00,0,9,3,2,0,2918,24756,27674
2015-09-09 04:00:00-04:00,0,9,4,2,0,2691,23599,26290
2015-09-09 05:00:00-04:00,0,9,5,2,0,2299,21920,24219
2015-09-09 06:00:00-04:00,0,9,6,2,0,2083,19437,21520
2015-09-09 07:00:00-04:00,0,9,7,2,0,1733,14336,16069
2015-09-09 08:00:00-04:00,0,9,8,2,0,1267,9762,11029
2015-09-09 09:00:00-04:00,0,9,9,2,0,896,5673,6569
2015-09-09 10:00:00-04:00,0,9,10,2,0,516,3613,4129
2015-09-09 11:00:00-04:00,0,9,11,2,0,359,2281,2640
2015-09-09 12:00:00-04:00,0,9,12,2,0,386,2291,2677
2015-09-09 13:00:00-04:00,0,9,13,2,0,377,3923,4300
2015-09-09 14:00:00-04:00,0,9,14,2,0,810,10956,11766
2015-09-09 15:00:00-04:00,0,9,15,2,0,2040,20366,22406
2015-09-09 16:00:00-04:00,0,9,16,2,0,2720,22331,25051
2015-09-09 17:00:00-04:00,0,9,17,2,0,2502,21365,23867
2015-09-09 18:00:00-04:00,0,9,18,2,0,2182,20301,22483
2015-09-09 19:00:00-04:00,0,9,19,2,0,1979,19990,21969
2015-09-09 20:00:00-04:00,0,9,20,2,0,2010,20527,22537
2015-09-09 21:00:00-04:00,0,9,21,2,0,2080,20349,22429
2015-09-09 22:00:00-04:00,0,9,22,2,0,2312,21158,23470
2015-09-09 23:00:00-04:00,0,9,23,2,0,2480,19521,22001
2015-09-10 00:00:00-04:00,0.14,9,0,3,0,3129,15727,18856
2015-09-10 01:00:00-04:00,0.06,9,1,3,0,2725,17708,20433
2015-09-10 02:00:00-04:00,0.04,9,2,3,0,3070,22905,25975
2015-09-10 03:00:00-04:00,0.02,9,3,3,0,2870,24826,27696
2015-09-10 04:00:00-04:00,0.23,9,4,3,0,2768,25020,27788
2015-09-10 05:00:00-04:00,0.09,9,5,3,0,2586,24256,26842
2015-09-10 06:00:00-04:00,0,9,6,3,0,2687,23470,26157
2015-09-10 07:00:00-04:00,0.08,9,7,3,0,2026,18343,20369
2015-09-10 08:00:00-04:00,0.04,9,8,3,0,1516,12878,14394
2015-09-10 09:00:00-04:00,0,9,9,3,0,1104,7822,8926
2015-09-10 10:00:00-04:00,0,9,10,3,0,670,4358,5028
2015-09-10 11:00:00-04:00,0.01,9,11,3,0,476,3080,3556
2015-09-10 12:00:00-04:00,0,9,12,3,0,482,3042,3524
2015-09-10 13:00:00-04:00,0,9,13,3,0,410,4319,4729
2015-09-10 14:00:00-04:00,0,9,14,3,0,881,11999,12880
2015-09-10 15:00:00-04:00,0,9,15,3,0,2151,21368,23519
2015-09-10 16:00:00-04:00,0,9,16,3,0,2904,21897,24801
2015-09-10 17:00:00-04:00,0,9,17,3,0,2646,21176,23822
2015-09-10 18:00:00-04:00,0.09,9,18,3,0,2357,19530,21887
2015-09-10 19:00:00-04:00,0,9,19,3,0,2067,19003,21070
2015-09-10 20:00:00-04:00,0.01,9,20,3,0,2013,19322,21335
2015-09-10 21:00:00-04:00,0.06,9,21,3,0,1983,18975,20958
2015-09-10 22:00:00-04:00,0.1,9,22,3,0,2444,19807,22251
2015-09-10 23:00:00-04:00,0.21,9,23,3,0,2583,16928,19511
2015-09-11 00:00:00-04:00,0,9,0,4,0,2697,13654,16351
2015-09-11 01:00:00-04:00,0,9,1,4,0,3521,18797,22318
2015-09-11 02:00:00-04:00,0,9,2,4,0,4150,22966,27116
2015-09-11 03:00:00-04:00,0,9,3,4,0,3562,23548,27110
2015-09-11 04:00:00-04:00,0,9,4,4,0,3573,25527,29100
2015-09-11 05:00:00-04:00,0,9,5,4,0,3312,24974,28286
2015-09-11 06:00:00-04:00,0,9,6,4,0,2878,23927,26805
2015-09-11 07:00:00-04:00,0,9,7,4,0,2677,22374,25051
2015-09-11 08:00:00-04:00,0,9,8,4,0,1879,15983,17862
2015-09-11 09:00:00-04:00,0,9,9,4,0,1379,10216,11595
2015-09-11 10:00:00-04:00,0,9,10,4,0,836,6822,7658
2015-09-11 11:00:00-04:00,0,9,11,4,0,643,4741,5384
2015-09-11 12:00:00-04:00,0,9,12,4,0,478,3900,4378
2015-09-11 13:00:00-04:00,0,9,13,4,0,438,4546,4984
2015-09-11 14:00:00-04:00,0,9,14,4,0,894,11290,12184
2015-09-11 15:00:00-04:00,0,9,15,4,0,1929,19592,21521
2015-09-11 16:00:00-04:00,0,9,16,4,0,2474,20718,23192
2015-09-11 17:00:00-04:00,0,9,17,4,0,2570,20403,22973
2015-09-11 18:00:00-04:00,0,9,18,4,0,2215,19257,21472
2015-09-11 19:00:00-04:00,0,9,19,4,0,2177,19040,21217
2015-09-11 20:00:00-04:00,0,9,20,4,0,1923,18978,20901
2015-09-11 21:00:00-04:00,0,9,21,4,0,1929,18123,20052
2015-09-11 22:00:00-04:00,0,9,22,4,0,2405,19776,22181
2015-09-11 23:00:00-04:00,0,9,23,4,0,2728,18068,20796
2015-09-12 00:00:00-04:00,0,9,0,5,0,2932,14366,17298
2015-09-12 01:00:00-04:00,0,9,1,5,0,3366,17751,21117
2015-09-12 02:00:00-04:00,0,9,2,5,0,3837,22856,26693
2015-09-12 03:00:00-04:00,0,9,3,5,0,3916,26076,29992
2015-09-12 04:00:00-04:00,0,9,4,5,0,3892,25446,29338
2015-09-12 05:00:00-04:00,0,9,5,5,0,3927,24446,28373
2015-09-12 06:00:00-04:00,0,9,6,5,0,3927,24874,28801
2015-09-12 07:00:00-04:00,0,9,7,5,0,3999,24509,28508
2015-09-12 08:00:00-04:00,0,9,8,5,0,3934,22498,26432
2015-09-12 09:00:00-04:00,0,9,9,5,0,3511,20846,24357
2015-09-12 10:00:00-04:00,0,9,10,5,0,3018,17832,20850
2015-09-12 11:00:00-04:00,0,9,11,5,0,2416,13267,15683
2015-09-12 12:00:00-04:00,0,9,12,5,0,1786,8377,10163
2015-09-12 13:00:00-04:00,0,9,13,5,0,849,4083,4932
2015-09-12 14:00:00-04:00,0,9,14,5,0,767,5266,6033
2015-09-12 15:00:00-04:00,0,9,15,5,0,981,7680,8661
2015-09-12 16:00:00-04:00,0,9,16,5,0,1280,11283,12563
2015-09-12 17:00:00-04:00,0.01,9,17,5,0,1746,15353,17099
2015-09-12 18:00:00-04:00,0.01,9,18,5,0,2051,18306,20357
2015-09-12 19:00:00-04:00,0,9,19,5,0,2245,20707,22952
2015-09-12 20:00:00-04:00,0.1,9,20,5,0,2419,20975,23394
2015-09-12 21:00:00-04:00,0,9,21,5,0,2364,20609,22973
2015-09-12 22:00:00-04:00,0,9,22,5,0,2607,20333,22940
2015-09-12 23:00:00-04:00,0.02,9,23,5,0,2982,20758,23740
2015-09-13 00:00:00-04:00,0,9,0,6,0,3311,18763,22074
2015-09-13 01:00:00-04:00,0.08,9,1,6,0,3810,21791,25601
2015-09-13 02:00:00-04:00,0,9,2,6,0,3961,24879,28840
2015-09-13 03:00:00-04:00,0,9,3,6,0,4218,25116,29334
2015-09-13 04:00:00-04:00,0,9,4,6,0,4334,24659,28993
2015-09-13 05:00:00-04:00,0,9,5,6,0,3803,20979,24782
2015-09-13 06:00:00-04:00,0,9,6,6,0,4113,23419,27532
2015-09-13 07:00:00-04:00,0,9,7,6,0,4456,26085,30541
2015-09-13 08:00:00-04:00,0,9,8,6,0,3997,22544,26541
2015-09-13 09:00:00-04:00,0,9,9,6,0,3618,20969,24587
2015-09-13 10:00:00-04:00,0,9,10,6,0,3182,18067,21249
2015-09-13 11:00:00-04:00,0,9,11,6,0,2539,13343,15882
2015-09-13 12:00:00-04:00,0,9,12,6,0,1937,8578,10515
2015-09-13 13:00:00-04:00,0,9,13,6,0,913,3959,4872
2015-09-13 14:00:00-04:00,0,9,14,6,0,636,4274,4910
2015-09-13 15:00:00-04:00,0,9,15,6,0,762,5680,6442
2015-09-13 16:00:00-04:00,0,9,16,6,0,981,9290,10271
2015-09-13 17:00:00-04:00,0,9,17,6,0,1311,12316,13627
2015-09-13 18:00:00-04:00,0,9,18,6,0,1719,16472,18191
2015-09-13 19:00:00-04:00,0,9,19,6,0,1995,19131,21126
2015-09-13 20:00:00-04:00,0,9,20,6,0,2236,20370,22606
2015-09-13 21:00:00-04:00,0,9,21,6,0,2177,20133,22310
2015-09-13 22:00:00-04:00,0,9,22,6,0,2480,20537,23017
2015-09-13 23:00:00-04:00,0,9,23,6,0,3049,21374,24423
2015-09-14 00:00:00-04:00,0,9,0,0,0,3015,19445,22460
2015-09-14 01:00:00-04:00,0,9,1,0,0,3020,20372,23392
2015-09-14 02:00:00-04:00,0,9,2,0,0,2977,20478,23455
2015-09-14 03:00:00-04:00,0,9,3,0,0,2833,20108,22941
2015-09-14 04:00:00-04:00,0,9,4,0,0,2697,18119,20816
2015-09-14 05:00:00-04:00,0,9,5,0,0,2607,17451,20058
2015-09-14 06:00:00-04:00,0,9,6,0,0,2562,16098,18660
2015-09-14 07:00:00-04:00,0,9,7,0,0,2271,13888,16159
2015-09-14 08:00:00-04:00,0,9,8,0,0,1585,8981,10566
2015-09-14 09:00:00-04:00,0,9,9,0,0,1048,5185,6233
2015-09-14 10:00:00-04:00,0,9,10,0,0,721,3289,4010
2015-09-14 11:00:00-04:00,0,9,11,0,0,564,2438,3002
2015-09-14 12:00:00-04:00,0,9,12,0,0,596,2692,3288
2015-09-14 13:00:00-04:00,0,9,13,0,0,451,3942,4393
2015-09-14 14:00:00-04:00,0,9,14,0,0,716,9352,10068
2015-09-14 15:00:00-04:00,0,9,15,0,0,1325,14650,15975
2015-09-14 16:00:00-04:00,0,9,16,0,0,2048,17424,19472
2015-09-14 17:00:00-04:00,0,9,17,0,0,2081,17788,19869
2015-09-14 18:00:00-04:00,0,9,18,0,0,1744,16945,18689
2015-09-14 19:00:00-04:00,0,9,19,0,0,1662,16399,18061
2015-09-14 20:00:00-04:00,0,9,20,0,0,1662,17453,19115
2015-09-14 21:00:00-04:00,0,9,21,0,0,1646,17782,19428
2015-09-14 22:00:00-04:00,0,9,22,0,0,1804,18018,19822
2015-09-14 23:00:00-04:00,0,9,23,0,0,2032,17914,19946
2015-09-15 00:00:00-04:00,0,9,0,1,0,2142,16501,18643
2015-09-15 01:00:00-04:00,0,9,1,1,0,2291,19263,21554
2015-09-15 02:00:00-04:00,0,9,2,1,0,2568,22556,25124
2015-09-15 03:00:00-04:00,0,9,3,1,0,2478,22887,25365
2015-09-15 04:00:00-04:00,0,9,4,1,0,2332,21386,23718
2015-09-15 05:00:00-04:00,0,9,5,1,0,2076,20055,22131
2015-09-15 06:00:00-04:00,0,9,6,1,0,1966,18511,20477
2015-09-15 07:00:00-04:00,0,9,7,1,0,1661,14463,16124
2015-09-15 08:00:00-04:00,0,9,8,1,0,1323,8901,10224
2015-09-15 09:00:00-04:00,0,9,9,1,0,987,5784,6771
2015-09-15 10:00:00-04:00,0,9,10,1,0,660,3712,4372
2015-09-15 11:00:00-04:00,0,9,11,1,0,435,2398,2833
2015-09-15 12:00:00-04:00,0,9,12,1,0,421,2430,2851
2015-09-15 13:00:00-04:00,0,9,13,1,0,366,3896,4262
2015-09-15 14:00:00-04:00,0,9,14,1,0,690,9948,10638
2015-09-15 15:00:00-04:00,0,9,15,1,0,1296,17327,18623
2015-09-15 16:00:00-04:00,0,9,16,1,0,2082,19598,21680
2015-09-15 17:00:00-04:00,0,9,17,1,0,2180,19558,21738
2015-09-15 18:00:00-04:00,0,9,18,1,0,1806,17719,19525
2015-09-15 19:00:00-04:00,0,9,19,1,0,1780,17728,19508
2015-09-15 20:00:00-04:00,0,9,20,1,0,1643,18506,20149
2015-09-15 21:00:00-04:00,0,9,21,1,0,1787,18912,20699
2015-09-15 22:00:00-04:00,0,9,22,1,0,2033,19858,21891
2015-09-15 23:00:00-04:00,0,9,23,1,0,2181,19010,21191
2015-09-16 00:00:00-04:00,0,9,0,2,0,2180,16055,18235
2015-09-16 01:00:00-04:00,0,9,1,2,0,2479,19358,21837
2015-09-16 02:00:00-04:00,0,9,2,2,0,2975,24239,27214
2015-09-16 03:00:00-04:00,0,9,3,2,0,2848,25431,28279
2015-09-16 04:00:00-04:00,0,9,4,2,0,2659,24740,27399
2015-09-16 05:00:00-04:00,0,9,5,2,0,2355,23833,26188
2015-09-16 06:00:00-04:00,0,9,6,2,0,2114,21598,23712
2015-09-16 07:00:00-04:00,0,9,7,2,0,1878,17113,18991
2015-09-16 08:00:00-04:00,0,9,8,2,0,1483,11087,12570
2015-09-16 09:00:00-04:00,0,9,9,2,0,1065,6965,8030
2015-09-16 10:00:00-04:00,0,9,10,2,0,659,4484,5143
2015-09-16 11:00:00-04:00,0,9,11,2,0,511,3000,3511
2015-09-16 12:00:00-04:00,0,9,12,2,0,456,2851,3307
2015-09-16 13:00:00-04:00,0,9,13,2,0,378,4144,4522
2015-09-16 14:00:00-04:00,0,9,14,2,0,782,11185,11967
2015-09-16 15:00:00-04:00,0,9,15,2,0,1894,19943,21837
2015-09-16 16:00:00-04:00,0,9,16,2,0,2614,21717,24331
2015-09-16 17:00:00-04:00,0,9,17,2,0,2520,20543,23063
2015-09-16 18:00:00-04:00,0,9,18,2,0,2117,19153,21270
2015-09-16 19:00:00-04:00,0,9,19,2,0,1972,19194,21166
2015-09-16 20:00:00-04:00,0,9,20,2,0,1981,19389,21370
2015-09-16 21:00:00-04:00,0,9,21,2,0,1901,19394,21295
2015-09-16 22:00:00-04:00,0,9,22,2,0,2320,20337,22657
2015-09-16 23:00:00-04:00,0,9,23,2,0,2416,18674,21090
2015-09-17 00:00:00-04:00,0,9,0,3,0,2500,15282,17782
2015-09-17 01:00:00-04:00,0,9,1,3,0,2940,18972,21912
2015-09-17 02:00:00-04:00,0,9,2,3,0,3171,23794,26965
2015-09-17 03:00:00-04:00,0,9,3,3,0,3123,25818,28941
2015-09-17 04:00:00-04:00,0,9,4,3,0,2815,25825,28640
2015-09-17 05:00:00-04:00,0,9,5,3,0,2675,25426,28101
2015-09-17 06:00:00-04:00,0,9,6,3,0,2406,23730,26136
2015-09-17 07:00:00-04:00,0,9,7,3,0,2125,19522,21647
2015-09-17 08:00:00-04:00,0,9,8,3,0,1768,14299,16067
2015-09-17 09:00:00-04:00,0,9,9,3,0,1154,8465,9619
2015-09-17 10:00:00-04:00,0,9,10,3,0,733,5107,5840
2015-09-17 11:00:00-04:00,0,9,11,3,0,565,3324,3889
2015-09-17 12:00:00-04:00,0,9,12,3,0,565,3163,3728
2015-09-17 13:00:00-04:00,0,9,13,3,0,443,4361,4804
2015-09-17 14:00:00-04:00,0,9,14,3,0,801,11252,12053
2015-09-17 15:00:00-04:00,0,9,15,3,0,1879,20099,21978
2015-09-17 16:00:00-04:00,0,9,16,3,0,2491,21872,24363
2015-09-17 17:00:00-04:00,0,9,17,3,0,2471,20561,23032
2015-09-17 18:00:00-04:00,0,9,18,3,0,2111,19533,21644
2015-09-17 19:00:00-04:00,0,9,19,3,0,1948,19432,21380
2015-09-17 20:00:00-04:00,0,9,20,3,0,1927,19925,21852
2015-09-17 21:00:00-04:00,0,9,21,3,0,1932,19663,21595
2015-09-17 22:00:00-04:00,0,9,22,3,0,2441,20361,22802
2015-09-17 23:00:00-04:00,0,9,23,3,0,2636,18429,21065
2015-09-18 00:00:00-04:00,0,9,0,4,0,2709,14627,17336
2015-09-18 01:00:00-04:00,0,9,1,4,0,3096,18344,21440
2015-09-18 02:00:00-04:00,0,9,2,4,0,3478,23881,27359
2015-09-18 03:00:00-04:00,0,9,3,4,0,3486,26133,29619
2015-09-18 04:00:00-04:00,0,9,4,4,0,3202,25960,29162
2015-09-18 05:00:00-04:00,0,9,5,4,0,2901,25857,28758
2015-09-18 06:00:00-04:00,0,9,6,4,0,2720,24734,27454
2015-09-18 07:00:00-04:00,0,9,7,4,0,2507,21530,24037
2015-09-18 08:00:00-04:00,0,9,8,4,0,2159,17758,19917
2015-09-18 09:00:00-04:00,0,9,9,4,0,1554,11510,13064
2015-09-18 10:00:00-04:00,0,9,10,4,0,1164,7713,8877
2015-09-18 11:00:00-04:00,0,9,11,4,0,786,5196,5982
2015-09-18 12:00:00-04:00,0,9,12,4,0,717,4166,4883
2015-09-18 13:00:00-04:00,0,9,13,4,0,523,4535,5058
2015-09-18 14:00:00-04:00,0,9,14,4,0,810,11097,11907
2015-09-18 15:00:00-04:00,0,9,15,4,0,1781,19337,21118
2015-09-18 16:00:00-04:00,0,9,16,4,0,2533,21362,23895
2015-09-18 17:00:00-04:00,0,9,17,4,0,2397,20456,22853
2015-09-18 18:00:00-04:00,0,9,18,4,0,2051,18853,20904
2015-09-18 19:00:00-04:00,0,9,19,4,0,2012,18980,20992
2015-09-18 20:00:00-04:00,0,9,20,4,0,1802,19173,20975
2015-09-18 21:00:00-04:00,0,9,21,4,0,1821,18418,20239
2015-09-18 22:00:00-04:00,0,9,22,4,0,2314,20078,22392
2015-09-18 23:00:00-04:00,0,9,23,4,0,2559,18276,20835
2015-09-19 00:00:00-04:00,0,9,0,5,0,3002,15488,18490
2015-09-19 01:00:00-04:00,0,9,1,5,0,3408,20298,23706
2015-09-19 02:00:00-04:00,0,9,2,5,0,3993,25637,29630
2015-09-19 03:00:00-04:00,0,9,3,5,0,4074,27528,31602
2015-09-19 04:00:00-04:00,0,9,4,5,0,3859,26174,30033
2015-09-19 05:00:00-04:00,0,9,5,5,0,3927,25013,28940
2015-09-19 06:00:00-04:00,0,9,6,5,0,4116,25934,30050
2015-09-19 07:00:00-04:00,0,9,7,5,0,4175,25159,29334
2015-09-19 08:00:00-04:00,0,9,8,5,0,3995,22992,26987
2015-09-19 09:00:00-04:00,0,9,9,5,0,3590,20410,24000
2015-09-19 10:00:00-04:00,0,9,10,5,0,3087,17573,20660
2015-09-19 11:00:00-04:00,0,9,11,5,0,2475,12867,15342
2015-09-19 12:00:00-04:00,0,9,12,5,0,1916,8209,10125
2015-09-19 13:00:00-04:00,0,9,13,5,0,946,4051,4997
2015-09-19 14:00:00-04:00,0,9,14,5,0,784,4985,5769
2015-09-19 15:00:00-04:00,0,9,15,5,0,1030,8103,9133
2015-09-19 16:00:00-04:00,0,9,16,5,0,1382,12879,14261
2015-09-19 17:00:00-04:00,0,9,17,5,0,1839,16384,18223
2015-09-19 18:00:00-04:00,0,9,18,5,0,2096,19147,21243
2015-09-19 19:00:00-04:00,0,9,19,5,0,2351,20820,23171
2015-09-19 20:00:00-04:00,0,9,20,5,0,2499,21686,24185
2015-09-19 21:00:00-04:00,0,9,21,5,0,2420,22191,24611
2015-09-19 22:00:00-04:00,0,9,22,5,0,2784,21001,23785
2015-09-19 23:00:00-04:00,0,9,23,5,0,3053,21379,24432
2015-09-20 00:00:00-04:00,0,9,0,6,0,3304,19053,22357
2015-09-20 01:00:00-04:00,0,9,1,6,0,3455,21847,25302
2015-09-20 02:00:00-04:00,0,9,2,6,0,4043,25778,29821
2015-09-20 03:00:00-04:00,0,9,3,6,0,4148,25433,29581
2015-09-20 04:00:00-04:00,0,9,4,6,0,3910,23202,27112
2015-09-20 05:00:00-04:00,0,9,5,6,0,4111,22643,26754
2015-09-20 06:00:00-04:00,0,9,6,6,0,4509,24024,28533
2015-09-20 07:00:00-04:00,0,9,7,6,0,4621,25886,30507
2015-09-20 08:00:00-04:00,0,9,8,6,0,4559,23645,28204
2015-09-20 09:00:00-04:00,0,9,9,6,0,4144,21781,25925
2015-09-20 10:00:00-04:00,0,9,10,6,0,3553,18712,22265
2015-09-20 11:00:00-04:00,0,9,11,6,0,2887,14359,17246
2015-09-20 12:00:00-04:00,0,9,12,6,0,2212,9056,11268
2015-09-20 13:00:00-04:00,0,9,13,6,0,1028,4333,5361
2015-09-20 14:00:00-04:00,0,9,14,6,0,807,5227,6034
2015-09-20 15:00:00-04:00,0,9,15,6,0,742,6011,6753
2015-09-20 16:00:00-04:00,0,9,16,6,0,980,10096,11076
2015-09-20 17:00:00-04:00,0,9,17,6,0,1398,13752,15150
2015-09-20 18:00:00-04:00,0,9,18,6,0,1695,17754,19449
2015-09-20 19:00:00-04:00,0,9,19,6,0,2059,19784,21843
2015-09-20 20:00:00-04:00,0,9,20,6,0,2193,20813,23006
2015-09-20 21:00:00-04:00,0,9,21,6,0,2170,20324,22494
2015-09-20 22:00:00-04:00,0,9,22,6,0,2438,20187,22625
2015-09-20 23:00:00-04:00,0,9,23,6,0,2590,19996,22586
2015-09-21 00:00:00-04:00,0,9,0,0,0,2690,19745,22435
2015-09-21 01:00:00-04:00,0,9,1,0,0,2897,20512,23409
2015-09-21 02:00:00-04:00,0,9,2,0,0,3028,22167,25195
2015-09-21 03:00:00-04:00,0,9,3,0,0,3058,21436,24494
2015-09-21 04:00:00-04:00,0,9,4,0,0,2774,18897,21671
2015-09-21 05:00:00-04:00,0,9,5,0,0,2582,17188,19770
2015-09-21 06:00:00-04:00,0,9,6,0,0,2447,14977,17424
2015-09-21 07:00:00-04:00,0,9,7,0,0,2251,12298,14549
2015-09-21 08:00:00-04:00,0,9,8,0,0,1568,7744,9312
2015-09-21 09:00:00-04:00,0,9,9,0,0,1039,4523,5562
2015-09-21 10:00:00-04:00,0,9,10,0,0,692,2777,3469
2015-09-21 11:00:00-04:00,0,9,11,0,0,535,1971,2506
2015-09-21 12:00:00-04:00,0,9,12,0,0,498,2358,2856
2015-09-21 13:00:00-04:00,0,9,13,0,0,457,4406,4863
2015-09-21 14:00:00-04:00,0,9,14,0,0,861,10792,11653
2015-09-21 15:00:00-04:00,0,9,15,0,0,1824,17875,19699
2015-09-21 16:00:00-04:00,0,9,16,0,0,2526,20073,22599
2015-09-21 17:00:00-04:00,0,9,17,0,0,2427,18799,21226
2015-09-21 18:00:00-04:00,0,9,18,0,0,1966,17249,19215
2015-09-21 19:00:00-04:00,0,9,19,0,0,1733,16894,18627
2015-09-21 20:00:00-04:00,0,9,20,0,0,1689,17131,18820
2015-09-21 21:00:00-04:00,0,9,21,0,0,1601,16765,18366
2015-09-21 22:00:00-04:00,0,9,22,0,0,1982,18803,20785
2015-09-21 23:00:00-04:00,0,9,23,0,0,2162,18587,20749
2015-09-22 00:00:00-04:00,0,9,0,1,0,2215,16520,18735
2015-09-22 01:00:00-04:00,0,9,1,1,0,2720,20303,23023
2015-09-22 02:00:00-04:00,0,9,2,1,0,2959,23787,26746
2015-09-22 03:00:00-04:00,0,9,3,1,0,2826,24391,27217
2015-09-22 04:00:00-04:00,0,9,4,1,0,2434,22950,25384
2015-09-22 05:00:00-04:00,0,9,5,1,0,2149,21665,23814
2015-09-22 06:00:00-04:00,0,9,6,1,0,1873,18696,20569
2015-09-22 07:00:00-04:00,0,9,7,1,0,1530,14007,15537
2015-09-22 08:00:00-04:00,0,9,8,1,0,1196,8709,9905
2015-09-22 09:00:00-04:00,0,9,9,1,0,772,4891,5663
2015-09-22 10:00:00-04:00,0,9,10,1,0,490,3124,3614
2015-09-22 11:00:00-04:00,0,9,11,1,0,342,2084,2426
2015-09-22 12:00:00-04:00,0,9,12,1,0,380,2114,2494
2015-09-22 13:00:00-04:00,0,9,13,1,0,366,3861,4227
2015-09-22 14:00:00-04:00,0,9,14,1,0,664,10764,11428
2015-09-22 15:00:00-04:00,0,9,15,1,0,1757,18634,20391
2015-09-22 16:00:00-04:00,0,9,16,1,0,2311,20697,23008
2015-09-22 17:00:00-04:00,0,9,17,1,0,2154,19322,21476
2015-09-22 18:00:00-04:00,0,9,18,1,0,1790,17246,19036
2015-09-22 19:00:00-04:00,0,9,19,1,0,1702,17465,19167
2015-09-22 20:00:00-04:00,0,9,20,1,0,1716,17733,19449
2015-09-22 21:00:00-04:00,0,9,21,1,0,1657,18171,19828
2015-09-22 22:00:00-04:00,0,9,22,1,0,2011,19549,21560
2015-09-22 23:00:00-04:00,0,9,23,1,0,2151,18458,20609
2015-09-23 00:00:00-04:00,0,9,0,2,0,2372,16394,18766
2015-09-23 01:00:00-04:00,0,9,1,2,0,2694,20878,23572
2015-09-23 02:00:00-04:00,0,9,2,2,0,2928,24650,27578
2015-09-23 03:00:00-04:00,0,9,3,2,0,2710,23530,26240
2015-09-23 04:00:00-04:00,0,9,4,2,0,2440,22659,25099
2015-09-23 05:00:00-04:00,0,9,5,2,0,2390,22365,24755
2015-09-23 06:00:00-04:00,0,9,6,2,0,2142,20055,22197
2015-09-23 07:00:00-04:00,0,9,7,2,0,1746,14449,16195
2015-09-23 08:00:00-04:00,0,9,8,2,0,1286,9338,10624
2015-09-23 09:00:00-04:00,0,9,9,2,0,929,5581,6510
2015-09-23 10:00:00-04:00,0,9,10,2,0,580,3733,4313
2015-09-23 11:00:00-04:00,0,9,11,2,0,446,2528,2974
2015-09-23 12:00:00-04:00,0,9,12,2,0,409,2343,2752
2015-09-23 13:00:00-04:00,0,9,13,2,0,349,3334,3683
2015-09-23 14:00:00-04:00,0,9,14,2,0,653,8813,9466
2015-09-23 15:00:00-04:00,0,9,15,2,0,1234,13700,14934
2015-09-23 16:00:00-04:00,0,9,16,2,0,1952,16710,18662
2015-09-23 17:00:00-04:00,0,9,17,2,0,2091,17424,19515
2015-09-23 18:00:00-04:00,0,9,18,2,0,1780,16945,18725
2015-09-23 19:00:00-04:00,0,9,19,2,0,1616,16004,17620
2015-09-23 20:00:00-04:00,0,9,20,2,0,1726,16738,18464
2015-09-23 21:00:00-04:00,0,9,21,2,0,1669,17635,19304
2015-09-23 22:00:00-04:00,0,9,22,2,0,1874,18258,20132
2015-09-23 23:00:00-04:00,0,9,23,2,0,2143,17373,19516
2015-09-24 00:00:00-04:00,0,9,0,3,0,2245,16326,18571
2015-09-24 01:00:00-04:00,0,9,1,3,0,2712,19868,22580
2015-09-24 02:00:00-04:00,0,9,2,3,0,2903,23800,26703
2015-09-24 03:00:00-04:00,0,9,3,3,0,2854,25530,28384
2015-09-24 04:00:00-04:00,0,9,4,3,0,2705,24371,27076
2015-09-24 05:00:00-04:00,0,9,5,3,0,2539,24076,26615
2015-09-24 06:00:00-04:00,0,9,6,3,0,2407,21876,24283
2015-09-24 07:00:00-04:00,0,9,7,3,0,2069,16286,18355
2015-09-24 08:00:00-04:00,0,9,8,3,0,1597,10282,11879
2015-09-24 09:00:00-04:00,0,9,9,3,0,1051,6308,7359
2015-09-24 10:00:00-04:00,0,9,10,3,0,671,4124,4795
2015-09-24 11:00:00-04:00,0,9,11,3,0,547,2664,3211
2015-09-24 12:00:00-04:00,0,9,12,3,0,450,2596,3046
2015-09-24 13:00:00-04:00,0,9,13,3,0,342,4040,4382
2015-09-24 14:00:00-04:00,0,9,14,3,0,650,9291,9941
2015-09-24 15:00:00-04:00,0,9,15,3,0,1179,13216,14395
2015-09-24 16:00:00-04:00,0,9,16,3,0,1831,14742,16573
2015-09-24 17:00:00-04:00,0,9,17,3,0,1944,14984,16928
2015-09-24 18:00:00-04:00,0,9,18,3,0,1672,14588,16260
2015-09-24 19:00:00-04:00,0,9,19,3,0,1586,14882,16468
2015-09-24 20:00:00-04:00,0,9,20,3,0,1556,15081,16637
2015-09-24 21:00:00-04:00,0,9,21,3,0,1587,14833,16420
2015-09-24 22:00:00-04:00,0,9,22,3,0,1739,15801,17540
2015-09-24 23:00:00-04:00,0,9,23,3,0,1959,15702,17661
2015-09-25 00:00:00-04:00,0,9,0,4,0,2131,14418,16549
2015-09-25 01:00:00-04:00,0,9,1,4,0,2572,17171,19743
2015-09-25 02:00:00-04:00,0,9,2,4,0,2780,19422,22202
2015-09-25 03:00:00-04:00,0,9,3,4,0,2779,20901,23680
2015-09-25 04:00:00-04:00,0,9,4,4,0,2678,21166,23844
2015-09-25 05:00:00-04:00,0,9,5,4,0,2426,20366,22792
2015-09-25 06:00:00-04:00,0,9,6,4,0,2302,20004,22306
2015-09-25 07:00:00-04:00,0,9,7,4,0,2133,18164,20297
2015-09-25 08:00:00-04:00,0,9,8,4,0,1749,15031,16780
2015-09-25 09:00:00-04:00,0,9,9,4,0,1314,10437,11751
2015-09-25 10:00:00-04:00,0,9,10,4,0,867,6481,7348
2015-09-25 11:00:00-04:00,0,9,11,4,0,623,4559,5182
2015-09-25 12:00:00-04:00,0,9,12,4,0,502,3625,4127
2015-09-25 13:00:00-04:00,0,9,13,4,0,415,4265,4680
2015-09-25 14:00:00-04:00,0,9,14,4,0,793,9217,10010
2015-09-25 15:00:00-04:00,0,9,15,4,0,1701,14590,16291
2015-09-25 16:00:00-04:00,0,9,16,4,0,2260,15865,18125
2015-09-25 17:00:00-04:00,0,9,17,4,0,2280,15129,17409
2015-09-25 18:00:00-04:00,0,9,18,4,0,1951,13838,15789
2015-09-25 19:00:00-04:00,0,9,19,4,0,1813,14525,16338
2015-09-25 20:00:00-04:00,0,9,20,4,0,1736,14336,16072
2015-09-25 21:00:00-04:00,0,9,21,4,0,1776,14833,16609
2015-09-25 22:00:00-04:00,0,9,22,4,0,2265,16295,18560
2015-09-25 23:00:00-04:00,0,9,23,4,0,2544,15860,18404
2015-09-26 00:00:00-04:00,0,9,0,5,0,2764,15119,17883
2015-09-26 01:00:00-04:00,0,9,1,5,0,3376,17583,20959
2015-09-26 02:00:00-04:00,0,9,2,5,0,3911,22107,26018
2015-09-26 03:00:00-04:00,0,9,3,5,0,4004,24137,28141
2015-09-26 04:00:00-04:00,0,9,4,5,0,3680,23415,27095
2015-09-26 05:00:00-04:00,0,9,5,5,0,3762,23284,27046
2015-09-26 06:00:00-04:00,0,9,6,5,0,4010,25352,29362
2015-09-26 07:00:00-04:00,0,9,7,5,0,4084,25307,29391
2015-09-26 08:00:00-04:00,0,9,8,5,0,3944,22614,26558
2015-09-26 09:00:00-04:00,0,9,9,5,0,3423,19752,23175
2015-09-26 10:00:00-04:00,0,9,10,5,0,2816,16258,19074
2015-09-26 11:00:00-04:00,0,9,11,5,0,2343,12003,14346
2015-09-26 12:00:00-04:00,0,9,12,5,0,1682,7628,9310
2015-09-26 13:00:00-04:00,0,9,13,5,0,851,3833,4684
2015-09-26 14:00:00-04:00,0,9,14,5,0,745,5011,5756
2015-09-26 15:00:00-04:00,0,9,15,5,0,916,7675,8591
2015-09-26 16:00:00-04:00,0,9,16,5,0,1289,12065,13354
2015-09-26 17:00:00-04:00,0,9,17,5,0,1728,15553,17281
2015-09-26 18:00:00-04:00,0,9,18,5,0,2012,18251,20263
2015-09-26 19:00:00-04:00,0,9,19,5,0,2180,20007,22187
2015-09-26 20:00:00-04:00,0,9,20,5,0,2396,21078,23474
2015-09-26 21:00:00-04:00,0,9,21,5,0,2473,21125,23598
2015-09-26 22:00:00-04:00,0,9,22,5,0,2656,20726,23382
2015-09-26 23:00:00-04:00,0,9,23,5,0,2958,20798,23756
2015-09-27 00:00:00-04:00,0,9,0,6,0,3058,18053,21111
2015-09-27 01:00:00-04:00,0,9,1,6,0,3506,20551,24057
2015-09-27 02:00:00-04:00,0,9,2,6,0,3710,23138,26848
2015-09-27 03:00:00-04:00,0,9,3,6,0,4172,23834,28006
2015-09-27 04:00:00-04:00,0,9,4,6,0,3960,22207,26167
2015-09-27 05:00:00-04:00,0,9,5,6,0,4189,23042,27231
2015-09-27 06:00:00-04:00,0,9,6,6,0,4246,25958,30204
2015-09-27 07:00:00-04:00,0,9,7,6,0,4341,26172,30513
2015-09-27 08:00:00-04:00,0,9,8,6,0,4234,24518,28752
2015-09-27 09:00:00-04:00,0,9,9,6,0,3908,21916,25824
2015-09-27 10:00:00-04:00,0,9,10,6,0,3363,18745,22108
2015-09-27 11:00:00-04:00,0,9,11,6,0,2649,13930,16579
2015-09-27 12:00:00-04:00,0,9,12,6,0,2016,8839,10855
2015-09-27 13:00:00-04:00,0,9,13,6,0,995,3983,4978
2015-09-27 14:00:00-04:00,0,9,14,6,0,753,4652,5405
2015-09-27 15:00:00-04:00,0,9,15,6,0,782,6529,7311
2015-09-27 16:00:00-04:00,0,9,16,6,0,965,9464,10429
2015-09-27 17:00:00-04:00,0,9,17,6,0,1373,13122,14495
2015-09-27 18:00:00-04:00,0,9,18,6,0,1765,17151,18916
2015-09-27 19:00:00-04:00,0,9,19,6,0,1956,19834,21790
2015-09-27 20:00:00-04:00,0,9,20,6,0,2160,20278,22438
2015-09-27 21:00:00-04:00,0,9,21,6,0,2043,20056,22099
2015-09-27 22:00:00-04:00,0,9,22,6,0,2299,19514,21813
2015-09-27 23:00:00-04:00,0,9,23,6,0,2622,19182,21804
2015-09-28 00:00:00-04:00,0,9,0,0,0,2778,17783,20561
2015-09-28 01:00:00-04:00,0,9,1,0,0,2888,18365,21253
2015-09-28 02:00:00-04:00,0,9,2,0,0,2993,19425,22418
2015-09-28 03:00:00-04:00,0,9,3,0,0,2937,18956,21893
2015-09-28 04:00:00-04:00,0,9,4,0,0,2648,17364,20012
2015-09-28 05:00:00-04:00,0,9,5,0,0,2423,17107,19530
2015-09-28 06:00:00-04:00,0,9,6,0,0,2340,15602,17942
2015-09-28 07:00:00-04:00,0,9,7,0,0,1966,12279,14245
2015-09-28 08:00:00-04:00,0,9,8,0,0,1423,7563,8986
2015-09-28 09:00:00-04:00,0,9,9,0,0,916,4523,5439
2015-09-28 10:00:00-04:00,0,9,10,0,0,622,2818,3440
2015-09-28 11:00:00-04:00,0,9,11,0,0,451,2047,2498
2015-09-28 12:00:00-04:00,0,9,12,0,0,506,2460,2966
2015-09-28 13:00:00-04:00,0,9,13,0,0,465,4258,4723
2015-09-28 14:00:00-04:00,0,9,14,0,0,780,10433,11213
2015-09-28 15:00:00-04:00,0,9,15,0,0,1784,16135,17919
2015-09-28 16:00:00-04:00,0,9,16,0,0,2418,17285,19703
2015-09-28 17:00:00-04:00,0,9,17,0,0,2328,15243,17571
2015-09-28 18:00:00-04:00,0,9,18,0,0,1934,13648,15582
2015-09-28 19:00:00-04:00,0,9,19,0,0,1740,14627,16367
2015-09-28 20:00:00-04:00,0,9,20,0,0,1761,15367,17128
2015-09-28 21:00:00-04:00,0,9,21,0,0,1805,15621,17426
2015-09-28 22:00:00-04:00,0,9,22,0,0,2038,16418,18456
2015-09-28 23:00:00-04:00,0,9,23,0,0,2208,16187,18395
2015-09-29 00:00:00-04:00,0,9,0,1,0,2300,14589,16889
2015-09-29 01:00:00-04:00,0,9,1,1,0,2596,17971,20567
2015-09-29 02:00:00-04:00,0,9,2,1,0,2917,20902,23819
2015-09-29 03:00:00-04:00,0,9,3,1,0,2845,20684,23529
2015-09-29 04:00:00-04:00,0,9,4,1,0,2387,20617,23004
2015-09-29 05:00:00-04:00,0,9,5,1,0,2183,20815,22998
2015-09-29 06:00:00-04:00,0,9,6,1,0,1899,19110,21009
2015-09-29 07:00:00-04:00,0,9,7,1,0,1548,13954,15502
2015-09-29 08:00:00-04:00,0,9,8,1,0,1163,8939,10102
2015-09-29 09:00:00-04:00,0,9,9,1,0,809,5107,5916
2015-09-29 10:00:00-04:00,0,9,10,1,0,501,3011,3512
2015-09-29 11:00:00-04:00,0,9,11,1,0,354,2068,2422
2015-09-29 12:00:00-04:00,0,9,12,1,0,381,2196,2577
2015-09-29 13:00:00-04:00,0,9,13,1,0,387,4060,4447
2015-09-29 14:00:00-04:00,0,9,14,1,0,730,10768,11498
2015-09-29 15:00:00-04:00,0,9,15,1,0,1738,18104,19842
2015-09-29 16:00:00-04:00,0.01,9,16,1,0,2436,19373,21809
2015-09-29 17:00:00-04:00,0,9,17,1,0,2253,17751,20004
2015-09-29 18:00:00-04:00,0,9,18,1,0,1941,15911,17852
2015-09-29 19:00:00-04:00,0,9,19,1,0,1888,16385,18273
2015-09-29 20:00:00-04:00,0,9,20,1,0,1841,17047,18888
2015-09-29 21:00:00-04:00,0,9,21,1,0,1804,16594,18398
2015-09-29 22:00:00-04:00,0.05,9,22,1,0,1984,18110,20094
2015-09-29 23:00:00-04:00,0.01,9,23,1,0,2370,17040,19410
2015-09-30 00:00:00-04:00,0.01,9,0,2,0,2598,14938,17536
2015-09-30 01:00:00-04:00,0.07,9,1,2,0,2880,18863,21743
2015-09-30 02:00:00-04:00,0.56,9,2,2,0,3087,22670,25757
2015-09-30 03:00:00-04:00,0.27,9,3,2,0,2980,23744,26724
2015-09-30 04:00:00-04:00,0.05,9,4,2,0,2502,23759,26261
2015-09-30 05:00:00-04:00,0.02,9,5,2,0,2566,24324,26890
2015-09-30 06:00:00-04:00,0,9,6,2,0,2482,22411,24893
2015-09-30 07:00:00-04:00,0,9,7,2,0,1991,17305,19296
2015-09-30 08:00:00-04:00,0,9,8,2,0,1288,10934,12222
2015-09-30 09:00:00-04:00,0,9,9,2,0,990,6409,7399
2015-09-30 10:00:00-04:00,0.05,9,10,2,0,655,4177,4832
2015-09-30 11:00:00-04:00,0.01,9,11,2,0,420,2652,3072
2015-09-30 12:00:00-04:00,0,9,12,2,0,372,2414,2786
2015-09-30 13:00:00-04:00,0,9,13,2,0,379,4016,4395
2015-09-30 14:00:00-04:00,0,9,14,2,0,763,11041,11804
2015-09-30 15:00:00-04:00,0,9,15,2,0,1913,18558,20471
2015-09-30 16:00:00-04:00,0,9,16,2,0,2595,20794,23389
2015-09-30 17:00:00-04:00,0,9,17,2,0,2691,20071,22762
2015-09-30 18:00:00-04:00,0,9,18,2,0,2254,17508,19762
2015-09-30 19:00:00-04:00,0,9,19,2,0,1988,17294,19282
2015-09-30 20:00:00-04:00,0,9,20,2,0,1865,17442,19307
2015-09-30 21:00:00-04:00,0,9,21,2,0,1847,17388,19235
2015-09-30 22:00:00-04:00,0,9,22,2,0,2150,18358,20508
2015-09-30 23:00:00-04:00,0,9,23,2,0,2294,16966,19260
2015-10-01 00:00:00-04:00,0,10,0,3,0,2444,14720,17164
2015-10-01 01:00:00-04:00,0,10,1,3,0,2904,18967,21871
2015-10-01 02:00:00-04:00,0,10,2,3,0,3331,23049,26380
2015-10-01 03:00:00-04:00,0,10,3,3,0,3305,24471,27776
2015-10-01 04:00:00-04:00,0,10,4,3,0,2911,25320,28231
2015-10-01 05:00:00-04:00,0,10,5,3,0,2754,25611,28365
2015-10-01 06:00:00-04:00,0,10,6,3,0,2412,23978,26390
2015-10-01 07:00:00-04:00,0,10,7,3,0,2083,19216,21299
2015-10-01 08:00:00-04:00,0,10,8,3,0,1630,12510,14140
2015-10-01 09:00:00-04:00,0,10,9,3,0,1062,7542,8604
2015-10-01 10:00:00-04:00,0,10,10,3,0,754,4735,5489
2015-10-01 11:00:00-04:00,0,10,11,3,0,511,3017,3528
2015-10-01 12:00:00-04:00,0,10,12,3,0,455,2891,3346
2015-10-01 13:00:00-04:00,0,10,13,3,0,424,4327,4751
2015-10-01 14:00:00-04:00,0,10,14,3,0,792,10987,11779
2015-10-01 15:00:00-04:00,0,10,15,3,0,1889,19276,21165
2015-10-01 16:00:00-04:00,0,10,16,3,0,2671,21297,23968
2015-10-01 17:00:00-04:00,0.03,10,17,3,0,2544,19911,22455
2015-10-01 18:00:00-04:00,0.02,10,18,3,0,2228,18423,20651
2015-10-01 19:00:00-04:00,0.03,10,19,3,0,2042,18438,20480
2015-10-01 20:00:00-04:00,0,10,20,3,0,2070,18907,20977
2015-10-01 21:00:00-04:00,0.01,10,21,3,0,2095,18629,20724
2015-10-01 22:00:00-04:00,0,10,22,3,0,2398,19693,22091
2015-10-01 23:00:00-04:00,0,10,23,3,0,2828,18433,21261
2015-10-02 00:00:00-04:00,0,10,0,4,0,3239,14675,17914
2015-10-02 01:00:00-04:00,0,10,1,4,0,3905,18544,22449
2015-10-02 02:00:00-04:00,0,10,2,4,0,4381,22639,27020
2015-10-02 03:00:00-04:00,0,10,3,4,0,4201,23940,28141
2015-10-02 04:00:00-04:00,0.01,10,4,4,0,3569,24690,28259
2015-10-02 05:00:00-04:00,0.01,10,5,4,0,3304,24456,27760
2015-10-02 06:00:00-04:00,0,10,6,4,0,2827,24171,26998
2015-10-02 07:00:00-04:00,0.02,10,7,4,0,2521,21912,24433
2015-10-02 08:00:00-04:00,0.02,10,8,4,0,2008,16354,18362
2015-10-02 09:00:00-04:00,0.02,10,9,4,0,1368,10207,11575
2015-10-02 10:00:00-04:00,0.02,10,10,4,0,998,6614,7612
2015-10-02 11:00:00-04:00,0.03,10,11,4,0,669,4635,5304
2015-10-02 12:00:00-04:00,0.01,10,12,4,0,561,3672,4233
2015-10-02 13:00:00-04:00,0.11,10,13,4,0,434,4541,4975
2015-10-02 14:00:00-04:00,0.06,10,14,4,0,836,11026,11862
2015-10-02 15:00:00-04:00,0.07,10,15,4,0,1903,18930,20833
2015-10-02 16:00:00-04:00,0.14,10,16,4,0,2838,20874,23712
2015-10-02 17:00:00-04:00,0.17,10,17,4,0,2856,20447,23303
2015-10-02 18:00:00-04:00,0.14,10,18,4,0,2494,19092,21586
2015-10-02 19:00:00-04:00,0.1,10,19,4,0,2333,19638,21971
2015-10-02 20:00:00-04:00,0.05,10,20,4,0,2253,19375,21628
2015-10-02 21:00:00-04:00,0.07,10,21,4,0,2351,18999,21350
2015-10-02 22:00:00-04:00,0.07,10,22,4,0,2917,20587,23504
2015-10-02 23:00:00-04:00,0.07,10,23,4,0,3556,18526,22082
2015-10-03 00:00:00-04:00,0.07,10,0,5,0,4291,15825,20116
2015-10-03 01:00:00-04:00,0.07,10,1,5,0,4784,20362,25146
2015-10-03 02:00:00-04:00,0.07,10,2,5,0,5014,24024,29038
2015-10-03 03:00:00-04:00,0.09,10,3,5,0,5077,25406,30483
2015-10-03 04:00:00-04:00,0.09,10,4,5,0,4563,24172,28735
2015-10-03 05:00:00-04:00,0.01,10,5,5,0,4142,23899,28041
2015-10-03 06:00:00-04:00,0,10,6,5,0,3793,23528,27321
2015-10-03 07:00:00-04:00,0.01,10,7,5,0,3726,23556,27282
2015-10-03 08:00:00-04:00,0.01,10,8,5,0,3395,21362,24757
2015-10-03 09:00:00-04:00,0.01,10,9,5,0,3046,17153,20199
2015-10-03 10:00:00-04:00,0,10,10,5,0,2284,13714,15998
2015-10-03 11:00:00-04:00,0,10,11,5,0,1687,9516,11203
2015-10-03 12:00:00-04:00,0,10,12,5,0,1241,5952,7193
2015-10-03 13:00:00-04:00,0,10,13,5,0,660,3153,3813
2015-10-03 14:00:00-04:00,0,10,14,5,0,580,4419,4999
2015-10-03 15:00:00-04:00,0,10,15,5,0,882,7196,8078
2015-10-03 16:00:00-04:00,0,10,16,5,0,1270,10832,12102
2015-10-03 17:00:00-04:00,0,10,17,5,0,1794,15418,17212
2015-10-03 18:00:00-04:00,0,10,18,5,0,2048,17688,19736
2015-10-03 19:00:00-04:00,0,10,19,5,0,2350,19937,22287
2015-10-03 20:00:00-04:00,0,10,20,5,0,2447,20692,23139
2015-10-03 21:00:00-04:00,0,10,21,5,0,2477,21388,23865
2015-10-03 22:00:00-04:00,0,10,22,5,0,2776,22155,24931
2015-10-03 23:00:00-04:00,0,10,23,5,0,3138,22833,25971
2015-10-04 00:00:00-04:00,0,10,0,6,0,3227,19582,22809
2015-10-04 01:00:00-04:00,0,10,1,6,0,3489,21828,25317
2015-10-04 02:00:00-04:00,0,10,2,6,0,3577,23445,27022
2015-10-04 03:00:00-04:00,0,10,3,6,0,3920,24805,28725
2015-10-04 04:00:00-04:00,0,10,4,6,0,3659,20767,24426
2015-10-04 05:00:00-04:00,0,10,5,6,0,3660,20773,24433
2015-10-04 06:00:00-04:00,0,10,6,6,0,3733,23179,26912
2015-10-04 07:00:00-04:00,0,10,7,6,0,4046,24904,28950
2015-10-04 08:00:00-04:00,0,10,8,6,0,3980,23786,27766
2015-10-04 09:00:00-04:00,0,10,9,6,0,3580,21260,24840
2015-10-04 10:00:00-04:00,0,10,10,6,0,2990,18067,21057
2015-10-04 11:00:00-04:00,0,10,11,6,0,2555,13285,15840
2015-10-04 12:00:00-04:00,0,10,12,6,0,1905,8311,10216
2015-10-04 13:00:00-04:00,0,10,13,6,0,976,3760,4736
2015-10-04 14:00:00-04:00,0,10,14,6,0,642,3962,4604
2015-10-04 15:00:00-04:00,0,10,15,6,0,678,5447,6125
2015-10-04 16:00:00-04:00,0,10,16,6,0,864,7850,8714
2015-10-04 17:00:00-04:00,0,10,17,6,0,1265,11989,13254
2015-10-04 18:00:00-04:00,0,10,18,6,0,1675,16159,17834
2015-10-04 19:00:00-04:00,0,10,19,6,0,1906,19027,20933
2015-10-04 20:00:00-04:00,0,10,20,6,0,2209,20999,23208
2015-10-04 21:00:00-04:00,0,10,21,6,0,2239,19777,22016
2015-10-04 22:00:00-04:00,0,10,22,6,0,2395,19117,21512
2015-10-04 23:00:00-04:00,0,10,23,6,0,2462,18318,20780
2015-10-05 00:00:00-04:00,0,10,0,0,0,2587,18300,20887
2015-10-05 01:00:00-04:00,0,10,1,0,0,2682,19368,22050
2015-10-05 02:00:00-04:00,0,10,2,0,0,2857,20284,23141
2015-10-05 03:00:00-04:00,0,10,3,0,0,2916,19632,22548
2015-10-05 04:00:00-04:00,0,10,4,0,0,2514,16818,19332
2015-10-05 05:00:00-04:00,0,10,5,0,0,2280,15725,18005
2015-10-05 06:00:00-04:00,0,10,6,0,0,2079,13409,15488
2015-10-05 07:00:00-04:00,0,10,7,0,0,1752,10556,12308
2015-10-05 08:00:00-04:00,0,10,8,0,0,1360,6814,8174
2015-10-05 09:00:00-04:00,0,10,9,0,0,892,3883,4775
2015-10-05 10:00:00-04:00,0,10,10,0,0,583,2616,3199
2015-10-05 11:00:00-04:00,0,10,11,0,0,432,1757,2189
2015-10-05 12:00:00-04:00,0,10,12,0,0,487,1980,2467
2015-10-05 13:00:00-04:00,0,10,13,0,0,484,3941,4425
2015-10-05 14:00:00-04:00,0,10,14,0,0,796,10533,11329
2015-10-05 15:00:00-04:00,0,10,15,0,0,1811,17300,19111
2015-10-05 16:00:00-04:00,0,10,16,0,0,2533,20011,22544
2015-10-05 17:00:00-04:00,0,10,17,0,0,2325,18111,20436
2015-10-05 18:00:00-04:00,0,10,18,0,0,1850,16291,18141
2015-10-05 19:00:00-04:00,0,10,19,0,0,1715,15897,17612
2015-10-05 20:00:00-04:00,0,10,20,0,0,1689,16553,18242
2015-10-05 21:00:00-04:00,0,10,21,0,0,1657,16151,17808
2015-10-05 22:00:00-04:00,0,10,22,0,0,1929,17485,19414
2015-10-05 23:00:00-04:00,0,10,23,0,0,2176,18379,20555
2015-10-06 00:00:00-04:00,0,10,0,1,0,2279,16449,18728
2015-10-06 01:00:00-04:00,0,10,1,1,0,2612,19725,22337
2015-10-06 02:00:00-04:00,0,10,2,1,0,2735,23858,26593
2015-10-06 03:00:00-04:00,0,10,3,1,0,2720,23717,26437
2015-10-06 04:00:00-04:00,0,10,4,1,0,2385,21910,24295
2015-10-06 05:00:00-04:00,0,10,5,1,0,2124,20781,22905
2015-10-06 06:00:00-04:00,0,10,6,1,0,1821,17667,19488
2015-10-06 07:00:00-04:00,0,10,7,1,0,1565,13001,14566
2015-10-06 08:00:00-04:00,0,10,8,1,0,1157,7983,9140
2015-10-06 09:00:00-04:00,0,10,9,1,0,749,4659,5408
2015-10-06 10:00:00-04:00,0,10,10,1,0,501,2958,3459
2015-10-06 11:00:00-04:00,0,10,11,1,0,349,1989,2338
2015-10-06 12:00:00-04:00,0,10,12,1,0,398,2063,2461
2015-10-06 13:00:00-04:00,0,10,13,1,0,377,3877,4254
2015-10-06 14:00:00-04:00,0,10,14,1,0,693,10522,11215
2015-10-06 15:00:00-04:00,0,10,15,1,0,1708,19553,21261
2015-10-06 16:00:00-04:00,0,10,16,1,0,2345,20756,23101
2015-10-06 17:00:00-04:00,0,10,17,1,0,2185,18977,21162
2015-10-06 18:00:00-04:00,0,10,18,1,0,1879,17016,18895
2015-10-06 19:00:00-04:00,0,10,19,1,0,1715,17135,18850
2015-10-06 20:00:00-04:00,0,10,20,1,0,1742,17349,19091
2015-10-06 21:00:00-04:00,0,10,21,1,0,1699,17392,19091
2015-10-06 22:00:00-04:00,0,10,22,1,0,2025,19070,21095
2015-10-06 23:00:00-04:00,0,10,23,1,0,2151,18918,21069
2015-10-07 00:00:00-04:00,0,10,0,2,0,2333,16358,18691
2015-10-07 01:00:00-04:00,0,10,1,2,0,2758,20424,23182
2015-10-07 02:00:00-04:00,0,10,2,2,0,2949,24766,27715
2015-10-07 03:00:00-04:00,0,10,3,2,0,3102,25796,28898
2015-10-07 04:00:00-04:00,0,10,4,2,0,2709,24278,26987
2015-10-07 05:00:00-04:00,0,10,5,2,0,2403,23744,26147
2015-10-07 06:00:00-04:00,0,10,6,2,0,2152,21920,24072
2015-10-07 07:00:00-04:00,0,10,7,2,0,1965,16775,18740
2015-10-07 08:00:00-04:00,0,10,8,2,0,1508,10430,11938
2015-10-07 09:00:00-04:00,0,10,9,2,0,922,5899,6821
2015-10-07 10:00:00-04:00,0,10,10,2,0,627,3599,4226
2015-10-07 11:00:00-04:00,0,10,11,2,0,420,2458,2878
2015-10-07 12:00:00-04:00,0,10,12,2,0,388,2385,2773
2015-10-07 13:00:00-04:00,0,10,13,2,0,359,3852,4211
2015-10-07 14:00:00-04:00,0,10,14,2,0,712,10794,11506
2015-10-07 15:00:00-04:00,0,10,15,2,0,1656,19155,20811
2015-10-07 16:00:00-04:00,0,10,16,2,0,2458,21506,23964
2015-10-07 17:00:00-04:00,0,10,17,2,0,2343,20249,22592
2015-10-07 18:00:00-04:00,0,10,18,2,0,1928,18181,20109
2015-10-07 19:00:00-04:00,0,10,19,2,0,1794,18185,19979
2015-10-07 20:00:00-04:00,0,10,20,2,0,1809,18520,20329
2015-10-07 21:00:00-04:00,0,10,21,2,0,1806,18641,20447
2015-10-07 22:00:00-04:00,0,10,22,2,0,1946,19529,21475
2015-10-07 23:00:00-04:00,0,10,23,2,0,2185,18487,20672
2015-10-08 00:00:00-04:00,0,10,0,3,0,2396,15920,18316
2015-10-08 01:00:00-04:00,0,10,1,3,0,2896,19933,22829
2015-10-08 02:00:00-04:00,0,10,2,3,0,3232,24612,27844
2015-10-08 03:00:00-04:00,0,10,3,3,0,3208,26062,29270
2015-10-08 04:00:00-04:00,0,10,4,3,0,2830,25231,28061
2015-10-08 05:00:00-04:00,0,10,5,3,0,2561,25191,27752
2015-10-08 06:00:00-04:00,0,10,6,3,0,2360,23146,25506
2015-10-08 07:00:00-04:00,0,10,7,3,0,2097,18994,21091
2015-10-08 08:00:00-04:00,0,10,8,3,0,1660,11894,13554
2015-10-08 09:00:00-04:00,0,10,9,3,0,1053,7073,8126
2015-10-08 10:00:00-04:00,0,10,10,3,0,771,4439,5210
2015-10-08 11:00:00-04:00,0,10,11,3,0,502,2870,3372
2015-10-08 12:00:00-04:00,0,10,12,3,0,451,2662,3113
2015-10-08 13:00:00-04:00,0,10,13,3,0,427,4236,4663
2015-10-08 14:00:00-04:00,0,10,14,3,0,737,10854,11591
2015-10-08 15:00:00-04:00,0,10,15,3,0,1829,19473,21302
2015-10-08 16:00:00-04:00,0,10,16,3,0,2558,21916,24474
2015-10-08 17:00:00-04:00,0,10,17,3,0,2399,20789,23188
2015-10-08 18:00:00-04:00,0,10,18,3,0,1989,18988,20977
2015-10-08 19:00:00-04:00,0,10,19,3,0,1828,18656,20484
2015-10-08 20:00:00-04:00,0,10,20,3,0,1885,19124,21009
2015-10-08 21:00:00-04:00,0,10,21,3,0,1945,19281,21226
2015-10-08 22:00:00-04:00,0,10,22,3,0,2078,20552,22630
2015-10-08 23:00:00-04:00,0,10,23,3,0,2463,19121,21584
2015-10-09 00:00:00-04:00,0,10,0,4,0,2728,15754,18482
2015-10-09 01:00:00-04:00,0,10,1,4,0,3208,20181,23389
2015-10-09 02:00:00-04:00,0,10,2,4,0,3568,24757,28325
2015-10-09 03:00:00-04:00,0,10,3,4,0,3601,26626,30227
2015-10-09 04:00:00-04:00,0,10,4,4,0,3150,26171,29321
2015-10-09 05:00:00-04:00,0,10,5,4,0,3139,25406,28545
2015-10-09 06:00:00-04:00,0,10,6,4,0,2727,24595,27322
2015-10-09 07:00:00-04:00,0,10,7,4,0,2732,22160,24892
2015-10-09 08:00:00-04:00,0,10,8,4,0,2001,16183,18184
2015-10-09 09:00:00-04:00,0,10,9,4,0,1534,10459,11993
2015-10-09 10:00:00-04:00,0,10,10,4,0,1118,6971,8089
2015-10-09 11:00:00-04:00,0,10,11,4,0,735,4634,5369
2015-10-09 12:00:00-04:00,0,10,12,4,0,665,3957,4622
2015-10-09 13:00:00-04:00,0,10,13,4,0,536,4426,4962
2015-10-09 14:00:00-04:00,0,10,14,4,0,775,10553,11328
2015-10-09 15:00:00-04:00,0,10,15,4,0,1852,18345,20197
2015-10-09 16:00:00-04:00,0.01,10,16,4,0,2585,21121,23706
2015-10-09 17:00:00-04:00,0.32,10,17,4,0,2518,20593,23111
2015-10-09 18:00:00-04:00,0.15,10,18,4,0,2191,18711,20902
2015-10-09 19:00:00-04:00,0.02,10,19,4,0,1973,18612,20585
2015-10-09 20:00:00-04:00,0,10,20,4,0,2010,19852,21862
2015-10-09 21:00:00-04:00,0,10,21,4,0,1965,18759,20724
2015-10-09 22:00:00-04:00,0,10,22,4,0,2408,20241,22649
2015-10-09 23:00:00-04:00,0,10,23,4,0,2746,18696,21442
2015-10-10 00:00:00-04:00,0,10,0,5,0,3261,15862,19123
2015-10-10 01:00:00-04:00,0,10,1,5,0,4559,19098,23657
2015-10-10 02:00:00-04:00,0,10,2,5,0,4680,21941,26621
2015-10-10 03:00:00-04:00,0,10,3,5,0,4455,22229,26684
2015-10-10 04:00:00-04:00,0,10,4,5,0,3748,21813,25561
2015-10-10 05:00:00-04:00,0,10,5,5,0,3755,23067,26822
2015-10-10 06:00:00-04:00,0,10,6,5,0,3576,23206,26782
2015-10-10 07:00:00-04:00,0,10,7,5,0,3643,23319,26962
2015-10-10 08:00:00-04:00,0,10,8,5,0,3669,22197,25866
2015-10-10 09:00:00-04:00,0,10,9,5,0,3304,20417,23721
2015-10-10 10:00:00-04:00,0,10,10,5,0,2759,15959,18718
2015-10-10 11:00:00-04:00,0,10,11,5,0,2138,11926,14064
2015-10-10 12:00:00-04:00,0,10,12,5,0,1646,7619,9265
2015-10-10 13:00:00-04:00,0,10,13,5,0,897,4182,5079
2015-10-10 14:00:00-04:00,0,10,14,5,0,747,5532,6279
2015-10-10 15:00:00-04:00,0,10,15,5,0,926,7886,8812
2015-10-10 16:00:00-04:00,0,10,16,5,0,1302,12150,13452
2015-10-10 17:00:00-04:00,0,10,17,5,0,1727,16508,18235
2015-10-10 18:00:00-04:00,0,10,18,5,0,1989,18833,20822
2015-10-10 19:00:00-04:00,0,10,19,5,0,2284,20612,22896
2015-10-10 20:00:00-04:00,0,10,20,5,0,2342,21404,23746
2015-10-10 21:00:00-04:00,0,10,21,5,0,2175,21323,23498
2015-10-10 22:00:00-04:00,0,10,22,5,0,2572,20757,23329
2015-10-10 23:00:00-04:00,0,10,23,5,0,2686,20921,23607
2015-10-11 00:00:00-04:00,0,10,0,6,0,2933,18352,21285
2015-10-11 01:00:00-04:00,0,10,1,6,0,3231,20292,23523
2015-10-11 02:00:00-04:00,0,10,2,6,0,3575,24775,28350
2015-10-11 03:00:00-04:00,0,10,3,6,0,3951,25644,29595
2015-10-11 04:00:00-04:00,0,10,4,6,0,3904,23318,27222
2015-10-11 05:00:00-04:00,0,10,5,6,0,4018,22459,26477
2015-10-11 06:00:00-04:00,0,10,6,6,0,4062,24398,28460
2015-10-11 07:00:00-04:00,0,10,7,6,0,4366,25208,29574
2015-10-11 08:00:00-04:00,0,10,8,6,0,4326,25017,29343
2015-10-11 09:00:00-04:00,0,10,9,6,0,3937,22241,26178
2015-10-11 10:00:00-04:00,0,10,10,6,0,3333,18660,21993
2015-10-11 11:00:00-04:00,0,10,11,6,0,2733,14262,16995
2015-10-11 12:00:00-04:00,0,10,12,6,0,2151,9092,11243
2015-10-11 13:00:00-04:00,0,10,13,6,0,1065,4225,5290
2015-10-11 14:00:00-04:00,0,10,14,6,0,706,4498,5204
2015-10-11 15:00:00-04:00,0,10,15,6,0,808,5832,6640
2015-10-11 16:00:00-04:00,0,10,16,6,0,955,8656,9611
2015-10-11 17:00:00-04:00,0,10,17,6,0,1332,12561,13893
2015-10-11 18:00:00-04:00,0,10,18,6,0,1628,17080,18708
2015-10-11 19:00:00-04:00,0,10,19,6,0,1904,19006,20910
2015-10-11 20:00:00-04:00,0,10,20,6,0,2105,19734,21839
2015-10-11 21:00:00-04:00,0,10,21,6,0,2070,19324,21394
2015-10-11 22:00:00-04:00,0,10,22,6,0,2308,18933,21241
2015-10-11 23:00:00-04:00,0,10,23,6,0,2419,18577,20996
2015-10-12 00:00:00-04:00,0,10,0,0,1,2668,16926,19594
2015-10-12 01:00:00-04:00,0,10,1,0,1,2745,18008,20753
2015-10-12 02:00:00-04:00,0,10,2,0,1,2910,20153,23063
2015-10-12 03:00:00-04:00,0,10,3,0,1,3005,19961,22966
2015-10-12 04:00:00-04:00,0,10,4,0,1,2650,17846,20496
2015-10-12 05:00:00-04:00,0,10,5,0,1,2506,17650,20156
2015-10-12 06:00:00-04:00,0,10,6,0,1,2398,16033,18431
2015-10-12 07:00:00-04:00,0,10,7,0,1,2120,13987,16107
2015-10-12 08:00:00-04:00,0,10,8,0,1,1683,10060,11743
2015-10-12 09:00:00-04:00,0,10,9,0,1,1238,6629,7867
2015-10-12 10:00:00-04:00,0,10,10,0,1,802,4248,5050
2015-10-12 11:00:00-04:00,0,10,11,0,1,601,3055,3656
2015-10-12 12:00:00-04:00,0,10,12,0,1,601,3036,3637
2015-10-12 13:00:00-04:00,0,10,13,0,1,510,3936,4446
2015-10-12 14:00:00-04:00,0,10,14,0,1,558,7609,8167
2015-10-12 15:00:00-04:00,0,10,15,0,1,944,11956,12900
2015-10-12 16:00:00-04:00,0,10,16,0,1,1495,15037,16532
2015-10-12 17:00:00-04:00,0,10,17,0,1,1685,16072,17757
2015-10-12 18:00:00-04:00,0,10,18,0,1,1428,15438,16866
2015-10-12 19:00:00-04:00,0,10,19,0,1,1536,15450,16986
2015-10-12 20:00:00-04:00,0,10,20,0,1,1481,15903,17384
2015-10-12 21:00:00-04:00,0,10,21,0,1,1636,16349,17985
2015-10-12 22:00:00-04:00,0,10,22,0,1,1714,17552,19266
2015-10-12 23:00:00-04:00,0,10,23,0,1,1889,17623,19512
2015-10-13 00:00:00-04:00,0,10,0,1,0,2063,16745,18808
2015-10-13 01:00:00-04:00,0,10,1,1,0,2250,19500,21750
2015-10-13 02:00:00-04:00,0,10,2,1,0,2469,22242,24711
2015-10-13 03:00:00-04:00,0,10,3,1,0,2464,21888,24352
2015-10-13 04:00:00-04:00,0,10,4,1,0,2188,19934,22122
2015-10-13 05:00:00-04:00,0,10,5,1,0,1870,18820,20690
2015-10-13 06:00:00-04:00,0,10,6,1,0,1765,16814,18579
2015-10-13 07:00:00-04:00,0,10,7,1,0,1509,12509,14018
2015-10-13 08:00:00-04:00,0,10,8,1,0,1297,8257,9554
2015-10-13 09:00:00-04:00,0,10,9,1,0,829,4998,5827
2015-10-13 10:00:00-04:00,0,10,10,1,0,533,2841,3374
2015-10-13 11:00:00-04:00,0,10,11,1,0,378,1967,2345
2015-10-13 12:00:00-04:00,0,10,12,1,0,370,2144,2514
2015-10-13 13:00:00-04:00,0,10,13,1,0,372,4038,4410
2015-10-13 14:00:00-04:00,0,10,14,1,0,731,10834,11565
2015-10-13 15:00:00-04:00,0,10,15,1,0,1796,18701,20497
2015-10-13 16:00:00-04:00,0,10,16,1,0,2542,21038,23580
2015-10-13 17:00:00-04:00,0,10,17,1,0,2349,20226,22575
2015-10-13 18:00:00-04:00,0,10,18,1,0,2009,18439,20448
2015-10-13 19:00:00-04:00,0,10,19,1,0,1817,18010,19827
2015-10-13 20:00:00-04:00,0,10,20,1,0,1737,19130,20867
2015-10-13 21:00:00-04:00,0,10,21,1,0,1831,18947,20778
2015-10-13 22:00:00-04:00,0,10,22,1,0,2014,19484,21498
2015-10-13 23:00:00-04:00,0,10,23,1,0,2166,18691,20857
2015-10-14 00:00:00-04:00,0,10,0,2,0,2379,16536,18915
2015-10-14 01:00:00-04:00,0,10,1,2,0,2758,20386,23144
2015-10-14 02:00:00-04:00,0,10,2,2,0,2944,24823,27767
2015-10-14 03:00:00-04:00,0,10,3,2,0,2946,24865,27811
2015-10-14 04:00:00-04:00,0,10,4,2,0,2644,23828,26472
2015-10-14 05:00:00-04:00,0,10,5,2,0,2284,23738,26022
2015-10-14 06:00:00-04:00,0,10,6,2,0,2073,20555,22628
2015-10-14 07:00:00-04:00,0,10,7,2,0,2051,16997,19048
2015-10-14 08:00:00-04:00,0,10,8,2,0,1507,10104,11611
2015-10-14 09:00:00-04:00,0,10,9,2,0,962,5728,6690
2015-10-14 10:00:00-04:00,0,10,10,2,0,605,3618,4223
2015-10-14 11:00:00-04:00,0,10,11,2,0,447,2512,2959
2015-10-14 12:00:00-04:00,0,10,12,2,0,430,2490,2920
2015-10-14 13:00:00-04:00,0,10,13,2,0,390,4087,4477
2015-10-14 14:00:00-04:00,0,10,14,2,0,670,10358,11028
2015-10-14 15:00:00-04:00,0,10,15,2,0,1745,18992,20737
2015-10-14 16:00:00-04:00,0,10,16,2,0,2478,21634,24112
2015-10-14 17:00:00-04:00,0,10,17,2,0,2411,20180,22591
2015-10-14 18:00:00-04:00,0,10,18,2,0,2060,18482,20542
2015-10-14 19:00:00-04:00,0,10,19,2,0,1786,18273,20059
2015-10-14 20:00:00-04:00,0,10,20,2,0,1834,18519,20353
2015-10-14 21:00:00-04:00,0,10,21,2,0,1868,18542,20410
2015-10-14 22:00:00-04:00,0,10,22,2,0,2254,20357,22611
2015-10-14 23:00:00-04:00,0,10,23,2,0,2365,18705,21070
2015-10-15 00:00:00-04:00,0,10,0,3,0,2475,15668,18143
2015-10-15 01:00:00-04:00,0,10,1,3,0,2798,20305,23103
2015-10-15 02:00:00-04:00,0,10,2,3,0,3112,25084,28196
2015-10-15 03:00:00-04:00,0,10,3,3,0,3081,25837,28918
2015-10-15 04:00:00-04:00,0,10,4,3,0,2785,25660,28445
2015-10-15 05:00:00-04:00,0,10,5,3,0,2547,25445,27992
2015-10-15 06:00:00-04:00,0,10,6,3,0,2314,23798,26112
2015-10-15 07:00:00-04:00,0,10,7,3,0,1962,18423,20385
2015-10-15 08:00:00-04:00,0,10,8,3,0,1553,11798,13351
2015-10-15 09:00:00-04:00,0,10,9,3,0,1070,7341,8411
2015-10-15 10:00:00-04:00,0,10,10,3,0,692,4221,4913
2015-10-15 11:00:00-04:00,0,10,11,3,0,493,2868,3361
2015-10-15 12:00:00-04:00,0,10,12,3,0,509,2637,3146
2015-10-15 13:00:00-04:00,0,10,13,3,0,417,4257,4674
2015-10-15 14:00:00-04:00,0,10,14,3,0,749,10977,11726
2015-10-15 15:00:00-04:00,0,10,15,3,0,1915,19992,21907
2015-10-15 16:00:00-04:00,0,10,16,3,0,2580,22255,24835
2015-10-15 17:00:00-04:00,0,10,17,3,0,2456,20543,22999
2015-10-15 18:00:00-04:00,0,10,18,3,0,2051,18954,21005
2015-10-15 19:00:00-04:00,0,10,19,3,0,1868,18815,20683
2015-10-15 20:00:00-04:00,0,10,20,3,0,1807,19187,20994
2015-10-15 21:00:00-04:00,0,10,21,3,0,1911,18995,20906
2015-10-15 22:00:00-04:00,0,10,22,3,0,2199,19828,22027
2015-10-15 23:00:00-04:00,0,10,23,3,0,2474,18547,21021
2015-10-16 00:00:00-04:00,0,10,0,4,0,2678,14906,17584
2015-10-16 01:00:00-04:00,0,10,1,4,0,3254,19392,22646
2015-10-16 02:00:00-04:00,0,10,2,4,0,3524,24184,27708
2015-10-16 03:00:00-04:00,0,10,3,4,0,3593,26339,29932
2015-10-16 04:00:00-04:00,0,10,4,4,0,3290,26592,29882
2015-10-16 05:00:00-04:00,0,10,5,4,0,3041,26655,29696
2015-10-16 06:00:00-04:00,0,10,6,4,0,2797,24991,27788
2015-10-16 07:00:00-04:00,0,10,7,4,0,2665,23222,25887
2015-10-16 08:00:00-04:00,0,10,8,4,0,2107,16927,19034
2015-10-16 09:00:00-04:00,0,10,9,4,0,1491,10857,12348
2015-10-16 10:00:00-04:00,0,10,10,4,0,1047,6856,7903
2015-10-16 11:00:00-04:00,0,10,11,4,0,781,4574,5355
2015-10-16 12:00:00-04:00,0,10,12,4,0,634,3854,4488
2015-10-16 13:00:00-04:00,0,10,13,4,0,484,4463,4947
2015-10-16 14:00:00-04:00,0,10,14,4,0,773,10647,11420
2015-10-16 15:00:00-04:00,0,10,15,4,0,1823,19569,21392
2015-10-16 16:00:00-04:00,0,10,16,4,0,2670,21953,24623
2015-10-16 17:00:00-04:00,0,10,17,4,0,2490,20663,23153
2015-10-16 18:00:00-04:00,0,10,18,4,0,2232,18946,21178
2015-10-16 19:00:00-04:00,0,10,19,4,0,2096,19943,22039
2015-10-16 20:00:00-04:00,0,10,20,4,0,1982,19785,21767
2015-10-16 21:00:00-04:00,0,10,21,4,0,1950,19378,21328
2015-10-16 22:00:00-04:00,0,10,22,4,0,2467,21122,23589
2015-10-16 23:00:00-04:00,0,10,23,4,0,2725,18898,21623
2015-10-17 00:00:00-04:00,0,10,0,5,0,2987,15871,18858
2015-10-17 01:00:00-04:00,0,10,1,5,0,3483,20946,24429
2015-10-17 02:00:00-04:00,0,10,2,5,0,3891,25544,29435
2015-10-17 03:00:00-04:00,0,10,3,5,0,4184,27729,31913
2015-10-17 04:00:00-04:00,0,10,4,5,0,3953,25358,29311
2015-10-17 05:00:00-04:00,0,10,5,5,0,4072,25708,29780
2015-10-17 06:00:00-04:00,0,10,6,5,0,4035,26367,30402
2015-10-17 07:00:00-04:00,0,10,7,5,0,4191,24456,28647
2015-10-17 08:00:00-04:00,0,10,8,5,0,3908,22251,26159
2015-10-17 09:00:00-04:00,0,10,9,5,0,3481,19934,23415
2015-10-17 10:00:00-04:00,0,10,10,5,0,2948,16496,19444
2015-10-17 11:00:00-04:00,0,10,11,5,0,2419,12337,14756
2015-10-17 12:00:00-04:00,0,10,12,5,0,1854,7758,9612
2015-10-17 13:00:00-04:00,0,10,13,5,0,907,4233,5140
2015-10-17 14:00:00-04:00,0,10,14,5,0,751,5187,5938
2015-10-17 15:00:00-04:00,0,10,15,5,0,993,8357,9350
2015-10-17 16:00:00-04:00,0,10,16,5,0,1367,12981,14348
2015-10-17 17:00:00-04:00,0,10,17,5,0,1755,17223,18978
2015-10-17 18:00:00-04:00,0,10,18,5,0,1979,20024,22003
2015-10-17 19:00:00-04:00,0,10,19,5,0,2159,21729,23888
2015-10-17 20:00:00-04:00,0,10,20,5,0,2434,23013,25447
2015-10-17 21:00:00-04:00,0,10,21,5,0,2532,23272,25804
2015-10-17 22:00:00-04:00,0,10,22,5,0,2757,22090,24847
2015-10-17 23:00:00-04:00,0,10,23,5,0,2985,22551,25536
2015-10-18 00:00:00-04:00,0,10,0,6,0,3264,19961,23225
2015-10-18 01:00:00-04:00,0,10,1,6,0,3545,22583,26128
2015-10-18 02:00:00-04:00,0,10,2,6,0,4211,26294,30505
2015-10-18 03:00:00-04:00,0,10,3,6,0,4667,28671,33338
2015-10-18 04:00:00-04:00,0,10,4,6,0,4295,24903,29198
2015-10-18 05:00:00-04:00,0,10,5,6,0,4293,24097,28390
2015-10-18 06:00:00-04:00,0,10,6,6,0,4392,25649,30041
2015-10-18 07:00:00-04:00,0,10,7,6,0,5052,27642,32694
2015-10-18 08:00:00-04:00,0,10,8,6,0,4649,25470,30119
2015-10-18 09:00:00-04:00,0,10,9,6,0,4089,22296,26385
2015-10-18 10:00:00-04:00,0,10,10,6,0,3511,18228,21739
2015-10-18 11:00:00-04:00,0,10,11,6,0,2830,13601,16431
2015-10-18 12:00:00-04:00,0,10,12,6,0,2038,8521,10559
2015-10-18 13:00:00-04:00,0,10,13,6,0,1006,3975,4981
2015-10-18 14:00:00-04:00,0,10,14,6,0,656,4217,4873
2015-10-18 15:00:00-04:00,0,10,15,6,0,794,6620,7414
2015-10-18 16:00:00-04:00,0,10,16,6,0,1060,9988,11048
2015-10-18 17:00:00-04:00,0,10,17,6,0,1465,14250,15715
2015-10-18 18:00:00-04:00,0,10,18,6,0,1852,18857,20709
2015-10-18 19:00:00-04:00,0,10,19,6,0,2145,21587,23732
2015-10-18 20:00:00-04:00,0,10,20,6,0,2408,23069,25477
2015-10-18 21:00:00-04:00,0,10,21,6,0,2421,22507,24928
2015-10-18 22:00:00-04:00,0,10,22,6,0,2585,21650,24235
2015-10-18 23:00:00-04:00,0,10,23,6,0,2729,20463,23192
2015-10-19 00:00:00-04:00,0,10,0,0,0,2916,18452,21368
2015-10-19 01:00:00-04:00,0,10,1,0,0,2997,19654,22651
2015-10-19 02:00:00-04:00,0,10,2,0,0,3191,21613,24804
2015-10-19 03:00:00-04:00,0,10,3,0,0,3186,21486,24672
2015-10-19 04:00:00-04:00,0,10,4,0,0,2930,18747,21677
2015-10-19 05:00:00-04:00,0,10,5,0,0,2753,17853,20606
2015-10-19 06:00:00-04:00,0,10,6,0,0,2400,15060,17460
2015-10-19 07:00:00-04:00,0,10,7,0,0,2121,12048,14169
2015-10-19 08:00:00-04:00,0,10,8,0,0,1495,7781,9276
2015-10-19 09:00:00-04:00,0,10,9,0,0,923,4331,5254
2015-10-19 10:00:00-04:00,0,10,10,0,0,590,2762,3352
2015-10-19 11:00:00-04:00,0,10,11,0,0,444,1887,2331
2015-10-19 12:00:00-04:00,0,10,12,0,0,505,2337,2842
2015-10-19 13:00:00-04:00,0,10,13,0,0,442,4256,4698
2015-10-19 14:00:00-04:00,0,10,14,0,0,805,10916,11721
2015-10-19 15:00:00-04:00,0,10,15,0,0,1913,18070,19983
2015-10-19 16:00:00-04:00,0,10,16,0,0,2776,20800,23576
2015-10-19 17:00:00-04:00,0,10,17,0,0,2482,19551,22033
2015-10-19 18:00:00-04:00,0,10,18,0,0,1982,17575,19557
2015-10-19 19:00:00-04:00,0,10,19,0,0,1812,17278,19090
2015-10-19 20:00:00-04:00,0,10,20,0,0,1789,17701,19490
2015-10-19 21:00:00-04:00,0,10,21,0,0,1774,17512,19286
2015-10-19 22:00:00-04:00,0,10,22,0,0,1933,19124,21057
2015-10-19 23:00:00-04:00,0,10,23,0,0,2201,19067,21268
2015-10-20 00:00:00-04:00,0,10,0,1,0,2432,17364,19796
2015-10-20 01:00:00-04:00,0,10,1,1,0,2734,20889,23623
2015-10-20 02:00:00-04:00,0,10,2,1,0,2906,24495,27401
2015-10-20 03:00:00-04:00,0,10,3,1,0,2879,24951,27830
2015-10-20 04:00:00-04:00,0,10,4,1,0,2398,22976,25374
2015-10-20 05:00:00-04:00,0,10,5,1,0,2198,22330,24528
2015-10-20 06:00:00-04:00,0,10,6,1,0,1765,19058,20823
2015-10-20 07:00:00-04:00,0,10,7,1,0,1524,13851,15375
2015-10-20 08:00:00-04:00,0,10,8,1,0,1132,8041,9173
2015-10-20 09:00:00-04:00,0,10,9,1,0,712,4587,5299
2015-10-20 10:00:00-04:00,0,10,10,1,0,447,2851,3298
2015-10-20 11:00:00-04:00,0,10,11,1,0,344,1966,2310
2015-10-20 12:00:00-04:00,0,10,12,1,0,413,1966,2379
2015-10-20 13:00:00-04:00,0,10,13,1,0,350,3842,4192
2015-10-20 14:00:00-04:00,0,10,14,1,0,706,10418,11124
2015-10-20 15:00:00-04:00,0,10,15,1,0,1752,18970,20722
2015-10-20 16:00:00-04:00,0,10,16,1,0,2583,21562,24145
2015-10-20 17:00:00-04:00,0,10,17,1,0,2376,20135,22511
2015-10-20 18:00:00-04:00,0,10,18,1,0,1996,17952,19948
2015-10-20 19:00:00-04:00,0,10,19,1,0,1739,17878,19617
2015-10-20 20:00:00-04:00,0,10,20,1,0,1653,18046,19699
2015-10-20 21:00:00-04:00,0,10,21,1,0,1745,17685,19430
2015-10-20 22:00:00-04:00,0,10,22,1,0,2138,19214,21352
2015-10-20 23:00:00-04:00,0,10,23,1,0,2318,18742,21060
2015-10-21 00:00:00-04:00,0,10,0,2,0,2418,16323,18741
2015-10-21 01:00:00-04:00,0,10,1,2,0,2766,20479,23245
2015-10-21 02:00:00-04:00,0,10,2,2,0,2983,24714,27697
2015-10-21 03:00:00-04:00,0,10,3,2,0,3217,25756,28973
2015-10-21 04:00:00-04:00,0,10,4,2,0,2777,24632,27409
2015-10-21 05:00:00-04:00,0,10,5,2,0,2412,23755,26167
2015-10-21 06:00:00-04:00,0,10,6,2,0,2118,21289,23407
2015-10-21 07:00:00-04:00,0,10,7,2,0,2085,17001,19086
2015-10-21 08:00:00-04:00,0,10,8,2,0,1451,10101,11552
2015-10-21 09:00:00-04:00,0,10,9,2,0,935,5856,6791
2015-10-21 10:00:00-04:00,0,10,10,2,0,529,3710,4239
2015-10-21 11:00:00-04:00,0,10,11,2,0,438,2406,2844
2015-10-21 12:00:00-04:00,0,10,12,2,0,411,2468,2879
2015-10-21 13:00:00-04:00,0,10,13,2,0,360,4015,4375
2015-10-21 14:00:00-04:00,0,10,14,2,0,684,10478,11162
2015-10-21 15:00:00-04:00,0,10,15,2,0,1612,18238,19850
2015-10-21 16:00:00-04:00,0,10,16,2,0,2404,20673,23077
2015-10-21 17:00:00-04:00,0,10,17,2,0,2192,19406,21598
2015-10-21 18:00:00-04:00,0,10,18,2,0,1924,18448,20372
2015-10-21 19:00:00-04:00,0,10,19,2,0,1870,18548,20418
2015-10-21 20:00:00-04:00,0,10,20,2,0,1816,18701,20517
2015-10-21 21:00:00-04:00,0,10,21,2,0,1865,18452,20317
2015-10-21 22:00:00-04:00,0,10,22,2,0,2222,19555,21777
2015-10-21 23:00:00-04:00,0,10,23,2,0,2250,18532,20782
2015-10-22 00:00:00-04:00,0,10,0,3,0,2405,15783,18188
2015-10-22 01:00:00-04:00,0,10,1,3,0,2971,20646,23617
2015-10-22 02:00:00-04:00,0,10,2,3,0,3278,24885,28163
2015-10-22 03:00:00-04:00,0,10,3,3,0,3185,26432,29617
2015-10-22 04:00:00-04:00,0,10,4,3,0,2945,25360,28305
2015-10-22 05:00:00-04:00,0,10,5,3,0,2674,24986,27660
2015-10-22 06:00:00-04:00,0,10,6,3,0,2378,23291,25669
2015-10-22 07:00:00-04:00,0,10,7,3,0,2054,18786,20840
2015-10-22 08:00:00-04:00,0,10,8,3,0,1602,12721,14323
2015-10-22 09:00:00-04:00,0,10,9,3,0,1094,7059,8153
2015-10-22 10:00:00-04:00,0,10,10,3,0,774,4454,5228
2015-10-22 11:00:00-04:00,0,10,11,3,0,481,2921,3402
2015-10-22 12:00:00-04:00,0,10,12,3,0,476,2668,3144
2015-10-22 13:00:00-04:00,0,10,13,3,0,442,3923,4365
2015-10-22 14:00:00-04:00,0,10,14,3,0,769,10903,11672
2015-10-22 15:00:00-04:00,0,10,15,3,0,1756,19669,21425
2015-10-22 16:00:00-04:00,0,10,16,3,0,2547,22178,24725
2015-10-22 17:00:00-04:00,0,10,17,3,0,2407,20691,23098
2015-10-22 18:00:00-04:00,0,10,18,3,0,1926,18785,20711
2015-10-22 19:00:00-04:00,0,10,19,3,0,1905,18524,20429
2015-10-22 20:00:00-04:00,0,10,20,3,0,1838,19085,20923
2015-10-22 21:00:00-04:00,0,10,21,3,0,1876,19285,21161
2015-10-22 22:00:00-04:00,0,10,22,3,0,2149,20448,22597
2015-10-22 23:00:00-04:00,0,10,23,3,0,2417,19393,21810
2015-10-23 00:00:00-04:00,0,10,0,4,0,2766,16324,19090
2015-10-23 01:00:00-04:00,0,10,1,4,0,3277,21143,24420
2015-10-23 02:00:00-04:00,0,10,2,4,0,3383,25606,28989
2015-10-23 03:00:00-04:00,0,10,3,4,0,3356,26253,29609
2015-10-23 04:00:00-04:00,0,10,4,4,0,3138,25878,29016
2015-10-23 05:00:00-04:00,0,10,5,4,0,2946,26155,29101
2015-10-23 06:00:00-04:00,0,10,6,4,0,2732,24733,27465
2015-10-23 07:00:00-04:00,0,10,7,4,0,2546,21893,24439
2015-10-23 08:00:00-04:00,0,10,8,4,0,2161,16869,19030
2015-10-23 09:00:00-04:00,0,10,9,4,0,1572,11045,12617
2015-10-23 10:00:00-04:00,0,10,10,4,0,975,7071,8046
2015-10-23 11:00:00-04:00,0,10,11,4,0,671,4626,5297
2015-10-23 12:00:00-04:00,0,10,12,4,0,564,3839,4403
2015-10-23 13:00:00-04:00,0,10,13,4,0,476,4564,5040
2015-10-23 14:00:00-04:00,0,10,14,4,0,823,10643,11466
2015-10-23 15:00:00-04:00,0,10,15,4,0,1802,19355,21157
2015-10-23 16:00:00-04:00,0,10,16,4,0,2602,21717,24319
2015-10-23 17:00:00-04:00,0,10,17,4,0,2463,20477,22940
2015-10-23 18:00:00-04:00,0,10,18,4,0,2169,19101,21270
2015-10-23 19:00:00-04:00,0,10,19,4,0,2094,19151,21245
2015-10-23 20:00:00-04:00,0,10,20,4,0,1912,19192,21104
2015-10-23 21:00:00-04:00,0,10,21,4,0,1847,18354,20201
2015-10-23 22:00:00-04:00,0,10,22,4,0,2396,20129,22525
2015-10-23 23:00:00-04:00,0,10,23,4,0,2595,18281,20876
2015-10-24 00:00:00-04:00,0,10,0,5,0,2970,15772,18742
2015-10-24 01:00:00-04:00,0,10,1,5,0,3543,20349,23892
2015-10-24 02:00:00-04:00,0,10,2,5,0,4140,25055,29195
2015-10-24 03:00:00-04:00,0,10,3,5,0,4356,27757,32113
2015-10-24 04:00:00-04:00,0,10,4,5,0,4156,26421,30577
2015-10-24 05:00:00-04:00,0,10,5,5,0,4021,26053,30074
2015-10-24 06:00:00-04:00,0,10,6,5,0,4168,26773,30941
2015-10-24 07:00:00-04:00,0,10,7,5,0,4271,26081,30352
2015-10-24 08:00:00-04:00,0,10,8,5,0,4162,23682,27844
2015-10-24 09:00:00-04:00,0,10,9,5,0,3695,20618,24313
2015-10-24 10:00:00-04:00,0,10,10,5,0,3134,17714,20848
2015-10-24 11:00:00-04:00,0,10,11,5,0,2501,12881,15382
2015-10-24 12:00:00-04:00,0,10,12,5,0,1888,7672,9560
2015-10-24 13:00:00-04:00,0,10,13,5,0,930,3907,4837
2015-10-24 14:00:00-04:00,0,10,14,5,0,781,4914,5695
2015-10-24 15:00:00-04:00,0,10,15,5,0,1121,8234,9355
2015-10-24 16:00:00-04:00,0,10,16,5,0,1452,12201,13653
2015-10-24 17:00:00-04:00,0,10,17,5,0,1955,16740,18695
2015-10-24 18:00:00-04:00,0,10,18,5,0,2276,20185,22461
2015-10-24 19:00:00-04:00,0,10,19,5,0,2416,21005,23421
2015-10-24 20:00:00-04:00,0,10,20,5,0,2439,22437,24876
2015-10-24 21:00:00-04:00,0,10,21,5,0,2533,22129,24662
2015-10-24 22:00:00-04:00,0,10,22,5,0,2692,21498,24190
2015-10-24 23:00:00-04:00,0,10,23,5,0,3035,20645,23680
2015-10-25 00:00:00-04:00,0,10,0,6,0,3153,17834,20987
2015-10-25 01:00:00-04:00,0,10,1,6,0,3370,20275,23645
2015-10-25 02:00:00-04:00,0,10,2,6,0,3776,23305,27081
2015-10-25 03:00:00-04:00,0,10,3,6,0,4022,25125,29147
2015-10-25 04:00:00-04:00,0,10,4,6,0,3789,22209,25998
2015-10-25 05:00:00-04:00,0,10,5,6,0,3868,21668,25536
2015-10-25 06:00:00-04:00,0,10,6,6,0,4125,24176,28301
2015-10-25 07:00:00-04:00,0.01,10,7,6,0,4263,25190,29453
2015-10-25 08:00:00-04:00,0,10,8,6,0,4276,24678,28954
2015-10-25 09:00:00-04:00,0.02,10,9,6,0,3801,21849,25650
2015-10-25 10:00:00-04:00,0,10,10,6,0,3229,18575,21804
2015-10-25 11:00:00-04:00,0,10,11,6,0,2661,13906,16567
2015-10-25 12:00:00-04:00,0,10,12,6,0,2187,8956,11143
2015-10-25 13:00:00-04:00,0,10,13,6,0,1140,4080,5220
2015-10-25 14:00:00-04:00,0,10,14,6,0,732,4184,4916
2015-10-25 15:00:00-04:00,0,10,15,6,0,798,5971,6769
2015-10-25 16:00:00-04:00,0,10,16,6,0,992,9418,10410
2015-10-25 17:00:00-04:00,0,10,17,6,0,1411,13390,14801
2015-10-25 18:00:00-04:00,0,10,18,6,0,1697,17571,19268
2015-10-25 19:00:00-04:00,0,10,19,6,0,2023,20148,22171
2015-10-25 20:00:00-04:00,0,10,20,6,0,2242,21795,24037
2015-10-25 21:00:00-04:00,0,10,21,6,0,2260,20996,23256
2015-10-25 22:00:00-04:00,0,10,22,6,0,2486,21103,23589
2015-10-25 23:00:00-04:00,0,10,23,6,0,2605,19800,22405
2015-10-26 00:00:00-04:00,0,10,0,0,0,2642,19545,22187
2015-10-26 01:00:00-04:00,0,10,1,0,0,2839,20343,23182
2015-10-26 02:00:00-04:00,0,10,2,0,0,3016,21751,24767
2015-10-26 03:00:00-04:00,0,10,3,0,0,3054,20368,23422
2015-10-26 04:00:00-04:00,0,10,4,0,0,2709,18014,20723
2015-10-26 05:00:00-04:00,0,10,5,0,0,2396,17418,19814
2015-10-26 06:00:00-04:00,0,10,6,0,0,2260,14909,17169
2015-10-26 07:00:00-04:00,0,10,7,0,0,1861,11569,13430
2015-10-26 08:00:00-04:00,0,10,8,0,0,1314,7115,8429
2015-10-26 09:00:00-04:00,0,10,9,0,0,938,4147,5085
2015-10-26 10:00:00-04:00,0,10,10,0,0,652,2681,3333
2015-10-26 11:00:00-04:00,0,10,11,0,0,510,1963,2473
2015-10-26 12:00:00-04:00,0,10,12,0,0,523,2348,2871
2015-10-26 13:00:00-04:00,0,10,13,0,0,511,4417,4928
2015-10-26 14:00:00-04:00,0,10,14,0,0,840,10419,11259
2015-10-26 15:00:00-04:00,0,10,15,0,0,1789,17572,19361
2015-10-26 16:00:00-04:00,0,10,16,0,0,2489,19597,22086
2015-10-26 17:00:00-04:00,0,10,17,0,0,2388,18691,21079
2015-10-26 18:00:00-04:00,0,10,18,0,0,2004,17129,19133
2015-10-26 19:00:00-04:00,0,10,19,0,0,1800,16655,18455
2015-10-26 20:00:00-04:00,0,10,20,0,0,1758,17534,19292
2015-10-26 21:00:00-04:00,0,10,21,0,0,1742,17216,18958
2015-10-26 22:00:00-04:00,0,10,22,0,0,1903,18679,20582
2015-10-26 23:00:00-04:00,0,10,23,0,0,2161,18651,20812
2015-10-27 00:00:00-04:00,0,10,0,1,0,2334,16907,19241
2015-10-27 01:00:00-04:00,0,10,1,1,0,2656,20100,22756
2015-10-27 02:00:00-04:00,0,10,2,1,0,2849,24391,27240
2015-10-27 03:00:00-04:00,0,10,3,1,0,2755,24552,27307
2015-10-27 04:00:00-04:00,0,10,4,1,0,2523,22879,25402
2015-10-27 05:00:00-04:00,0,10,5,1,0,2178,21339,23517
2015-10-27 06:00:00-04:00,0,10,6,1,0,1816,18816,20632
2015-10-27 07:00:00-04:00,0,10,7,1,0,1441,13116,14557
2015-10-27 08:00:00-04:00,0,10,8,1,0,1095,7969,9064
2015-10-27 09:00:00-04:00,0,10,9,1,0,625,4614,5239
2015-10-27 10:00:00-04:00,0,10,10,1,0,431,2978,3409
2015-10-27 11:00:00-04:00,0,10,11,1,0,348,1969,2317
2015-10-27 12:00:00-04:00,0,10,12,1,0,348,2130,2478
2015-10-27 13:00:00-04:00,0,10,13,1,0,364,3843,4207
2015-10-27 14:00:00-04:00,0,10,14,1,0,694,10552,11246
2015-10-27 15:00:00-04:00,0,10,15,1,0,1726,18744,20470
2015-10-27 16:00:00-04:00,0,10,16,1,0,2603,21538,24141
2015-10-27 17:00:00-04:00,0,10,17,1,0,2392,20039,22431
2015-10-27 18:00:00-04:00,0,10,18,1,0,1933,18054,19987
2015-10-27 19:00:00-04:00,0,10,19,1,0,1863,17667,19530
2015-10-27 20:00:00-04:00,0,10,20,1,0,1745,18292,20037
2015-10-27 21:00:00-04:00,0,10,21,1,0,1767,18200,19967
2015-10-27 22:00:00-04:00,0,10,22,1,0,2078,19768,21846
2015-10-27 23:00:00-04:00,0,10,23,1,0,2320,19059,21379
2015-10-28 00:00:00-04:00,0,10,0,2,0,2439,16233,18672
2015-10-28 01:00:00-04:00,0,10,1,2,0,2782,20894,23676
2015-10-28 02:00:00-04:00,0,10,2,2,0,3189,24725,27914
2015-10-28 03:00:00-04:00,0,10,3,2,0,3255,25909,29164
2015-10-28 04:00:00-04:00,0,10,4,2,0,2845,25165,28010
2015-10-28 05:00:00-04:00,0,10,5,2,0,2489,24753,27242
2015-10-28 06:00:00-04:00,0,10,6,2,0,2086,22275,24361
2015-10-28 07:00:00-04:00,0,10,7,2,0,1795,16385,18180
2015-10-28 08:00:00-04:00,0,10,8,2,0,1366,10696,12062
2015-10-28 09:00:00-04:00,0,10,9,2,0,1102,8132,9234
2015-10-28 10:00:00-04:00,0,10,10,2,0,632,3907,4539
2015-10-28 11:00:00-04:00,0.02,10,11,2,0,410,2496,2906
2015-10-28 12:00:00-04:00,0.06,10,12,2,0,416,2432,2848
2015-10-28 13:00:00-04:00,0.05,10,13,2,0,392,3985,4377
2015-10-28 14:00:00-04:00,0.03,10,14,2,0,724,10527,11251
2015-10-28 15:00:00-04:00,0.04,10,15,2,0,1772,19087,20859
2015-10-28 16:00:00-04:00,0.19,10,16,2,0,2671,22438,25109
2015-10-28 17:00:00-04:00,0.4,10,17,2,0,2510,21038,23548
2015-10-28 18:00:00-04:00,0,10,18,2,0,2267,20406,22673
2015-10-28 19:00:00-04:00,0,10,19,2,0,2173,19458,21631
2015-10-28 20:00:00-04:00,0,10,20,2,0,2290,20320,22610
2015-10-28 21:00:00-04:00,0.04,10,21,2,0,2167,19093,21260
2015-10-28 22:00:00-04:00,0.03,10,22,2,0,2553,19416,21969
2015-10-28 23:00:00-04:00,0.14,10,23,2,0,2797,17762,20559
2015-10-29 00:00:00-04:00,0.25,10,0,3,0,3549,14910,18459
2015-10-29 01:00:00-04:00,0,10,1,3,0,4033,18581,22614
2015-10-29 02:00:00-04:00,0,10,2,3,0,3411,21109,24520
2015-10-29 03:00:00-04:00,0,10,3,3,0,3375,23170,26545
2015-10-29 04:00:00-04:00,0.01,10,4,3,0,3000,23827,26827
2015-10-29 05:00:00-04:00,0,10,5,3,0,2711,23938,26649
2015-10-29 06:00:00-04:00,0,10,6,3,0,2507,22487,24994
2015-10-29 07:00:00-04:00,0,10,7,3,0,2239,17724,19963
2015-10-29 08:00:00-04:00,0,10,8,3,0,1646,11404,13050
2015-10-29 09:00:00-04:00,0,10,9,3,0,976,7388,8364
2015-10-29 10:00:00-04:00,0,10,10,3,0,550,4523,5073
2015-10-29 11:00:00-04:00,0,10,11,3,0,416,2500,2916
2015-10-29 12:00:00-04:00,0,10,12,3,0,384,2419,2803
2015-10-29 13:00:00-04:00,0,10,13,3,0,364,3966,4330
2015-10-29 14:00:00-04:00,0,10,14,3,0,703,10841,11544
2015-10-29 15:00:00-04:00,0,10,15,3,0,1722,19629,21351
2015-10-29 16:00:00-04:00,0,10,16,3,0,2551,22073,24624
2015-10-29 17:00:00-04:00,0,10,17,3,0,2434,20374,22808
2015-10-29 18:00:00-04:00,0,10,18,3,0,2047,18941,20988
2015-10-29 19:00:00-04:00,0,10,19,3,0,1947,18816,20763
2015-10-29 20:00:00-04:00,0,10,20,3,0,1947,19641,21588
2015-10-29 21:00:00-04:00,0,10,21,3,0,1936,18896,20832
2015-10-29 22:00:00-04:00,0,10,22,3,0,2289,20176,22465
2015-10-29 23:00:00-04:00,0,10,23,3,0,2454,18832,21286
2015-10-30 00:00:00-04:00,0,10,0,4,0,2729,15444,18173
2015-10-30 01:00:00-04:00,0,10,1,4,0,3159,19834,22993
2015-10-30 02:00:00-04:00,0,10,2,4,0,3572,23985,27557
2015-10-30 03:00:00-04:00,0,10,3,4,0,3641,25260,28901
2015-10-30 04:00:00-04:00,0,10,4,4,0,3337,25234,28571
2015-10-30 05:00:00-04:00,0,10,5,4,0,3187,26051,29238
2015-10-30 06:00:00-04:00,0,10,6,4,0,2984,25298,28282
2015-10-30 07:00:00-04:00,0,10,7,4,0,2726,22145,24871
2015-10-30 08:00:00-04:00,0,10,8,4,0,2092,17160,19252
2015-10-30 09:00:00-04:00,0,10,9,4,0,1604,11536,13140
2015-10-30 10:00:00-04:00,0,10,10,4,0,1196,7767,8963
2015-10-30 11:00:00-04:00,0,10,11,4,0,846,5175,6021
2015-10-30 12:00:00-04:00,0,10,12,4,0,657,4025,4682
2015-10-30 13:00:00-04:00,0,10,13,4,0,520,4481,5001
2015-10-30 14:00:00-04:00,0,10,14,4,0,813,10950,11763
2015-10-30 15:00:00-04:00,0,10,15,4,0,1865,19181,21046
2015-10-30 16:00:00-04:00,0,10,16,4,0,2705,21866,24571
2015-10-30 17:00:00-04:00,0,10,17,4,0,2710,20976,23686
2015-10-30 18:00:00-04:00,0,10,18,4,0,2440,19342,21782
2015-10-30 19:00:00-04:00,0,10,19,4,0,2261,19028,21289
2015-10-30 20:00:00-04:00,0,10,20,4,0,2111,18937,21048
2015-10-30 21:00:00-04:00,0,10,21,4,0,1997,18237,20234
2015-10-30 22:00:00-04:00,0,10,22,4,0,2496,19834,22330
2015-10-30 23:00:00-04:00,0,10,23,4,0,2881,18367,21248
2015-10-31 00:00:00-04:00,0,10,0,5,0,3342,15597,18939
2015-10-31 01:00:00-04:00,0,10,1,5,0,3812,20228,24040
2015-10-31 02:00:00-04:00,0,10,2,5,0,4427,25236,29663
2015-10-31 03:00:00-04:00,0,10,3,5,0,4599,27458,32057
2015-10-31 04:00:00-04:00,0,10,4,5,0,4598,26424,31022
2015-10-31 05:00:00-04:00,0,10,5,5,0,4551,25384,29935
2015-10-31 06:00:00-04:00,0,10,6,5,0,4582,25818,30400
2015-10-31 07:00:00-04:00,0,10,7,5,0,4744,25778,30522
2015-10-31 08:00:00-04:00,0,10,8,5,0,4362,23712,28074
2015-10-31 09:00:00-04:00,0,10,9,5,0,4058,21394,25452
2015-10-31 10:00:00-04:00,0,10,10,5,0,3451,19394,22845
2015-10-31 11:00:00-04:00,0,10,11,5,0,2796,14944,17740
2015-10-31 12:00:00-04:00,0,10,12,5,0,2051,9483,11534
2015-10-31 13:00:00-04:00,0,10,13,5,0,967,4404,5371
2015-10-31 14:00:00-04:00,0,10,14,5,0,728,4837,5565
2015-10-31 15:00:00-04:00,0,10,15,5,0,936,7523,8459
2015-10-31 16:00:00-04:00,0,10,16,5,0,1238,10704,11942
2015-10-31 17:00:00-04:00,0,10,17,5,0,1638,15346,16984
2015-10-31 18:00:00-04:00,0,10,18,5,0,1933,18233,20166
2015-10-31 19:00:00-04:00,0,10,19,5,0,2255,20772,23027
2015-10-31 20:00:00-04:00,0,10,20,5,0,2337,21294,23631
2015-10-31 21:00:00-04:00,0,10,21,5,0,2409,22019,24428
2015-10-31 22:00:00-04:00,0,10,22,5,0,2780,21471,24251
2015-10-31 23:00:00-04:00,0,10,23,5,0,3061,21688,24749
2015-11-01 00:00:00-04:00,0,11,0,6,0,3479,19754,23233
2015-11-01 01:00:00-04:00,0,11,1,6,0,3651,22089,25740
2015-11-01 02:00:00-05:00,0,11,2,6,0,4026,24197,28223
2015-11-01 03:00:00-05:00,0,11,3,6,0,4428,24527,28955
2015-11-01 04:00:00-05:00,0,11,4,6,0,4625,22933,27558
2015-11-01 05:00:00-05:00,0,11,5,6,0,4915,23008,27923
2015-11-01 06:00:00-05:00,0,11,6,6,0,5022,23614,28636
2015-11-01 07:00:00-05:00,0,11,7,6,0,5354,24242,29596
2015-11-01 08:00:00-05:00,0,11,8,6,0,5628,24162,29790
2015-11-01 09:00:00-05:00,0,11,9,6,0,10296,45853,56149
2015-11-01 10:00:00-05:00,0,11,10,6,0,4441,19443,23884
2015-11-01 11:00:00-05:00,0,11,11,6,0,3767,15278,19045
2015-11-01 12:00:00-05:00,0,11,12,6,0,2707,9799,12506
2015-11-01 13:00:00-05:00,0,11,13,6,0,1546,6846,8392
2015-11-01 14:00:00-05:00,0,11,14,6,0,937,6138,7075
2015-11-01 15:00:00-05:00,0,11,15,6,0,881,6443,7324
2015-11-01 16:00:00-05:00,0,11,16,6,0,996,7858,8854
2015-11-01 17:00:00-05:00,0,11,17,6,0,1269,11383,12652
2015-11-01 18:00:00-05:00,0,11,18,6,0,1607,15160,16767
2015-11-01 19:00:00-05:00,0,11,19,6,0,1724,17370,19094
2015-11-01 20:00:00-05:00,0,11,20,6,0,1811,19103,20914
2015-11-01 21:00:00-05:00,0,11,21,6,0,1950,18790,20740
2015-11-01 22:00:00-05:00,0,11,22,6,0,2099,18603,20702
2015-11-01 23:00:00-05:00,0,11,23,6,0,2217,17811,20028
2015-11-02 00:00:00-05:00,0,11,0,0,0,2579,16836,19415
2015-11-02 01:00:00-05:00,0,11,1,0,0,2690,17385,20075
2015-11-02 02:00:00-05:00,0,11,2,0,0,2755,19407,22162
2015-11-02 03:00:00-05:00,0,11,3,0,0,2758,19115,21873
2015-11-02 04:00:00-05:00,0,11,4,0,0,2403,16849,19252
2015-11-02 05:00:00-05:00,0,11,5,0,0,2116,15743,17859
2015-11-02 06:00:00-05:00,0,11,6,0,0,2012,13392,15404
2015-11-02 07:00:00-05:00,0,11,7,0,0,1608,11338,12946
2015-11-02 08:00:00-05:00,0,11,8,0,0,1390,7665,9055
2015-11-02 09:00:00-05:00,0,11,9,0,0,1016,5077,6093
2015-11-02 10:00:00-05:00,0,11,10,0,0,636,2643,3279
2015-11-02 11:00:00-05:00,0,11,11,0,0,441,1919,2360
2015-11-02 12:00:00-05:00,0,11,12,0,0,500,2559,3059
2015-11-02 13:00:00-05:00,0,11,13,0,0,465,4625,5090
2015-11-02 14:00:00-05:00,0,11,14,0,0,919,11176,12095
2015-11-02 15:00:00-05:00,0,11,15,0,0,1835,17674,19509
2015-11-02 16:00:00-05:00,0,11,16,0,0,2468,19048,21516
2015-11-02 17:00:00-05:00,0,11,17,0,0,2215,18100,20315
2015-11-02 18:00:00-05:00,0,11,18,0,0,1967,16813,18780
2015-11-02 19:00:00-05:00,0,11,19,0,0,1757,16864,18621
2015-11-02 20:00:00-05:00,0,11,20,0,0,1709,17212,18921
2015-11-02 21:00:00-05:00,0,11,21,0,0,1752,17578,19330
2015-11-02 22:00:00-05:00,0,11,22,0,0,2013,18756,20769
2015-11-02 23:00:00-05:00,0,11,23,0,0,2180,18340,20520
2015-11-03 00:00:00-05:00,0,11,0,1,0,2427,16045,18472
2015-11-03 01:00:00-05:00,0,11,1,1,0,2440,19285,21725
2015-11-03 02:00:00-05:00,0,11,2,1,0,2793,22971,25764
2015-11-03 03:00:00-05:00,0,11,3,1,0,2496,21975,24471
2015-11-03 04:00:00-05:00,0,11,4,1,0,2262,20813,23075
2015-11-03 05:00:00-05:00,0,11,5,1,0,2070,20156,22226
2015-11-03 06:00:00-05:00,0,11,6,1,0,1859,18035,19894
2015-11-03 07:00:00-05:00,0,11,7,1,0,1475,13231,14706
2015-11-03 08:00:00-05:00,0,11,8,1,0,1100,8289,9389
2015-11-03 09:00:00-05:00,0,11,9,1,0,724,4729,5453
2015-11-03 10:00:00-05:00,0,11,10,1,0,469,3011,3480
2015-11-03 11:00:00-05:00,0,11,11,1,0,315,2046,2361
2015-11-03 12:00:00-05:00,0,11,12,1,0,398,2395,2793
2015-11-03 13:00:00-05:00,0,11,13,1,0,402,4148,4550
2015-11-03 14:00:00-05:00,0,11,14,1,0,782,10542,11324
2015-11-03 15:00:00-05:00,0,11,15,1,0,1538,17459,18997
2015-11-03 16:00:00-05:00,0,11,16,1,0,2087,19416,21503
2015-11-03 17:00:00-05:00,0,11,17,1,0,2050,17924,19974
2015-11-03 18:00:00-05:00,0,11,18,1,0,1820,16998,18818
2015-11-03 19:00:00-05:00,0,11,19,1,0,1781,17198,18979
2015-11-03 20:00:00-05:00,0,11,20,1,0,1724,17858,19582
2015-11-03 21:00:00-05:00,0,11,21,1,0,1736,17489,19225
2015-11-03 22:00:00-05:00,0,11,22,1,0,1929,19208,21137
2015-11-03 23:00:00-05:00,0,11,23,1,0,2202,18401,20603
2015-11-04 00:00:00-05:00,0,11,0,2,0,2451,16130,18581
2015-11-04 01:00:00-05:00,0,11,1,2,0,2627,19629,22256
2015-11-04 02:00:00-05:00,0,11,2,2,0,2909,24381,27290
2015-11-04 03:00:00-05:00,0,11,3,2,0,2961,23965,26926
2015-11-04 04:00:00-05:00,0,11,4,2,0,2388,23068,25456
2015-11-04 05:00:00-05:00,0,11,5,2,0,2386,24009,26395
2015-11-04 06:00:00-05:00,0,11,6,2,0,1950,21543,23493
2015-11-04 07:00:00-05:00,0,11,7,2,0,1650,15163,16813
2015-11-04 08:00:00-05:00,0,11,8,2,0,1213,9183,10396
2015-11-04 09:00:00-05:00,0,11,9,2,0,872,5343,6215
2015-11-04 10:00:00-05:00,0,11,10,2,0,556,3480,4036
2015-11-04 11:00:00-05:00,0,11,11,2,0,379,2323,2702
2015-11-04 12:00:00-05:00,0,11,12,2,0,389,2382,2771
2015-11-04 13:00:00-05:00,0,11,13,2,0,352,3892,4244
2015-11-04 14:00:00-05:00,0,11,14,2,0,824,10915,11739
2015-11-04 15:00:00-05:00,0,11,15,2,0,1755,19178,20933
2015-11-04 16:00:00-05:00,0,11,16,2,0,2373,20949,23322
2015-11-04 17:00:00-05:00,0,11,17,2,0,2170,19391,21561
2015-11-04 18:00:00-05:00,0,11,18,2,0,1924,17876,19800
2015-11-04 19:00:00-05:00,0,11,19,2,0,1827,18094,19921
2015-11-04 20:00:00-05:00,0,11,20,2,0,1831,18355,20186
2015-11-04 21:00:00-05:00,0,11,21,2,0,1883,18118,20001
2015-11-04 22:00:00-05:00,0,11,22,2,0,2146,19302,21448
2015-11-04 23:00:00-05:00,0,11,23,2,0,2255,18239,20494
2015-11-05 00:00:00-05:00,0,11,0,3,0,2489,15480,17969
2015-11-05 01:00:00-05:00,0,11,1,3,0,2833,19748,22581
2015-11-05 02:00:00-05:00,0,11,2,3,0,3210,24501,27711
2015-11-05 03:00:00-05:00,0,11,3,3,0,3177,24902,28079
2015-11-05 04:00:00-05:00,0,11,4,3,0,2709,25202,27911
2015-11-05 05:00:00-05:00,0,11,5,3,0,2516,25742,28258
2015-11-05 06:00:00-05:00,0,11,6,3,0,2331,23286,25617
2015-11-05 07:00:00-05:00,0,11,7,3,0,1985,18208,20193
2015-11-05 08:00:00-05:00,0,11,8,3,0,1534,11458,12992
2015-11-05 09:00:00-05:00,0,11,9,3,0,1063,6807,7870
2015-11-05 10:00:00-05:00,0,11,10,3,0,677,4270,4947
2015-11-05 11:00:00-05:00,0,11,11,3,0,552,2686,3238
2015-11-05 12:00:00-05:00,0,11,12,3,0,425,2654,3079
2015-11-05 13:00:00-05:00,0,11,13,3,0,403,4146,4549
2015-11-05 14:00:00-05:00,0,11,14,3,0,813,11221,12034
2015-11-05 15:00:00-05:00,0,11,15,3,0,1798,18916,20714
2015-11-05 16:00:00-05:00,0,11,16,3,0,2555,20720,23275
2015-11-05 17:00:00-05:00,0,11,17,3,0,2313,20193,22506
2015-11-05 18:00:00-05:00,0,11,18,3,0,2217,18882,21099
2015-11-05 19:00:00-05:00,0,11,19,3,0,2246,19849,22095
2015-11-05 20:00:00-05:00,0,11,20,3,0,1959,19175,21134
2015-11-05 21:00:00-05:00,0,11,21,3,0,2106,19253,21359
2015-11-05 22:00:00-05:00,0,11,22,3,0,2302,20538,22840
2015-11-05 23:00:00-05:00,0,11,23,3,0,2703,19443,22146
2015-11-06 00:00:00-05:00,0,11,0,4,0,3074,15892,18966
2015-11-06 01:00:00-05:00,0,11,1,4,0,3250,19392,22642
2015-11-06 02:00:00-05:00,0,11,2,4,0,3544,24328,27872
2015-11-06 03:00:00-05:00,0,11,3,4,0,3470,24585,28055
2015-11-06 04:00:00-05:00,0,11,4,4,0,3137,25375,28512
2015-11-06 05:00:00-05:00,0,11,5,4,0,2848,26176,29024
2015-11-06 06:00:00-05:00,0,11,6,4,0,2592,24611,27203
2015-11-06 07:00:00-05:00,0,11,7,4,0,2282,21611,23893
2015-11-06 08:00:00-05:00,0,11,8,4,0,1805,15603,17408
2015-11-06 09:00:00-05:00,0,11,9,4,0,1362,10102,11464
2015-11-06 10:00:00-05:00,0,11,10,4,0,925,6360,7285
2015-11-06 11:00:00-05:00,0,11,11,4,0,607,4342,4949
2015-11-06 12:00:00-05:00,0,11,12,4,0,610,3626,4236
2015-11-06 13:00:00-05:00,0,11,13,4,0,477,4422,4899
2015-11-06 14:00:00-05:00,0,11,14,4,0,834,10878,11712
2015-11-06 15:00:00-05:00,0,11,15,4,0,1801,19051,20852
2015-11-06 16:00:00-05:00,0,11,16,4,0,2514,21030,23544
2015-11-06 17:00:00-05:00,0,11,17,4,0,2368,20115,22483
2015-11-06 18:00:00-05:00,0,11,18,4,0,2162,18361,20523
2015-11-06 19:00:00-05:00,0,11,19,4,0,2043,18833,20876
2015-11-06 20:00:00-05:00,0,11,20,4,0,1912,19403,21315
2015-11-06 21:00:00-05:00,0,11,21,4,0,1948,19166,21114
2015-11-06 22:00:00-05:00,0,11,22,4,0,2323,20270,22593
2015-11-06 23:00:00-05:00,0,11,23,4,0,2748,18756,21504
2015-11-07 00:00:00-05:00,0,11,0,5,0,3053,15961,19014
2015-11-07 01:00:00-05:00,0,11,1,5,0,3537,20683,24220
2015-11-07 02:00:00-05:00,0,11,2,5,0,4085,25387,29472
2015-11-07 03:00:00-05:00,0,11,3,5,0,4156,27340,31496
2015-11-07 04:00:00-05:00,0,11,4,5,0,3862,24140,28002
2015-11-07 05:00:00-05:00,0,11,5,5,0,3749,24163,27912
2015-11-07 06:00:00-05:00,0,11,6,5,0,3868,26159,30027
2015-11-07 07:00:00-05:00,0,11,7,5,0,3915,25137,29052
2015-11-07 08:00:00-05:00,0,11,8,5,0,3845,22674,26519
2015-11-07 09:00:00-05:00,0,11,9,5,0,3442,20085,23527
2015-11-07 10:00:00-05:00,0,11,10,5,0,2851,16541,19392
2015-11-07 11:00:00-05:00,0,11,11,5,0,2291,12432,14723
2015-11-07 12:00:00-05:00,0,11,12,5,0,1737,7814,9551
2015-11-07 13:00:00-05:00,0,11,13,5,0,902,3984,4886
2015-11-07 14:00:00-05:00,0,11,14,5,0,771,4866,5637
2015-11-07 15:00:00-05:00,0,11,15,5,0,1026,7853,8879
2015-11-07 16:00:00-05:00,0,11,16,5,0,1461,12017,13478
2015-11-07 17:00:00-05:00,0,11,17,5,0,1837,16166,18003
2015-11-07 18:00:00-05:00,0,11,18,5,0,2053,18622,20675
2015-11-07 19:00:00-05:00,0,11,19,5,0,2315,21052,23367
2015-11-07 20:00:00-05:00,0,11,20,5,0,2438,22563,25001
2015-11-07 21:00:00-05:00,0,11,21,5,0,2570,22945,25515
2015-11-07 22:00:00-05:00,0,11,22,5,0,2629,21852,24481
2015-11-07 23:00:00-05:00,0,11,23,5,0,2975,22088,25063
2015-11-08 00:00:00-05:00,0,11,0,6,0,3228,19033,22261
2015-11-08 01:00:00-05:00,0,11,1,6,0,3502,21781,25283
2015-11-08 02:00:00-05:00,0,11,2,6,0,3912,25749,29661
2015-11-08 03:00:00-05:00,0,11,3,6,0,4003,26673,30676
2015-11-08 04:00:00-05:00,0,11,4,6,0,3978,22376,26354
2015-11-08 05:00:00-05:00,0,11,5,6,0,4050,22438,26488
2015-11-08 06:00:00-05:00,0,11,6,6,0,4203,25666,29869
2015-11-08 07:00:00-05:00,0,11,7,6,0,4440,26663,31103
2015-11-08 08:00:00-05:00,0,11,8,6,0,4441,25304,29745
2015-11-08 09:00:00-05:00,0,11,9,6,0,4055,22904,26959
2015-11-08 10:00:00-05:00,0,11,10,6,0,3516,19091,22607
2015-11-08 11:00:00-05:00,0,11,11,6,0,2836,14214,17050
2015-11-08 12:00:00-05:00,0,11,12,6,0,2123,8951,11074
2015-11-08 13:00:00-05:00,0,11,13,6,0,987,3973,4960
2015-11-08 14:00:00-05:00,0,11,14,6,0,679,4146,4825
2015-11-08 15:00:00-05:00,0,11,15,6,0,734,5912,6646
2015-11-08 16:00:00-05:00,0,11,16,6,0,937,9397,10334
2015-11-08 17:00:00-05:00,0,11,17,6,0,1389,14016,15405
2015-11-08 18:00:00-05:00,0,11,18,6,0,1837,18337,20174
2015-11-08 19:00:00-05:00,0,11,19,6,0,2121,20501,22622
2015-11-08 20:00:00-05:00,0,11,20,6,0,2152,22068,24220
2015-11-08 21:00:00-05:00,0,11,21,6,0,2249,21560,23809
2015-11-08 22:00:00-05:00,0,11,22,6,0,2399,21847,24246
2015-11-08 23:00:00-05:00,0,11,23,6,0,2596,20918,23514
2015-11-09 00:00:00-05:00,0,11,0,0,0,2955,19737,22692
2015-11-09 01:00:00-05:00,0,11,1,0,0,2944,20668,23612
2015-11-09 02:00:00-05:00,0,11,2,0,0,2932,21088,24020
2015-11-09 03:00:00-05:00,0,11,3,0,0,2912,19664,22576
2015-11-09 04:00:00-05:00,0,11,4,0,0,2690,17172,19862
2015-11-09 05:00:00-05:00,0,11,5,0,0,2413,16167,18580
2015-11-09 06:00:00-05:00,0,11,6,0,0,2042,14182,16224
2015-11-09 07:00:00-05:00,0,11,7,0,0,1682,10592,12274
2015-11-09 08:00:00-05:00,0,11,8,0,0,1358,6954,8312
2015-11-09 09:00:00-05:00,0,11,9,0,0,847,4253,5100
2015-11-09 10:00:00-05:00,0,11,10,0,0,579,2557,3136
2015-11-09 11:00:00-05:00,0,11,11,0,0,419,1869,2288
2015-11-09 12:00:00-05:00,0,11,12,0,0,524,2349,2873
2015-11-09 13:00:00-05:00,0,11,13,0,0,488,4179,4667
2015-11-09 14:00:00-05:00,0,11,14,0,0,928,10705,11633
2015-11-09 15:00:00-05:00,0,11,15,0,0,1878,17798,19676
2015-11-09 16:00:00-05:00,0,11,16,0,0,2533,19857,22390
2015-11-09 17:00:00-05:00,0,11,17,0,0,2322,18581,20903
2015-11-09 18:00:00-05:00,0,11,18,0,0,1878,16916,18794
2015-11-09 19:00:00-05:00,0,11,19,0,0,1734,16366,18100
2015-11-09 20:00:00-05:00,0,11,20,0,0,1632,17145,18777
2015-11-09 21:00:00-05:00,0,11,21,0,0,1719,16989,18708
2015-11-09 22:00:00-05:00,0,11,22,0,0,1966,18803,20769
2015-11-09 23:00:00-05:00,0,11,23,0,0,2243,18595,20838
2015-11-10 00:00:00-05:00,0,11,0,1,0,2430,16840,19270
2015-11-10 01:00:00-05:00,0,11,1,1,0,2692,20506,23198
2015-11-10 02:00:00-05:00,0,11,2,1,0,2820,24109,26929
2015-11-10 03:00:00-05:00,0,11,3,1,0,2675,22741,25416
2015-11-10 04:00:00-05:00,0,11,4,1,0,2373,21844,24217
2015-11-10 05:00:00-05:00,0,11,5,1,0,1997,21630,23627
2015-11-10 06:00:00-05:00,0,11,6,1,0,1674,18118,19792
2015-11-10 07:00:00-05:00,0,11,7,1,0,1438,13025,14463
2015-11-10 08:00:00-05:00,0.01,11,8,1,0,1066,7944,9010
2015-11-10 09:00:00-05:00,0.02,11,9,1,0,712,4710,5422
2015-11-10 10:00:00-05:00,0.03,11,10,1,0,484,3054,3538
2015-11-10 11:00:00-05:00,0.1,11,11,1,0,330,1984,2314
2015-11-10 12:00:00-05:00,0.02,11,12,1,0,351,2037,2388
2015-11-10 13:00:00-05:00,0,11,13,1,0,355,3921,4276
2015-11-10 14:00:00-05:00,0,11,14,1,0,819,10721,11540
2015-11-10 15:00:00-05:00,0,11,15,1,0,1860,19464,21324
2015-11-10 16:00:00-05:00,0.02,11,16,1,0,2846,22109,24955
2015-11-10 17:00:00-05:00,0,11,17,1,0,2668,20130,22798
2015-11-10 18:00:00-05:00,0,11,18,1,0,2360,19041,21401
2015-11-10 19:00:00-05:00,0,11,19,1,0,2158,18649,20807
2015-11-10 20:00:00-05:00,0,11,20,1,0,1932,18287,20219
2015-11-10 21:00:00-05:00,0,11,21,1,0,2058,18150,20208
2015-11-10 22:00:00-05:00,0.04,11,22,1,0,2304,18700,21004
2015-11-10 23:00:00-05:00,0.02,11,23,1,0,2576,17373,19949
2015-11-11 00:00:00-05:00,0.04,11,0,2,1,2757,14020,16777
2015-11-11 01:00:00-05:00,0.1,11,1,2,1,2886,18156,21042
2015-11-11 02:00:00-05:00,0.05,11,2,2,1,3216,23253,26469
2015-11-11 03:00:00-05:00,0,11,3,2,1,3342,24679,28021
2015-11-11 04:00:00-05:00,0.03,11,4,2,1,2822,24598,27420
2015-11-11 05:00:00-05:00,0.01,11,5,2,1,2897,25765,28662
2015-11-11 06:00:00-05:00,0.01,11,6,2,1,2574,22986,25560
2015-11-11 07:00:00-05:00,0,11,7,2,1,2179,18320,20499
2015-11-11 08:00:00-05:00,0,11,8,2,1,1498,11724,13222
2015-11-11 09:00:00-05:00,0,11,9,2,1,1037,6848,7885
2015-11-11 10:00:00-05:00,0,11,10,2,1,547,4027,4574
2015-11-11 11:00:00-05:00,0,11,11,2,1,347,2718,3065
2015-11-11 12:00:00-05:00,0,11,12,2,1,383,2547,2930
2015-11-11 13:00:00-05:00,0,11,13,2,1,343,3919,4262
2015-11-11 14:00:00-05:00,0,11,14,2,1,745,9505,10250
2015-11-11 15:00:00-05:00,0,11,15,2,1,1359,17557,18916
2015-11-11 16:00:00-05:00,0,11,16,2,1,1996,19823,21819
2015-11-11 17:00:00-05:00,0,11,17,2,1,2070,18841,20911
2015-11-11 18:00:00-05:00,0,11,18,2,1,1820,17427,19247
2015-11-11 19:00:00-05:00,0,11,19,2,1,1815,17071,18886
2015-11-11 20:00:00-05:00,0,11,20,2,1,1791,17641,19432
2015-11-11 21:00:00-05:00,0,11,21,2,1,1839,16978,18817
2015-11-11 22:00:00-05:00,0,11,22,2,1,1888,17527,19415
2015-11-11 23:00:00-05:00,0,11,23,2,1,2116,16706,18822
2015-11-12 00:00:00-05:00,0,11,0,3,0,2319,14236,16555
2015-11-12 01:00:00-05:00,0,11,1,3,0,2599,18462,21061
2015-11-12 02:00:00-05:00,0,11,2,3,0,3020,24060,27080
2015-11-12 03:00:00-05:00,0,11,3,3,0,2902,25003,27905
2015-11-12 04:00:00-05:00,0,11,4,3,0,2784,24524,27308
2015-11-12 05:00:00-05:00,0,11,5,3,0,2575,24067,26642
2015-11-12 06:00:00-05:00,0,11,6,3,0,2366,22701,25067
2015-11-12 07:00:00-05:00,0,11,7,3,0,1989,18090,20079
2015-11-12 08:00:00-05:00,0,11,8,3,0,1570,12031,13601
2015-11-12 09:00:00-05:00,0,11,9,3,0,1135,6966,8101
2015-11-12 10:00:00-05:00,0,11,10,3,0,667,4409,5076
2015-11-12 11:00:00-05:00,0,11,11,3,0,495,2984,3479
2015-11-12 12:00:00-05:00,0,11,12,3,0,459,2781,3240
2015-11-12 13:00:00-05:00,0,11,13,3,0,423,4153,4576
2015-11-12 14:00:00-05:00,0.01,11,14,3,0,847,10728,11575
2015-11-12 15:00:00-05:00,0,11,15,3,0,1908,19596,21504
2015-11-12 16:00:00-05:00,0,11,16,3,0,2721,22089,24810
2015-11-12 17:00:00-05:00,0,11,17,3,0,2506,20257,22763
2015-11-12 18:00:00-05:00,0,11,18,3,0,2233,18646,20879
2015-11-12 19:00:00-05:00,0,11,19,3,0,2125,19101,21226
2015-11-12 20:00:00-05:00,0,11,20,3,0,2021,19015,21036
2015-11-12 21:00:00-05:00,0,11,21,3,0,2148,19411,21559
2015-11-12 22:00:00-05:00,0,11,22,3,0,2369,19661,22030
2015-11-12 23:00:00-05:00,0,11,23,3,0,2386,18343,20729
2015-11-13 00:00:00-05:00,0,11,0,4,0,2732,15341,18073
2015-11-13 01:00:00-05:00,0,11,1,4,0,3045,20254,23299
2015-11-13 02:00:00-05:00,0,11,2,4,0,3311,24810,28121
2015-11-13 03:00:00-05:00,0,11,3,4,0,3296,25394,28690
2015-11-13 04:00:00-05:00,0,11,4,4,0,3045,25912,28957
2015-11-13 05:00:00-05:00,0,11,5,4,0,2998,26882,29880
2015-11-13 06:00:00-05:00,0,11,6,4,0,2546,25186,27732
2015-11-13 07:00:00-05:00,0,11,7,4,0,2571,22699,25270
2015-11-13 08:00:00-05:00,0,11,8,4,0,1940,16761,18701
2015-11-13 09:00:00-05:00,0,11,9,4,0,1562,10906,12468
2015-11-13 10:00:00-05:00,0,11,10,4,0,1121,6786,7907
2015-11-13 11:00:00-05:00,0,11,11,4,0,735,4477,5212
2015-11-13 12:00:00-05:00,0,11,12,4,0,643,3877,4520
2015-11-13 13:00:00-05:00,0,11,13,4,0,487,4461,4948
2015-11-13 14:00:00-05:00,0,11,14,4,0,824,10362,11186
2015-11-13 15:00:00-05:00,0,11,15,4,0,1831,18740,20571
2015-11-13 16:00:00-05:00,0,11,16,4,0,2576,21399,23975
2015-11-13 17:00:00-05:00,0,11,17,4,0,2498,19910,22408
2015-11-13 18:00:00-05:00,0,11,18,4,0,2084,18510,20594
2015-11-13 19:00:00-05:00,0,11,19,4,0,2016,18629,20645
2015-11-13 20:00:00-05:00,0,11,20,4,0,1900,18908,20808
2015-11-13 21:00:00-05:00,0,11,21,4,0,1892,19251,21143
2015-11-13 22:00:00-05:00,0,11,22,4,0,2405,20421,22826
2015-11-13 23:00:00-05:00,0,11,23,4,0,2665,18521,21186
2015-11-14 00:00:00-05:00,0,11,0,5,0,3126,15890,19016
2015-11-14 01:00:00-05:00,0,11,1,5,0,3890,20482,24372
2015-11-14 02:00:00-05:00,0,11,2,5,0,4196,25697,29893
2015-11-14 03:00:00-05:00,0,11,3,5,0,4452,27272,31724
2015-11-14 04:00:00-05:00,0,11,4,5,0,4439,25834,30273
2015-11-14 05:00:00-05:00,0,11,5,5,0,4224,26425,30649
2015-11-14 06:00:00-05:00,0,11,6,5,0,4434,27382,31816
2015-11-14 07:00:00-05:00,0,11,7,5,0,4579,26816,31395
2015-11-14 08:00:00-05:00,0,11,8,5,0,4166,24367,28533
2015-11-14 09:00:00-05:00,0,11,9,5,0,3509,20593,24102
2015-11-14 10:00:00-05:00,0,11,10,5,0,2995,17259,20254
2015-11-14 11:00:00-05:00,0,11,11,5,0,2580,12787,15367
2015-11-14 12:00:00-05:00,0,11,12,5,0,1881,8044,9925
2015-11-14 13:00:00-05:00,0,11,13,5,0,1013,3838,4851
2015-11-14 14:00:00-05:00,0,11,14,5,0,786,4872,5658
2015-11-14 15:00:00-05:00,0,11,15,5,0,1037,7340,8377
2015-11-14 16:00:00-05:00,0,11,16,5,0,1504,11903,13407
2015-11-14 17:00:00-05:00,0,11,17,5,0,1914,16192,18106
2015-11-14 18:00:00-05:00,0,11,18,5,0,2139,19094,21233
2015-11-14 20:00:00-05:00,0,11,20,5,0,2388,21333,23721
2015-11-14 21:00:00-05:00,0,11,21,5,0,2473,22756,25229
2015-11-14 22:00:00-05:00,0,11,22,5,0,2688,22613,25301
2015-11-14 23:00:00-05:00,0,11,23,5,0,2766,22090,24856
2015-11-15 00:00:00-05:00,0,11,0,6,0,3062,22481,25543
2015-11-15 01:00:00-05:00,0,11,1,6,0,3429,18878,22307
2015-11-15 02:00:00-05:00,0,11,2,6,0,3878,21201,25079
2015-11-15 03:00:00-05:00,0,11,3,6,0,4092,25370,29462
2015-11-15 04:00:00-05:00,0,11,4,6,0,4359,26593,30952
2015-11-15 05:00:00-05:00,0,11,5,6,0,4223,22825,27048
2015-11-15 06:00:00-05:00,0,11,6,6,0,4242,22847,27089
2015-11-15 07:00:00-05:00,0,11,7,6,0,4466,25458,29924
2015-11-15 08:00:00-05:00,0,11,8,6,0,4699,26253,30952
2015-11-15 09:00:00-05:00,0,11,9,6,0,4497,24621,29118
2015-11-15 10:00:00-05:00,0,11,10,6,0,4225,23330,27555
2015-11-15 11:00:00-05:00,0,11,11,6,0,3575,19692,23267
2015-11-15 12:00:00-05:00,0,11,12,6,0,2843,14751,17594
2015-11-15 13:00:00-05:00,0,11,13,6,0,2228,9315,11543
2015-11-15 14:00:00-05:00,0,11,14,6,0,1059,4178,5237
2015-11-15 15:00:00-05:00,0,11,15,6,0,759,4201,4960
2015-11-15 16:00:00-05:00,0,11,16,6,0,766,5503,6269
2015-11-15 17:00:00-05:00,0,11,17,6,0,981,8572,9553
2015-11-15 18:00:00-05:00,0,11,18,6,0,1409,13001,14410
2015-11-15 19:00:00-05:00,0,11,19,6,0,1876,17685,19561
2015-11-15 20:00:00-05:00,0,11,20,6,0,2037,20477,22514
2015-11-15 21:00:00-05:00,0,11,21,6,0,2204,21551,23755
2015-11-15 22:00:00-05:00,0,11,22,6,0,2322,21048,23370
2015-11-15 23:00:00-05:00,0,11,23,6,0,2491,20870,23361
2015-11-16 00:00:00-05:00,0,11,0,0,0,2628,20024,22652
2015-11-16 01:00:00-05:00,0,11,1,0,0,2857,18443,21300
2015-11-16 02:00:00-05:00,0,11,2,0,0,2890,19204,22094
2015-11-16 03:00:00-05:00,0,11,3,0,0,2958,19720,22678
2015-11-16 04:00:00-05:00,0,11,4,0,0,2825,17615,20440
2015-11-16 05:00:00-05:00,0,11,5,0,0,2604,17223,19827
2015-11-16 06:00:00-05:00,0,11,6,0,0,2309,16144,18453
2015-11-16 07:00:00-05:00,0,11,7,0,0,1969,13568,15537
2015-11-16 08:00:00-05:00,0,11,8,0,0,1746,10477,12223
2015-11-16 09:00:00-05:00,0,11,9,0,0,1300,6874,8174
2015-11-16 10:00:00-05:00,0,11,10,0,0,830,4081,4911
2015-11-16 11:00:00-05:00,0,11,11,0,0,547,2509,3056
2015-11-16 12:00:00-05:00,0,11,12,0,0,450,1946,2396
2015-11-16 13:00:00-05:00,0,11,13,0,0,557,2365,2922
2015-11-16 14:00:00-05:00,0,11,14,0,0,468,4233,4701
2015-11-16 15:00:00-05:00,0,11,15,0,0,941,10724,11665
2015-11-16 16:00:00-05:00,0,11,16,0,0,1910,17783,19693
2015-11-16 17:00:00-05:00,0,11,17,0,0,2601,19608,22209
2015-11-16 18:00:00-05:00,0,11,18,0,0,2366,18334,20700
2015-11-16 19:00:00-05:00,0,11,19,0,0,1885,15999,17884
2015-11-16 20:00:00-05:00,0,11,20,0,0,1696,16366,18062
2015-11-16 21:00:00-05:00,0,11,21,0,0,1655,16308,17963
2015-11-16 22:00:00-05:00,0,11,22,0,0,1759,16253,18012
2015-11-16 23:00:00-05:00,0,11,23,0,0,1948,17924,19872
2015-11-17 00:00:00-05:00,0,11,0,1,0,2215,18208,20423
2015-11-17 01:00:00-05:00,0,11,1,1,0,2391,16443,18834
2015-11-17 02:00:00-05:00,0,11,2,1,0,2598,19428,22026
2015-11-17 03:00:00-05:00,0,11,3,1,0,2785,23454,26239
2015-11-17 04:00:00-05:00,0,11,4,1,0,2599,23025,25624
2015-11-17 05:00:00-05:00,0,11,5,1,0,2256,21853,24109
2015-11-17 06:00:00-05:00,0,11,6,1,0,2098,21182,23280
2015-11-17 07:00:00-05:00,0,11,7,1,0,1744,18839,20583
2015-11-17 08:00:00-05:00,0,11,8,1,0,1506,13876,15382
2015-11-17 09:00:00-05:00,0,11,9,1,0,1145,8370,9515
2015-11-17 10:00:00-05:00,0,11,10,1,0,765,4953,5718
2015-11-17 11:00:00-05:00,0,11,11,1,0,492,3144,3636
2015-11-17 12:00:00-05:00,0,11,12,1,0,399,2103,2502
2015-11-17 13:00:00-05:00,0,11,13,1,0,381,2192,2573
2015-11-17 14:00:00-05:00,0,11,14,1,0,357,3843,4200
2015-11-17 15:00:00-05:00,0,11,15,1,0,782,10758,11540
2015-11-17 16:00:00-05:00,0,11,16,1,0,1937,19341,21278
2015-11-17 17:00:00-05:00,0,11,17,1,0,2605,21868,24473
2015-11-17 18:00:00-05:00,0,11,18,1,0,2326,20284,22610
2015-11-17 19:00:00-05:00,0,11,19,1,0,1945,18048,19993
2015-11-17 20:00:00-05:00,0,11,20,1,0,1848,17912,19760
2015-11-17 21:00:00-05:00,0,11,21,1,0,1795,18244,20039
2015-11-17 22:00:00-05:00,0,11,22,1,0,1834,18008,19842
2015-11-17 23:00:00-05:00,0,11,23,1,0,2111,19712,21823
2015-11-18 00:00:00-05:00,0,11,0,2,0,2328,18870,21198
2015-11-18 01:00:00-05:00,0,11,1,2,0,2642,15909,18551
2015-11-18 02:00:00-05:00,0,11,2,2,0,2955,20703,23658
2015-11-18 03:00:00-05:00,0,11,3,2,0,3305,24995,28300
2015-11-18 04:00:00-05:00,0,11,4,2,0,3211,25112,28323
2015-11-18 05:00:00-05:00,0,11,5,2,0,2824,24962,27786
2015-11-18 06:00:00-05:00,0,11,6,2,0,2600,25772,28372
2015-11-18 07:00:00-05:00,0,11,7,2,0,2301,22751,25052
2015-11-18 08:00:00-05:00,0,11,8,2,0,1839,16634,18473
2015-11-18 09:00:00-05:00,0,11,9,2,0,1282,10255,11537
2015-11-18 10:00:00-05:00,0,11,10,2,0,832,5907,6739
2015-11-18 11:00:00-05:00,0,11,11,2,0,538,3789,4327
2015-11-18 12:00:00-05:00,0,11,12,2,0,386,2365,2751
2015-11-18 13:00:00-05:00,0,11,13,2,0,403,2408,2811
2015-11-18 14:00:00-05:00,0,11,14,2,0,406,3900,4306
2015-11-18 15:00:00-05:00,0,11,15,2,0,803,10920,11723
2015-11-18 16:00:00-05:00,0,11,16,2,0,1859,20199,22058
2015-11-18 17:00:00-05:00,0,11,17,2,0,2717,22673,25390
2015-11-18 18:00:00-05:00,0,11,18,2,0,2491,20207,22698
2015-11-18 19:00:00-05:00,0,11,19,2,0,2125,18274,20399
2015-11-18 20:00:00-05:00,0,11,20,2,0,1972,18233,20205
2015-11-18 21:00:00-05:00,0,11,21,2,0,1870,18796,20666
2015-11-18 22:00:00-05:00,0,11,22,2,0,1912,18522,20434
2015-11-18 23:00:00-05:00,0,11,23,2,0,2119,19656,21775
2015-11-19 00:00:00-05:00,0,11,0,3,0,2275,18191,20466
2015-11-19 01:00:00-05:00,0,11,1,3,0,2503,14963,17466
2015-11-19 02:00:00-05:00,0,11,2,3,0,2871,19267,22138
2015-11-19 03:00:00-05:00,0,11,3,3,0,3198,24500,27698
2015-11-19 04:00:00-05:00,0,11,4,3,0,3206,25057,28263
2015-11-19 05:00:00-05:00,0,11,5,3,0,2806,25477,28283
2015-11-19 06:00:00-05:00,0,11,6,3,0,2492,25662,28154
2015-11-19 07:00:00-05:00,0,11,7,3,0,2333,23762,26095
2015-11-19 08:00:00-05:00,0,11,8,3,0,2095,18338,20433
2015-11-19 09:00:00-05:00,0,11,9,3,0,1644,12262,13906
2015-11-19 10:00:00-05:00,0,11,10,3,0,1059,7366,8425
2015-11-19 11:00:00-05:00,0,11,11,3,0,665,4730,5395
2015-11-19 12:00:00-05:00,0,11,12,3,0,480,3025,3505
2015-11-19 13:00:00-05:00,0,11,13,3,0,486,2805,3291
2015-11-19 14:00:00-05:00,0.02,11,14,3,0,425,3955,4380
2015-11-19 15:00:00-05:00,0,11,15,3,0,912,11379,12291
2015-11-19 16:00:00-05:00,0.04,11,16,3,0,1938,20356,22294
2015-11-19 17:00:00-05:00,0.17,11,17,3,0,2766,22257,25023
2015-11-19 18:00:00-05:00,0.19,11,18,3,0,2514,20622,23136
2015-11-19 19:00:00-05:00,0.25,11,19,3,0,2271,19839,22110
2015-11-19 20:00:00-05:00,0.11,11,20,3,0,1978,18697,20675
2015-11-19 21:00:00-05:00,0.24,11,21,3,0,2019,18975,20994
2015-11-19 22:00:00-05:00,0.09,11,22,3,0,2032,18754,20786
2015-11-19 23:00:00-05:00,0.05,11,23,3,0,2442,19915,22357
2015-11-20 00:00:00-05:00,0,11,0,4,0,2647,17657,20304
2015-11-20 01:00:00-05:00,0,11,1,4,0,3182,14366,17548
2015-11-20 02:00:00-05:00,0,11,2,4,0,4233,18465,22698
2015-11-20 03:00:00-05:00,0,11,3,4,0,4808,23089,27897
2015-11-20 04:00:00-05:00,0,11,4,4,0,4537,24055,28592
2015-11-20 05:00:00-05:00,0,11,5,4,0,4313,24915,29228
2015-11-20 06:00:00-05:00,0,11,6,4,0,3724,24490,28214
2015-11-20 07:00:00-05:00,0,11,7,4,0,3090,23109,26199
2015-11-20 08:00:00-05:00,0,11,8,4,0,2444,19508,21952
2015-11-20 09:00:00-05:00,0,11,9,4,0,1858,15297,17155
2015-11-20 10:00:00-05:00,0,11,10,4,0,1275,10553,11828
2015-11-20 11:00:00-05:00,0,11,11,4,0,872,6529,7401
2015-11-20 12:00:00-05:00,0,11,12,4,0,549,4216,4765
2015-11-20 13:00:00-05:00,0,11,13,4,0,604,3706,4310
2015-11-20 14:00:00-05:00,0,11,14,4,0,609,4775,5384
2015-11-20 15:00:00-05:00,0,11,15,4,0,1071,11619,12690
2015-11-20 16:00:00-05:00,0,11,16,4,0,1947,19141,21088
2015-11-20 17:00:00-05:00,0,11,17,4,0,2770,21685,24455
2015-11-20 18:00:00-05:00,0,11,18,4,0,2576,20045,22621
2015-11-20 19:00:00-05:00,0,11,19,4,0,2187,18796,20983
2015-11-20 20:00:00-05:00,0,11,20,4,0,2056,19130,21186
2015-11-20 21:00:00-05:00,0,11,21,4,0,1928,19152,21080
2015-11-20 22:00:00-05:00,0,11,22,4,0,1935,19108,21043
2015-11-20 23:00:00-05:00,0,11,23,4,0,2349,20476,22825
2015-11-21 00:00:00-05:00,0,11,0,5,0,2841,18622,21463
2015-11-21 01:00:00-05:00,0,11,1,5,0,3217,15384,18601
2015-11-21 02:00:00-05:00,0,11,2,5,0,3682,19742,23424
2015-11-21 03:00:00-05:00,0,11,3,5,0,4133,25328,29461
2015-11-21 04:00:00-05:00,0,11,4,5,0,4517,26843,31360
2015-11-21 05:00:00-05:00,0,11,5,5,0,4182,24967,29149
2015-11-21 06:00:00-05:00,0,11,6,5,0,4173,25082,29255
2015-11-21 07:00:00-05:00,0,11,7,5,0,4250,26429,30679
2015-11-21 08:00:00-05:00,0,11,8,5,0,4355,25796,30151
2015-11-21 09:00:00-05:00,0,11,9,5,0,4118,23267,27385
2015-11-21 10:00:00-05:00,0,11,10,5,0,3683,20950,24633
2015-11-21 11:00:00-05:00,0,11,11,5,0,3195,17250,20445
2015-11-21 12:00:00-05:00,0,11,12,5,0,2483,12583,15066
2015-11-21 13:00:00-05:00,0,11,13,5,0,1925,8107,10032
2015-11-21 14:00:00-05:00,0,11,14,5,0,977,3992,4969
2015-11-21 15:00:00-05:00,0,11,15,5,0,870,5136,6006
2015-11-21 16:00:00-05:00,0,11,16,5,0,1013,7552,8565
2015-11-21 17:00:00-05:00,0,11,17,5,0,1429,11441,12870
2015-11-21 18:00:00-05:00,0,11,18,5,0,1904,15913,17817
2015-11-21 19:00:00-05:00,0,11,19,5,0,2131,18691,20822
2015-11-21 20:00:00-05:00,0,11,20,5,0,2348,20920,23268
2015-11-21 21:00:00-05:00,0,11,21,5,0,2480,22659,25139
2015-11-21 22:00:00-05:00,0,11,22,5,0,2542,22083,24625
2015-11-21 23:00:00-05:00,0,11,23,5,0,2724,21675,24399
2015-11-22 00:00:00-05:00,0,11,0,6,0,3018,22145,25163
2015-11-22 01:00:00-05:00,0,11,1,6,0,3244,19056,22300
2015-11-22 02:00:00-05:00,0,11,2,6,0,3624,21397,25021
2015-11-22 03:00:00-05:00,0,11,3,6,0,3837,25038,28875
2015-11-22 04:00:00-05:00,0,11,4,6,0,4065,25998,30063
2015-11-22 05:00:00-05:00,0,11,5,6,0,3980,21613,25593
2015-11-22 06:00:00-05:00,0,11,6,6,0,4020,21546,25566
2015-11-22 07:00:00-05:00,0,11,7,6,0,4367,24466,28833
2015-11-22 08:00:00-05:00,0,11,8,6,0,4457,25826,30283
2015-11-22 09:00:00-05:00,0,11,9,6,0,4251,24259,28510
2015-11-22 10:00:00-05:00,0,11,10,6,0,4393,22616,27009
2015-11-22 11:00:00-05:00,0,11,11,6,0,3645,19134,22779
2015-11-22 12:00:00-05:00,0,11,12,6,0,2921,14350,17271
2015-11-22 13:00:00-05:00,0,11,13,6,0,2166,8738,10904
2015-11-22 14:00:00-05:00,0,11,14,6,0,1126,4034,5160
2015-11-22 15:00:00-05:00,0,11,15,6,0,812,4227,5039
2015-11-22 16:00:00-05:00,0,11,16,6,0,731,5566,6297
2015-11-22 17:00:00-05:00,0,11,17,6,0,948,8247,9195
2015-11-22 18:00:00-05:00,0,11,18,6,0,1351,12221,13572
2015-11-22 19:00:00-05:00,0,11,19,6,0,1783,16893,18676
2015-11-22 20:00:00-05:00,0,11,20,6,0,2106,19513,21619
2015-11-22 21:00:00-05:00,0,11,21,6,0,2210,21581,23791
2015-11-22 22:00:00-05:00,0,11,22,6,0,2372,21316,23688
2015-11-22 23:00:00-05:00,0,11,23,6,0,2494,20924,23418
2015-11-23 00:00:00-05:00,0,11,0,0,0,2697,20623,23320
2015-11-23 01:00:00-05:00,0,11,1,0,0,2755,18927,21682
2015-11-23 02:00:00-05:00,0,11,2,0,0,2875,19676,22551
2015-11-23 03:00:00-05:00,0,11,3,0,0,2879,20056,22935
2015-11-23 04:00:00-05:00,0,11,4,0,0,2836,18408,21244
2015-11-23 05:00:00-05:00,0,11,5,0,0,2626,16257,18883
2015-11-23 06:00:00-05:00,0,11,6,0,0,2374,15326,17700
2015-11-23 07:00:00-05:00,0,11,7,0,0,2130,13494,15624
2015-11-23 08:00:00-05:00,0,11,8,0,0,1745,10207,11952
2015-11-23 09:00:00-05:00,0,11,9,0,0,1273,6591,7864
2015-11-23 10:00:00-05:00,0,11,10,0,0,841,3923,4764
2015-11-23 11:00:00-05:00,0,11,11,0,0,567,2492,3059
2015-11-23 12:00:00-05:00,0,11,12,0,0,463,1869,2332
2015-11-23 13:00:00-05:00,0,11,13,0,0,541,2220,2761
2015-11-23 14:00:00-05:00,0,11,14,0,0,480,3773,4253
2015-11-23 15:00:00-05:00,0,11,15,0,0,893,10472,11365
2015-11-23 16:00:00-05:00,0,11,16,0,0,1925,17832,19757
2015-11-23 17:00:00-05:00,0,11,17,0,0,2625,20664,23289
2015-11-23 18:00:00-05:00,0,11,18,0,0,2491,19159,21650
2015-11-23 19:00:00-05:00,0,11,19,0,0,2008,17308,19316
2015-11-23 20:00:00-05:00,0,11,20,0,0,1813,17225,19038
2015-11-23 21:00:00-05:00,0,11,21,0,0,1857,18343,20200
2015-11-23 22:00:00-05:00,0,11,22,0,0,1868,18128,19996
2015-11-23 23:00:00-05:00,0,11,23,0,0,2080,19821,21901
2015-11-24 00:00:00-05:00,0,11,0,1,0,2362,19740,22102
2015-11-24 01:00:00-05:00,0,11,1,1,0,2635,17008,19643
2015-11-24 02:00:00-05:00,0,11,2,1,0,3100,21019,24119
2015-11-24 03:00:00-05:00,0,11,3,1,0,3209,24365,27574
2015-11-24 04:00:00-05:00,0,11,4,1,0,3303,24437,27740
2015-11-24 05:00:00-05:00,0,11,5,1,0,2825,23293,26118
2015-11-24 06:00:00-05:00,0,11,6,1,0,2457,22941,25398
2015-11-24 07:00:00-05:00,0,11,7,1,0,2093,19990,22083
2015-11-24 08:00:00-05:00,0,11,8,1,0,1722,13399,15121
2015-11-24 09:00:00-05:00,0,11,9,1,0,1266,9074,10340
2015-11-24 10:00:00-05:00,0,11,10,1,0,758,4943,5701
2015-11-24 11:00:00-05:00,0,11,11,1,0,502,3075,3577
2015-11-24 12:00:00-05:00,0,11,12,1,0,354,2066,2420
2015-11-24 13:00:00-05:00,0,11,13,1,0,423,2464,2887
2015-11-24 14:00:00-05:00,0,11,14,1,0,416,4207,4623
2015-11-24 15:00:00-05:00,0,11,15,1,0,808,10795,11603
2015-11-24 16:00:00-05:00,0,11,16,1,0,1754,18801,20555
2015-11-24 17:00:00-05:00,0,11,17,1,0,2683,21738,24421
2015-11-24 18:00:00-05:00,0,11,18,1,0,2488,20499,22987
2015-11-24 19:00:00-05:00,0,11,19,1,0,2078,18661,20739
2015-11-24 20:00:00-05:00,0,11,20,1,0,1918,18763,20681
2015-11-24 21:00:00-05:00,0,11,21,1,0,1950,19538,21488
2015-11-24 22:00:00-05:00,0,11,22,1,0,2015,19509,21524
2015-11-24 23:00:00-05:00,0,11,23,1,0,2253,20691,22944
2015-11-25 00:00:00-05:00,0,11,0,2,0,2523,19048,21571
2015-11-25 01:00:00-05:00,0,11,1,2,0,2629,14832,17461
2015-11-25 02:00:00-05:00,0,11,2,2,0,3094,18585,21679
2015-11-25 03:00:00-05:00,0,11,3,2,0,3438,23073,26511
2015-11-25 04:00:00-05:00,0,11,4,2,0,3295,23408,26703
2015-11-25 05:00:00-05:00,0,11,5,2,0,2974,22905,25879
2015-11-25 06:00:00-05:00,0,11,6,2,0,2737,22567,25304
2015-11-25 07:00:00-05:00,0,11,7,2,0,2279,20897,23176
2015-11-25 08:00:00-05:00,0,11,8,2,0,1962,17811,19773
2015-11-25 09:00:00-05:00,0,11,9,2,0,1517,12934,14451
2015-11-25 10:00:00-05:00,0,11,10,2,0,1040,7429,8469
2015-11-25 11:00:00-05:00,0,11,11,2,0,588,4701,5289
2015-11-25 12:00:00-05:00,0,11,12,2,0,454,3324,3778
2015-11-25 13:00:00-05:00,0,11,13,2,0,495,3283,3778
2015-11-25 14:00:00-05:00,0,11,14,2,0,460,4356,4816
2015-11-25 15:00:00-05:00,0,11,15,2,0,771,9569,10340
2015-11-25 16:00:00-05:00,0,11,16,2,0,1750,15467,17217
2015-11-25 17:00:00-05:00,0,11,17,2,0,2575,18818,21393
2015-11-25 18:00:00-05:00,0,11,18,2,0,2279,18735,21014
2015-11-25 19:00:00-05:00,0,11,19,2,0,2215,17666,19881
2015-11-25 20:00:00-05:00,0,11,20,2,0,2025,18650,20675
2015-11-25 21:00:00-05:00,0,11,21,2,0,2160,19956,22116
2015-11-25 22:00:00-05:00,0,11,22,2,0,2352,20050,22402
2015-11-25 23:00:00-05:00,0,11,23,2,0,2671,19968,22639
2015-11-26 00:00:00-05:00,0,11,0,3,1,2968,18454,21422
2015-11-26 01:00:00-05:00,0,11,1,3,1,3264,15814,19078
2015-11-26 02:00:00-05:00,0,11,2,3,1,3444,18966,22410
2015-11-26 03:00:00-05:00,0,11,3,3,1,3521,21558,25079
2015-11-26 04:00:00-05:00,0,11,4,3,1,3378,20709,24087
2015-11-26 05:00:00-05:00,0,11,5,3,1,2972,17766,20738
2015-11-26 06:00:00-05:00,0,11,6,3,1,2862,17753,20615
2015-11-26 07:00:00-05:00,0,11,7,3,1,2787,17517,20304
2015-11-26 08:00:00-05:00,0,11,8,3,1,2465,15280,17745
2015-11-26 09:00:00-05:00,0,11,9,3,1,2085,12627,14712
2015-11-26 10:00:00-05:00,0,11,10,3,1,1658,10209,11867
2015-11-26 11:00:00-05:00,0,11,11,3,1,1404,8093,9497
2015-11-26 12:00:00-05:00,0,11,12,3,1,1126,6307,7433
2015-11-26 13:00:00-05:00,0,11,13,3,1,1078,5040,6118
2015-11-26 14:00:00-05:00,0,11,14,3,1,681,3665,4346
2015-11-26 15:00:00-05:00,0,11,15,3,1,726,4958,5684
2015-11-26 16:00:00-05:00,0,11,16,3,1,829,6325,7154
2015-11-26 17:00:00-05:00,0,11,17,3,1,908,7235,8143
2015-11-26 18:00:00-05:00,0,11,18,3,1,1064,8023,9087
2015-11-26 19:00:00-05:00,0,11,19,3,1,1230,9306,10536
2015-11-26 20:00:00-05:00,0,11,20,3,1,1482,11377,12859
2015-11-26 21:00:00-05:00,0,11,21,3,1,1660,12218,13878
2015-11-26 22:00:00-05:00,0,11,22,3,1,2066,12656,14722
2015-11-26 23:00:00-05:00,0,11,23,3,1,2344,12969,15313
2015-11-27 00:00:00-05:00,0,11,0,4,0,2689,13533,16222
2015-11-27 01:00:00-05:00,0,11,1,4,0,2931,12459,15390
2015-11-27 02:00:00-05:00,0,11,2,4,0,3138,11911,15049
2015-11-27 03:00:00-05:00,0,11,3,4,0,3285,11717,15002
2015-11-27 04:00:00-05:00,0,11,4,4,0,3293,12176,15469
2015-11-27 05:00:00-05:00,0,11,5,4,0,3352,12873,16225
2015-11-27 06:00:00-05:00,0,11,6,4,0,3436,13477,16913
2015-11-27 07:00:00-05:00,0,11,7,4,0,3377,13134,16511
2015-11-27 08:00:00-05:00,0,11,8,4,0,3199,10105,13304
2015-11-27 09:00:00-05:00,0,11,9,4,0,2773,7590,10363
2015-11-27 10:00:00-05:00,0,11,10,4,0,1981,5041,7022
2015-11-27 11:00:00-05:00,0,11,11,4,0,1363,3413,4776
2015-11-27 12:00:00-05:00,0,11,12,4,0,912,2446,3358
2015-11-27 13:00:00-05:00,0,11,13,4,0,752,2187,2939
2015-11-27 14:00:00-05:00,0,11,14,4,0,477,1983,2460
2015-11-27 15:00:00-05:00,0,11,15,4,0,574,3728,4302
2015-11-27 16:00:00-05:00,0,11,16,4,0,806,5672,6478
2015-11-27 17:00:00-05:00,0,11,17,4,0,1047,7500,8547
2015-11-27 18:00:00-05:00,0,11,18,4,0,1148,9575,10723
2015-11-27 19:00:00-05:00,0,11,19,4,0,1330,11720,13050
2015-11-27 20:00:00-05:00,0,11,20,4,0,1383,13141,14524
2015-11-27 21:00:00-05:00,0,11,21,4,0,1473,14993,16466
2015-11-27 22:00:00-05:00,0,11,22,4,0,1586,16209,17795
2015-11-27 23:00:00-05:00,0,11,23,4,0,1818,16705,18523
2015-11-28 00:00:00-05:00,0,11,0,5,0,2232,17056,19288
2015-11-28 01:00:00-05:00,0,11,1,5,0,2391,16676,19067
2015-11-28 02:00:00-05:00,0,11,2,5,0,2581,18183,20764
2015-11-28 03:00:00-05:00,0,11,3,5,0,2675,18671,21346
2015-11-28 04:00:00-05:00,0,11,4,5,0,2708,18852,21560
2015-11-28 05:00:00-05:00,0,11,5,5,0,2413,15103,17516
2015-11-28 06:00:00-05:00,0,11,6,5,0,2438,15613,18051
2015-11-28 07:00:00-05:00,0,11,7,5,0,2574,17245,19819
2015-11-28 08:00:00-05:00,0,11,8,5,0,2445,15776,18221
2015-11-28 09:00:00-05:00,0,11,9,5,0,2485,13483,15968
2015-11-28 10:00:00-05:00,0,11,10,5,0,2086,11525,13611
2015-11-28 11:00:00-05:00,0,11,11,5,0,1716,9637,11353
2015-11-28 12:00:00-05:00,0,11,12,5,0,1468,7639,9107
2015-11-28 13:00:00-05:00,0,11,13,5,0,1203,5447,6650
2015-11-28 14:00:00-05:00,0,11,14,5,0,651,2747,3398
2015-11-28 15:00:00-05:00,0.01,11,15,5,0,556,3115,3671
2015-11-28 16:00:00-05:00,0.01,11,16,5,0,668,4365,5033
2015-11-28 17:00:00-05:00,0.01,11,17,5,0,892,6625,7517
2015-11-28 18:00:00-05:00,0,11,18,5,0,1243,10003,11246
2015-11-28 19:00:00-05:00,0,11,19,5,0,1471,13251,14722
2015-11-28 20:00:00-05:00,0,11,20,5,0,1694,15682,17376
2015-11-28 21:00:00-05:00,0,11,21,5,0,1943,17841,19784
2015-11-28 22:00:00-05:00,0,11,22,5,0,2284,20665,22949
2015-11-28 23:00:00-05:00,0,11,23,5,0,2557,21605,24162
2015-11-29 00:00:00-05:00,0,11,0,6,0,2739,20423,23162
2015-11-29 01:00:00-05:00,0,11,1,6,0,2937,18639,21576
2015-11-29 02:00:00-05:00,0,11,2,6,0,2936,19442,22378
2015-11-29 03:00:00-05:00,0,11,3,6,0,3033,21048,24081
2015-11-29 04:00:00-05:00,0,11,4,6,0,3136,22473,25609
2015-11-29 05:00:00-05:00,0,11,5,6,0,2983,18686,21669
2015-11-29 06:00:00-05:00,0,11,6,6,0,3051,18600,21651
2015-11-29 07:00:00-05:00,0,11,7,6,0,2995,20410,23405
2015-11-29 08:00:00-05:00,0,11,8,6,0,3142,21176,24318
2015-11-29 09:00:00-05:00,0,11,9,6,0,3176,17935,21111
2015-11-29 10:00:00-05:00,0,11,10,6,0,2849,15704,18553
2015-11-29 11:00:00-05:00,0,11,11,6,0,2501,13138,15639
2015-11-29 12:00:00-05:00,0,11,12,6,0,2187,10068,12255
2015-11-29 13:00:00-05:00,0,11,13,6,0,1639,6952,8591
2015-11-29 14:00:00-05:00,0,11,14,6,0,764,3356,4120
2015-11-29 15:00:00-05:00,0,11,15,6,0,566,3657,4223
2015-11-29 16:00:00-05:00,0,11,16,6,0,606,5067,5673
2015-11-29 17:00:00-05:00,0,11,17,6,0,792,7835,8627
2015-11-29 18:00:00-05:00,0,11,18,6,0,1151,11077,12228
2015-11-29 19:00:00-05:00,0,11,19,6,0,1517,14955,16472
2015-11-29 20:00:00-05:00,0,11,20,6,0,1925,16616,18541
2015-11-29 21:00:00-05:00,0,11,21,6,0,1974,18551,20525
2015-11-29 22:00:00-05:00,0,11,22,6,0,2123,18485,20608
2015-11-29 23:00:00-05:00,0,11,23,6,0,2248,19253,21501
2015-11-30 00:00:00-05:00,0,11,0,0,0,2476,18878,21354
2015-11-30 01:00:00-05:00,0,11,1,0,0,2614,18545,21159
2015-11-30 02:00:00-05:00,0,11,2,0,0,2747,19120,21867
2015-11-30 03:00:00-05:00,0,11,3,0,0,2714,19983,22697
2015-11-30 04:00:00-05:00,0,11,4,0,0,2646,18481,21127
2015-11-30 05:00:00-05:00,0,11,5,0,0,2524,16745,19269
2015-11-30 06:00:00-05:00,0,11,6,0,0,2264,15542,17806
2015-11-30 07:00:00-05:00,0,11,7,0,0,2032,13818,15850
2015-11-30 08:00:00-05:00,0,11,8,0,0,1627,9985,11612
2015-11-30 09:00:00-05:00,0,11,9,0,0,1238,7056,8294
2015-11-30 10:00:00-05:00,0,11,10,0,0,812,3792,4604
2015-11-30 11:00:00-05:00,0,11,11,0,0,525,2181,2706
2015-11-30 12:00:00-05:00,0,11,12,0,0,411,1698,2109
2015-11-30 13:00:00-05:00,0,11,13,0,0,502,2061,2563
2015-11-30 14:00:00-05:00,0,11,14,0,0,406,3990,4396
2015-11-30 15:00:00-05:00,0,11,15,0,0,828,10557,11385
2015-11-30 16:00:00-05:00,0,11,16,0,0,1904,17928,19832
2015-11-30 17:00:00-05:00,0,11,17,0,0,2649,20501,23150
2015-11-30 18:00:00-05:00,0,11,18,0,0,2478,19167,21645
2015-11-30 19:00:00-05:00,0,11,19,0,0,2037,16563,18600
2015-11-30 20:00:00-05:00,0,11,20,0,0,1809,16479,18288
2015-11-30 21:00:00-05:00,0,11,21,0,0,1706,17258,18964
2015-11-30 22:00:00-05:00,0,11,22,0,0,1815,16880,18695
2015-11-30 23:00:00-05:00,0,11,23,0,0,2015,18441,20456
2015-12-01 00:00:00-05:00,0,12,0,1,0,2294,18802,21096
2015-12-01 01:00:00-05:00,0,12,1,1,0,2459,16736,19195
2015-12-01 02:00:00-05:00,0,12,2,1,0,2756,19614,22370
2015-12-01 03:00:00-05:00,0.02,12,3,1,0,2914,23373,26287
2015-12-01 04:00:00-05:00,0.06,12,4,1,0,2766,22721,25487
2015-12-01 05:00:00-05:00,0.04,12,5,1,0,2441,21656,24097
2015-12-01 06:00:00-05:00,0.01,12,6,1,0,2023,20749,22772
2015-12-01 07:00:00-05:00,0.01,12,7,1,0,1652,16928,18580
2015-12-01 08:00:00-05:00,0,12,8,1,0,1383,11871,13254
2015-12-01 09:00:00-05:00,0,12,9,1,0,1049,7788,8837
2015-12-01 10:00:00-05:00,0,12,10,1,0,758,4421,5179
2015-12-01 11:00:00-05:00,0,12,11,1,0,454,2858,3312
2015-12-01 12:00:00-05:00,0,12,12,1,0,373,2004,2377
2015-12-01 13:00:00-05:00,0,12,13,1,0,418,2166,2584
2015-12-01 14:00:00-05:00,0.01,12,14,1,0,410,4148,4558
2015-12-01 15:00:00-05:00,0.05,12,15,1,0,812,11352,12164
2015-12-01 16:00:00-05:00,0.02,12,16,1,0,1877,19604,21481
2015-12-01 17:00:00-05:00,0.01,12,17,1,0,2791,22195,24986
2015-12-01 18:00:00-05:00,0.02,12,18,1,0,2722,20631,23353
2015-12-01 19:00:00-05:00,0.03,12,19,1,0,2213,18764,20977
2015-12-01 20:00:00-05:00,0.02,12,20,1,0,2007,18383,20390
2015-12-01 21:00:00-05:00,0.03,12,21,1,0,1958,18376,20334
2015-12-01 22:00:00-05:00,0,12,22,1,0,2138,18727,20865
2015-12-01 23:00:00-05:00,0,12,23,1,0,2481,20114,22595
2015-12-02 00:00:00-05:00,0,12,0,2,0,2740,18628,21368
2015-12-02 01:00:00-05:00,0,12,1,2,0,2782,14775,17557
2015-12-02 02:00:00-05:00,0.01,12,2,2,0,3005,18325,21330
2015-12-02 03:00:00-05:00,0,12,3,2,0,3425,22830,26255
2015-12-02 04:00:00-05:00,0.02,12,4,2,0,3442,23754,27196
2015-12-02 05:00:00-05:00,0.01,12,5,2,0,2896,23907,26803
2015-12-02 06:00:00-05:00,0,12,6,2,0,2707,23881,26588
2015-12-02 07:00:00-05:00,0,12,7,2,0,2112,21033,23145
2015-12-02 08:00:00-05:00,0.01,12,8,2,0,1720,15726,17446
2015-12-02 09:00:00-05:00,0.03,12,9,2,0,1267,9613,10880
2015-12-02 10:00:00-05:00,0.02,12,10,2,0,760,5709,6469
2015-12-02 11:00:00-05:00,0,12,11,2,0,526,3395,3921
2015-12-02 12:00:00-05:00,0,12,12,2,0,359,2307,2666
2015-12-02 13:00:00-05:00,0,12,13,2,0,393,2369,2762
2015-12-02 14:00:00-05:00,0,12,14,2,0,349,3969,4318
2015-12-02 15:00:00-05:00,0,12,15,2,0,783,10883,11666
2015-12-02 16:00:00-05:00,0.03,12,16,2,0,1834,19767,21601
2015-12-02 17:00:00-05:00,0,12,17,2,0,2722,22534,25256
2015-12-02 18:00:00-05:00,0,12,18,2,0,2712,21118,23830
2015-12-02 19:00:00-05:00,0,12,19,2,0,2178,18405,20583
2015-12-02 20:00:00-05:00,0.01,12,20,2,0,1895,17513,19408
2015-12-02 21:00:00-05:00,0,12,21,2,0,2004,18838,20842
2015-12-02 22:00:00-05:00,0,12,22,2,0,2043,18505,20548
2015-12-02 23:00:00-05:00,0,12,23,2,0,2212,19200,21412
2015-12-03 00:00:00-05:00,0,12,0,3,0,2669,18346,21015
2015-12-03 01:00:00-05:00,0,12,1,3,0,2839,13959,16798
2015-12-03 02:00:00-05:00,0,12,2,3,0,3319,18205,21524
2015-12-03 03:00:00-05:00,0,12,3,3,0,3302,22073,25375
2015-12-03 04:00:00-05:00,0,12,4,3,0,3165,23659,26824
2015-12-03 05:00:00-05:00,0,12,5,3,0,2871,23032,25903
2015-12-03 06:00:00-05:00,0,12,6,3,0,2535,23922,26457
2015-12-03 07:00:00-05:00,0,12,7,3,0,2274,23040,25314
2015-12-03 08:00:00-05:00,0,12,8,3,0,2050,19395,21445
2015-12-03 09:00:00-05:00,0,12,9,3,0,1561,12263,13824
2015-12-03 10:00:00-05:00,0,12,10,3,0,1041,7353,8394
2015-12-03 11:00:00-05:00,0,12,11,3,0,759,4588,5347
2015-12-03 12:00:00-05:00,0,12,12,3,0,535,2881,3416
2015-12-03 13:00:00-05:00,0,12,13,3,0,462,2773,3235
2015-12-03 14:00:00-05:00,0,12,14,3,0,398,4147,4545
2015-12-03 15:00:00-05:00,0,12,15,3,0,828,10878,11706
2015-12-03 16:00:00-05:00,0,12,16,3,0,1903,20230,22133
2015-12-03 17:00:00-05:00,0,12,17,3,0,2622,22977,25599
2015-12-03 18:00:00-05:00,0,12,18,3,0,2530,21276,23806
2015-12-03 19:00:00-05:00,0,12,19,3,0,2216,19229,21445
2015-12-03 20:00:00-05:00,0,12,20,3,0,2020,18919,20939
2015-12-03 21:00:00-05:00,0,12,21,3,0,2004,19510,21514
2015-12-03 22:00:00-05:00,0,12,22,3,0,2202,19597,21799
2015-12-03 23:00:00-05:00,0,12,23,3,0,2355,20628,22983
2015-12-04 00:00:00-05:00,0,12,0,4,0,2629,18869,21498
2015-12-04 01:00:00-05:00,0,12,1,4,0,2899,15623,18522
2015-12-04 02:00:00-05:00,0,12,2,4,0,3248,20205,23453
2015-12-04 03:00:00-05:00,0,12,3,4,0,3731,25018,28749
2015-12-04 04:00:00-05:00,0,12,4,4,0,3788,26308,30096
2015-12-04 05:00:00-05:00,0,12,5,4,0,3376,26022,29398
2015-12-04 06:00:00-05:00,0,12,6,4,0,3108,26754,29862
2015-12-04 07:00:00-05:00,0,12,7,4,0,2828,25423,28251
2015-12-04 08:00:00-05:00,0,12,8,4,0,2544,22534,25078
2015-12-04 09:00:00-05:00,0,12,9,4,0,1967,17061,19028
2015-12-04 10:00:00-05:00,0,12,10,4,0,1396,11217,12613
2015-12-04 11:00:00-05:00,0,12,11,4,0,952,7006,7958
2015-12-04 12:00:00-05:00,0,12,12,4,0,660,4654,5314
2015-12-04 13:00:00-05:00,0,12,13,4,0,560,3713,4273
2015-12-04 14:00:00-05:00,0,12,14,4,0,442,4296,4738
2015-12-04 15:00:00-05:00,0,12,15,4,0,849,10526,11375
2015-12-04 16:00:00-05:00,0,12,16,4,0,1953,19111,21064
2015-12-04 17:00:00-05:00,0,12,17,4,0,2710,21938,24648
2015-12-04 18:00:00-05:00,0,12,18,4,0,2734,20774,23508
2015-12-04 19:00:00-05:00,0,12,19,4,0,2276,19024,21300
2015-12-04 20:00:00-05:00,0,12,20,4,0,2024,18935,20959
2015-12-04 21:00:00-05:00,0,12,21,4,0,1871,18823,20694
2015-12-04 22:00:00-05:00,0,12,22,4,0,1982,18897,20879
2015-12-04 23:00:00-05:00,0,12,23,4,0,2333,20727,23060
2015-12-05 00:00:00-05:00,0,12,0,5,0,2781,19127,21908
2015-12-05 01:00:00-05:00,0,12,1,5,0,3108,15890,18998
2015-12-05 02:00:00-05:00,0,12,2,5,0,3711,21025,24736
2015-12-05 03:00:00-05:00,0,12,3,5,0,4260,26061,30321
2015-12-05 04:00:00-05:00,0,12,4,5,0,4351,27049,31400
2015-12-05 05:00:00-05:00,0,12,5,5,0,4155,25994,30149
2015-12-05 06:00:00-05:00,0,12,6,5,0,3965,25861,29826
2015-12-05 07:00:00-05:00,0,12,7,5,0,4252,26839,31091
2015-12-05 08:00:00-05:00,0,12,8,5,0,4056,26459,30515
2015-12-05 09:00:00-05:00,0,12,9,5,0,4058,24771,28829
2015-12-05 10:00:00-05:00,0,12,10,5,0,3529,21287,24816
2015-12-05 11:00:00-05:00,0,12,11,5,0,2942,17799,20741
2015-12-05 12:00:00-05:00,0,12,12,5,0,2326,12635,14961
2015-12-05 13:00:00-05:00,0,12,13,5,0,1781,7927,9708
2015-12-05 14:00:00-05:00,0,12,14,5,0,866,3918,4784
2015-12-05 15:00:00-05:00,0,12,15,5,0,729,4617,5346
2015-12-05 16:00:00-05:00,0,12,16,5,0,991,7709,8700
2015-12-05 17:00:00-05:00,0,12,17,5,0,1391,11803,13194
2015-12-05 18:00:00-05:00,0,12,18,5,0,1783,16194,17977
2015-12-05 19:00:00-05:00,0,12,19,5,0,2014,19087,21101
2015-12-05 20:00:00-05:00,0,12,20,5,0,2251,21347,23598
2015-12-05 21:00:00-05:00,0,12,21,5,0,2341,22757,25098
2015-12-05 22:00:00-05:00,0,12,22,5,0,2545,23654,26199
2015-12-05 23:00:00-05:00,0,12,23,5,0,2698,23034,25732
2015-12-06 00:00:00-05:00,0,12,0,6,0,3146,23223,26369
2015-12-06 01:00:00-05:00,0,12,1,6,0,3379,19884,23263
2015-12-06 02:00:00-05:00,0,12,2,6,0,3603,21881,25484
2015-12-06 03:00:00-05:00,0,12,3,6,0,4016,24738,28754
2015-12-06 04:00:00-05:00,0,12,4,6,0,4445,25799,30244
2015-12-06 05:00:00-05:00,0,12,5,6,0,4205,23226,27431
2015-12-06 06:00:00-05:00,0,12,6,6,0,4028,22940,26968
2015-12-06 07:00:00-05:00,0,12,7,6,0,4299,24971,29270
2015-12-06 08:00:00-05:00,0,12,8,6,0,4725,25891,30616
2015-12-06 09:00:00-05:00,0,12,9,6,0,4540,25744,30284
2015-12-06 10:00:00-05:00,0,12,10,6,0,4227,23727,27954
2015-12-06 11:00:00-05:00,0,12,11,6,0,3696,20036,23732
2015-12-06 12:00:00-05:00,0,12,12,6,0,2995,14900,17895
2015-12-06 13:00:00-05:00,0,12,13,6,0,2115,9361,11476
2015-12-06 14:00:00-05:00,0,12,14,6,0,1015,3987,5002
2015-12-06 15:00:00-05:00,0,12,15,6,0,675,3901,4576
2015-12-06 16:00:00-05:00,0,12,16,6,0,750,5443,6193
2015-12-06 17:00:00-05:00,0,12,17,6,0,841,8807,9648
2015-12-06 18:00:00-05:00,0,12,18,6,0,1304,13456,14760
2015-12-06 19:00:00-05:00,0,12,19,6,0,1700,18562,20262
2015-12-06 20:00:00-05:00,0,12,20,6,0,1996,20688,22684
2015-12-06 21:00:00-05:00,0,12,21,6,0,2155,22353,24508
2015-12-06 22:00:00-05:00,0,12,22,6,0,2287,21651,23938
2015-12-06 23:00:00-05:00,0,12,23,6,0,2381,21739,24120
2015-12-07 00:00:00-05:00,0,12,0,0,0,2540,21382,23922
2015-12-07 01:00:00-05:00,0,12,1,0,0,2775,20228,23003
2015-12-07 02:00:00-05:00,0,12,2,0,0,2958,21019,23977
2015-12-07 03:00:00-05:00,0,12,3,0,0,2837,21273,24110
2015-12-07 04:00:00-05:00,0,12,4,0,0,2749,19971,22720
2015-12-07 05:00:00-05:00,0,12,5,0,0,2615,17923,20538
2015-12-07 06:00:00-05:00,0,12,6,0,0,2347,17111,19458
2015-12-07 07:00:00-05:00,0,12,7,0,0,2098,14721,16819
2015-12-07 08:00:00-05:00,0,12,8,0,0,1734,10899,12633
2015-12-07 09:00:00-05:00,0,12,9,0,0,1223,6927,8150
2015-12-07 10:00:00-05:00,0,12,10,0,0,777,4159,4936
2015-12-07 11:00:00-05:00,0,12,11,0,0,549,2607,3156
2015-12-07 12:00:00-05:00,0,12,12,0,0,454,1953,2407
2015-12-07 13:00:00-05:00,0,12,13,0,0,487,2300,2787
2015-12-07 14:00:00-05:00,0,12,14,0,0,441,4174,4615
2015-12-07 15:00:00-05:00,0,12,15,0,0,851,10543,11394
2015-12-07 16:00:00-05:00,0,12,16,0,0,1905,18568,20473
2015-12-07 17:00:00-05:00,0,12,17,0,0,2749,20895,23644
2015-12-07 18:00:00-05:00,0,12,18,0,0,2471,19365,21836
2015-12-07 19:00:00-05:00,0,12,19,0,0,2003,17499,19502
2015-12-07 20:00:00-05:00,0,12,20,0,0,1733,17406,19139
2015-12-07 21:00:00-05:00,0,12,21,0,0,1762,17807,19569
2015-12-07 22:00:00-05:00,0,12,22,0,0,1837,17881,19718
2015-12-07 23:00:00-05:00,0,12,23,0,0,1971,19395,21366
2015-12-08 00:00:00-05:00,0,12,0,1,0,2328,19383,21711
2015-12-08 01:00:00-05:00,0,12,1,1,0,2395,16971,19366
2015-12-08 02:00:00-05:00,0,12,2,1,0,2674,20599,23273
2015-12-08 03:00:00-05:00,0,12,3,1,0,2990,24385,27375
2015-12-08 04:00:00-05:00,0,12,4,1,0,2799,24638,27437
2015-12-08 05:00:00-05:00,0,12,5,1,0,2357,23500,25857
2015-12-08 06:00:00-05:00,0,12,6,1,0,2088,23746,25834
2015-12-08 07:00:00-05:00,0,12,7,1,0,1854,21385,23239
2015-12-08 08:00:00-05:00,0,12,8,1,0,1604,15629,17233
2015-12-08 09:00:00-05:00,0,12,9,1,0,1211,9155,10366
2015-12-08 10:00:00-05:00,0,12,10,1,0,802,5446,6248
2015-12-08 11:00:00-05:00,0,12,11,1,0,460,3308,3768
2015-12-08 12:00:00-05:00,0,12,12,1,0,334,2247,2581
2015-12-08 13:00:00-05:00,0,12,13,1,0,411,2300,2711
2015-12-08 14:00:00-05:00,0,12,14,1,0,400,3911,4311
2015-12-08 15:00:00-05:00,0,12,15,1,0,853,10801,11654
2015-12-08 16:00:00-05:00,0,12,16,1,0,1909,18897,20806
2015-12-08 17:00:00-05:00,0,12,17,1,0,2663,21684,24347
2015-12-08 18:00:00-05:00,0,12,18,1,0,2444,20012,22456
2015-12-08 19:00:00-05:00,0,12,19,1,0,2013,18188,20201
2015-12-08 20:00:00-05:00,0,12,20,1,0,1812,17894,19706
2015-12-08 21:00:00-05:00,0,12,21,1,0,1831,18218,20049
2015-12-08 22:00:00-05:00,0,12,22,1,0,1847,18180,20027
2015-12-08 23:00:00-05:00,0,12,23,1,0,2081,19360,21441
2015-12-09 00:00:00-05:00,0,12,0,2,0,2359,18242,20601
2015-12-09 01:00:00-05:00,0,12,1,2,0,2516,14526,17042
2015-12-09 02:00:00-05:00,0,12,2,2,0,2870,18058,20928
2015-12-09 03:00:00-05:00,0,12,3,2,0,3075,22801,25876
2015-12-09 04:00:00-05:00,0,12,4,2,0,3053,24188,27241
2015-12-09 05:00:00-05:00,0,12,5,2,0,2817,24901,27718
2015-12-09 06:00:00-05:00,0,12,6,2,0,2501,26180,28681
2015-12-09 07:00:00-05:00,0,12,7,2,0,2173,23908,26081
2015-12-09 08:00:00-05:00,0,12,8,2,0,1865,19821,21686
2015-12-09 09:00:00-05:00,0,12,9,2,0,1405,12162,13567
2015-12-09 10:00:00-05:00,0,12,10,2,0,934,6750,7684
2015-12-09 11:00:00-05:00,0,12,11,2,0,560,4175,4735
2015-12-09 12:00:00-05:00,0,12,12,2,0,414,2659,3073
2015-12-09 13:00:00-05:00,0,12,13,2,0,327,2581,2908
2015-12-09 14:00:00-05:00,0,12,14,2,0,363,3974,4337
2015-12-09 15:00:00-05:00,0,12,15,2,0,716,10789,11505
2015-12-09 16:00:00-05:00,0,12,16,2,0,1796,19218,21014
2015-12-09 17:00:00-05:00,0,12,17,2,0,2828,22011,24839
2015-12-09 18:00:00-05:00,0,12,18,2,0,2563,20507,23070
2015-12-09 19:00:00-05:00,0,12,19,2,0,2087,18380,20467
2015-12-09 20:00:00-05:00,0,12,20,2,0,1913,18585,20498
2015-12-09 21:00:00-05:00,0,12,21,2,0,1962,18735,20697
2015-12-09 22:00:00-05:00,0,12,22,2,0,2013,18102,20115
2015-12-09 23:00:00-05:00,0,12,23,2,0,2281,19117,21398
2015-12-10 00:00:00-05:00,0,12,0,3,0,2395,17110,19505
2015-12-10 01:00:00-05:00,0,12,1,3,0,2594,13780,16374
2015-12-10 02:00:00-05:00,0,12,2,3,0,3006,17986,20992
2015-12-10 03:00:00-05:00,0,12,3,3,0,3327,23364,26691
2015-12-10 04:00:00-05:00,0,12,4,3,0,3353,24745,28098
2015-12-10 05:00:00-05:00,0,12,5,3,0,2877,24770,27647
2015-12-10 06:00:00-05:00,0,12,6,3,0,2613,26228,28841
2015-12-10 07:00:00-05:00,0,12,7,3,0,2436,24648,27084
2015-12-10 08:00:00-05:00,0,12,8,3,0,2148,21064,23212
2015-12-10 09:00:00-05:00,0,12,9,3,0,1603,14610,16213
2015-12-10 10:00:00-05:00,0,12,10,3,0,1108,8588,9696
2015-12-10 11:00:00-05:00,0,12,11,3,0,719,5180,5899
2015-12-10 12:00:00-05:00,0,12,12,3,0,488,3167,3655
2015-12-10 13:00:00-05:00,0,12,13,3,0,447,2869,3316
2015-12-10 14:00:00-05:00,0,12,14,3,0,387,4137,4524
2015-12-10 15:00:00-05:00,0,12,15,3,0,805,10885,11690
2015-12-10 16:00:00-05:00,0,12,16,3,0,1923,19669,21592
2015-12-10 17:00:00-05:00,0,12,17,3,0,2687,21850,24537
2015-12-10 18:00:00-05:00,0,12,18,3,0,2512,20210,22722
2015-12-10 19:00:00-05:00,0,12,19,3,0,2100,18094,20194
2015-12-10 20:00:00-05:00,0,12,20,3,0,1974,18547,20521
2015-12-10 21:00:00-05:00,0,12,21,3,0,1890,18425,20315
2015-12-10 22:00:00-05:00,0,12,22,3,0,1979,18244,20223
2015-12-10 23:00:00-05:00,0,12,23,3,0,2205,19228,21433
2015-12-11 00:00:00-05:00,0,12,0,4,0,2527,18035,20562
2015-12-11 01:00:00-05:00,0,12,1,4,0,2839,14298,17137
2015-12-11 02:00:00-05:00,0,12,2,4,0,3269,19082,22351
2015-12-11 03:00:00-05:00,0,12,3,4,0,3628,24247,27875
2015-12-11 04:00:00-05:00,0,12,4,4,0,3558,26003,29561
2015-12-11 05:00:00-05:00,0,12,5,4,0,3279,25990,29269
2015-12-11 06:00:00-05:00,0,12,6,4,0,3091,26653,29744
2015-12-11 07:00:00-05:00,0,12,7,4,0,3002,25090,28092
2015-12-11 08:00:00-05:00,0,12,8,4,0,2689,23075,25764
2015-12-11 09:00:00-05:00,0,12,9,4,0,2353,20654,23007
2015-12-11 10:00:00-05:00,0,12,10,4,0,1803,14174,15977
2015-12-11 11:00:00-05:00,0,12,11,4,0,1159,9002,10161
2015-12-11 12:00:00-05:00,0,12,12,4,0,655,5447,6102
2015-12-11 13:00:00-05:00,0,12,13,4,0,568,4040,4608
2015-12-11 14:00:00-05:00,0,12,14,4,0,432,4454,4886
2015-12-11 15:00:00-05:00,0,12,15,4,0,838,10398,11236
2015-12-11 16:00:00-05:00,0,12,16,4,0,1886,18843,20729
2015-12-11 17:00:00-05:00,0,12,17,4,0,2748,21521,24269
2015-12-11 18:00:00-05:00,0,12,18,4,0,2634,19548,22182
2015-12-11 19:00:00-05:00,0,12,19,4,0,2229,18104,20333
2015-12-11 20:00:00-05:00,0,12,20,4,0,2021,18228,20249
2015-12-11 21:00:00-05:00,0,12,21,4,0,1950,17947,19897
2015-12-11 22:00:00-05:00,0,12,22,4,0,1912,18748,20660
2015-12-11 23:00:00-05:00,0,12,23,4,0,2356,19921,22277
2015-12-12 00:00:00-05:00,0,12,0,5,0,2820,18039,20859
2015-12-12 01:00:00-05:00,0,12,1,5,0,3107,15219,18326
2015-12-12 02:00:00-05:00,0,12,2,5,0,3600,19581,23181
2015-12-12 03:00:00-05:00,0,12,3,5,0,3990,24907,28897
2015-12-12 04:00:00-05:00,0,12,4,5,0,4261,26029,30290
2015-12-12 05:00:00-05:00,0,12,5,5,0,3977,24888,28865
2015-12-12 06:00:00-05:00,0,12,6,5,0,3877,25571,29448
2015-12-12 07:00:00-05:00,0,12,7,5,0,4276,26380,30656
2015-12-12 08:00:00-05:00,0,12,8,5,0,4661,26186,30847
2015-12-12 09:00:00-05:00,0,12,9,5,0,4325,24016,28341
2015-12-12 10:00:00-05:00,0,12,10,5,0,3753,21531,25284
2015-12-12 11:00:00-05:00,0,12,11,5,0,3079,17738,20817
2015-12-12 12:00:00-05:00,0,12,12,5,0,2324,12579,14903
2015-12-12 13:00:00-05:00,0,12,13,5,0,1821,8036,9857
2015-12-12 14:00:00-05:00,0,12,14,5,0,856,3954,4810
2015-12-12 15:00:00-05:00,0,12,15,5,0,716,4401,5117
2015-12-12 16:00:00-05:00,0,12,16,5,0,907,7272,8179
2015-12-12 17:00:00-05:00,0,12,17,5,0,1233,11015,12248
2015-12-12 18:00:00-05:00,0,12,18,5,0,1686,15891,17577
2015-12-12 19:00:00-05:00,0,12,19,5,0,1960,20066,22026
2015-12-12 20:00:00-05:00,0,12,20,5,0,2222,22143,24365
2015-12-12 21:00:00-05:00,0,12,21,5,0,2316,24040,26356
2015-12-12 22:00:00-05:00,0,12,22,5,0,2629,24403,27032
2015-12-12 23:00:00-05:00,0,12,23,5,0,2806,23818,26624
2015-12-13 00:00:00-05:00,0,12,0,6,0,2967,22270,25237
2015-12-13 01:00:00-05:00,0,12,1,6,0,3135,18056,21191
2015-12-13 02:00:00-05:00,0,12,2,6,0,3463,20180,23643
2015-12-13 03:00:00-05:00,0,12,3,6,0,3850,23496,27346
2015-12-13 04:00:00-05:00,0,12,4,6,0,4365,23798,28163
2015-12-13 05:00:00-05:00,0,12,5,6,0,4262,21804,26066
2015-12-13 06:00:00-05:00,0,12,6,6,0,4181,21754,25935
2015-12-13 07:00:00-05:00,0,12,7,6,0,4457,23440,27897
2015-12-13 08:00:00-05:00,0,12,8,6,0,4788,23565,28353
2015-12-13 09:00:00-05:00,0,12,9,6,0,4752,22930,27682
2015-12-13 10:00:00-05:00,0,12,10,6,0,4568,22801,27369
2015-12-13 11:00:00-05:00,0,12,11,6,0,3785,18625,22410
2015-12-13 12:00:00-05:00,0,12,12,6,0,3069,13945,17014
2015-12-13 13:00:00-05:00,0,12,13,6,0,2362,9024,11386
2015-12-13 14:00:00-05:00,0,12,14,6,0,1299,4176,5475
2015-12-13 15:00:00-05:00,0,12,15,6,0,824,4143,4967
2015-12-13 16:00:00-05:00,0,12,16,6,0,842,5736,6578
2015-12-13 17:00:00-05:00,0,12,17,6,0,940,8896,9836
2015-12-13 18:00:00-05:00,0,12,18,6,0,1293,13238,14531
2015-12-13 19:00:00-05:00,0,12,19,6,0,1721,18183,19904
2015-12-13 20:00:00-05:00,0,12,20,6,0,2065,20495,22560
2015-12-13 21:00:00-05:00,0,12,21,6,0,2219,21567,23786
2015-12-13 22:00:00-05:00,0,12,22,6,0,2296,20829,23125
2015-12-13 23:00:00-05:00,0,12,23,6,0,2467,20980,23447
2015-12-14 00:00:00-05:00,0,12,0,0,0,2757,19821,22578
2015-12-14 01:00:00-05:00,0,12,1,0,0,2901,17066,19967
2015-12-14 02:00:00-05:00,0,12,2,0,0,3039,17721,20760
2015-12-14 03:00:00-05:00,0,12,3,0,0,3104,18689,21793
2015-12-14 04:00:00-05:00,0,12,4,0,0,2946,18494,21440
2015-12-14 05:00:00-05:00,0,12,5,0,0,2606,17083,19689
2015-12-14 06:00:00-05:00,0,12,6,0,0,2476,16721,19197
2015-12-14 07:00:00-05:00,0,12,7,0,0,2125,14482,16607
2015-12-14 08:00:00-05:00,0,12,8,0,0,1751,11428,13179
2015-12-14 09:00:00-05:00,0,12,9,0,0,1302,7337,8639
2015-12-14 10:00:00-05:00,0,12,10,0,0,917,4302,5219
2015-12-14 11:00:00-05:00,0,12,11,0,0,609,2949,3558
2015-12-14 12:00:00-05:00,0,12,12,0,0,449,2227,2676
2015-12-14 13:00:00-05:00,0,12,13,0,0,525,2516,3041
2015-12-14 14:00:00-05:00,0,12,14,0,0,497,4130,4627
2015-12-14 15:00:00-05:00,0,12,15,0,0,886,10793,11679
2015-12-14 16:00:00-05:00,0,12,16,0,0,1900,18174,20074
2015-12-14 17:00:00-05:00,0,12,17,0,0,2755,20370,23125
2015-12-14 18:00:00-05:00,0,12,18,0,0,2379,18537,20916
2015-12-14 19:00:00-05:00,0.09,12,19,0,0,1945,16487,18432
2015-12-14 20:00:00-05:00,0.14,12,20,0,0,1757,16555,18312
2015-12-14 21:00:00-05:00,0.02,12,21,0,0,1840,17360,19200
2015-12-14 22:00:00-05:00,0.02,12,22,0,0,1823,17514,19337
2015-12-14 23:00:00-05:00,0.01,12,23,0,0,1988,18647,20635
2015-12-15 00:00:00-05:00,0,12,0,1,0,2242,18584,20826
2015-12-15 01:00:00-05:00,0,12,1,1,0,2435,16696,19131
2015-12-15 02:00:00-05:00,0.11,12,2,1,0,2811,19948,22759
2015-12-15 03:00:00-05:00,0,12,3,1,0,3071,24797,27868
2015-12-15 04:00:00-05:00,0,12,4,1,0,4255,28426,32681
2015-12-15 05:00:00-05:00,0,12,5,1,0,3179,24510,27689
2015-12-15 06:00:00-05:00,0,12,6,1,0,2460,23410,25870
2015-12-15 07:00:00-05:00,0,12,7,1,0,2038,20912,22950
2015-12-15 08:00:00-05:00,0,12,8,1,0,1708,15118,16826
2015-12-15 09:00:00-05:00,0,12,9,1,0,1165,9603,10768
2015-12-15 10:00:00-05:00,0,12,10,1,0,781,5635,6416
2015-12-15 11:00:00-05:00,0,12,11,1,0,557,3468,4025
2015-12-15 12:00:00-05:00,0,12,12,1,0,384,2195,2579
2015-12-15 13:00:00-05:00,0,12,13,1,0,406,2360,2766
2015-12-15 14:00:00-05:00,0,12,14,1,0,413,4022,4435
2015-12-15 15:00:00-05:00,0,12,15,1,0,733,10683,11416
2015-12-15 16:00:00-05:00,0,12,16,1,0,1875,19168,21043
2015-12-15 17:00:00-05:00,0,12,17,1,0,2792,22157,24949
2015-12-15 18:00:00-05:00,0,12,18,1,0,2420,20175,22595
2015-12-15 19:00:00-05:00,0,12,19,1,0,1959,18467,20426
2015-12-15 20:00:00-05:00,0,12,20,1,0,1872,18200,20072
2015-12-15 21:00:00-05:00,0,12,21,1,0,1791,18733,20524
2015-12-15 22:00:00-05:00,0,12,22,1,0,1902,18244,20146
2015-12-15 23:00:00-05:00,0,12,23,1,0,2129,20083,22212
2015-12-16 00:00:00-05:00,0,12,0,2,0,2413,19209,21622
2015-12-16 01:00:00-05:00,0,12,1,2,0,2545,15773,18318
2015-12-16 02:00:00-05:00,0,12,2,2,0,3066,20095,23161
2015-12-16 03:00:00-05:00,0,12,3,2,0,3339,24737,28076
2015-12-16 04:00:00-05:00,0,12,4,2,0,3355,25328,28683
2015-12-16 05:00:00-05:00,0,12,5,2,0,2869,25991,28860
2015-12-16 06:00:00-05:00,0,12,6,2,0,2753,26682,29435
2015-12-16 07:00:00-05:00,0,12,7,2,0,2548,25087,27635
2015-12-16 08:00:00-05:00,0,12,8,2,0,2199,20863,23062
2015-12-16 09:00:00-05:00,0,12,9,2,0,1646,13707,15353
2015-12-16 10:00:00-05:00,0,12,10,2,0,1150,8107,9257
2015-12-16 11:00:00-05:00,0,12,11,2,0,698,4780,5478
2015-12-16 12:00:00-05:00,0,12,12,2,0,512,3049,3561
2015-12-16 13:00:00-05:00,0,12,13,2,0,492,2945,3437
2015-12-16 14:00:00-05:00,0,12,14,2,0,406,4113,4519
2015-12-16 15:00:00-05:00,0,12,15,2,0,814,10932,11746
2015-12-16 16:00:00-05:00,0,12,16,2,0,1813,20197,22010
2015-12-16 17:00:00-05:00,0,12,17,2,0,2736,23170,25906
2015-12-16 18:00:00-05:00,0,12,18,2,0,2564,20933,23497
2015-12-16 19:00:00-05:00,0,12,19,2,0,2181,19089,21270
2015-12-16 20:00:00-05:00,0,12,20,2,0,1914,19694,21608
2015-12-16 21:00:00-05:00,0.01,12,21,2,0,1958,19992,21950
2015-12-16 22:00:00-05:00,0.03,12,22,2,0,2012,19530,21542
2015-12-16 23:00:00-05:00,0,12,23,2,0,2250,20823,23073
2015-12-17 00:00:00-05:00,0,12,0,3,0,2607,19205,21812
2015-12-17 01:00:00-05:00,0,12,1,3,0,2757,15634,18391
2015-12-17 02:00:00-05:00,0,12,2,3,0,3197,19898,23095
2015-12-17 03:00:00-05:00,0,12,3,3,0,3568,25112,28680
2015-12-17 04:00:00-05:00,0,12,4,3,0,3476,26045,29521
2015-12-17 05:00:00-05:00,0.01,12,5,3,0,3338,26668,30006
2015-12-17 06:00:00-05:00,0,12,6,3,0,3346,27531,30877
2015-12-17 07:00:00-05:00,0,12,7,3,0,3047,24325,27372
2015-12-17 08:00:00-05:00,0,12,8,3,0,2629,22164,24793
2015-12-17 09:00:00-05:00,0,12,9,3,0,1857,15651,17508
2015-12-17 10:00:00-05:00,0,12,10,3,0,1238,9789,11027
2015-12-17 11:00:00-05:00,0.04,12,11,3,0,809,6053,6862
2015-12-17 12:00:00-05:00,0.11,12,12,3,0,518,3632,4150
2015-12-17 13:00:00-05:00,0.07,12,13,3,0,457,3201,3658
2015-12-17 14:00:00-05:00,0.13,12,14,3,0,449,4336,4785
2015-12-17 15:00:00-05:00,0.22,12,15,3,0,857,10900,11757
2015-12-17 16:00:00-05:00,0.27,12,16,3,0,1931,20090,22021
2015-12-17 17:00:00-05:00,0.04,12,17,3,0,3055,23685,26740
2015-12-17 18:00:00-05:00,0,12,18,3,0,2710,21395,24105
2015-12-17 19:00:00-05:00,0,12,19,3,0,2417,20460,22877
2015-12-17 20:00:00-05:00,0,12,20,3,0,2481,21156,23637
2015-12-17 21:00:00-05:00,0,12,21,3,0,2528,20809,23337
2015-12-17 22:00:00-05:00,0,12,22,3,0,2572,19679,22251
2015-12-17 23:00:00-05:00,0,12,23,3,0,2913,20456,23369
2015-12-18 00:00:00-05:00,0,12,0,4,0,3484,17752,21236
2015-12-18 01:00:00-05:00,0,12,1,4,0,3638,13217,16855
2015-12-18 02:00:00-05:00,0,12,2,4,0,3765,17202,20967
2015-12-18 03:00:00-05:00,0,12,3,4,0,3808,22432,26240
2015-12-18 04:00:00-05:00,0,12,4,4,0,3708,24706,28414
2015-12-18 05:00:00-05:00,0,12,5,4,0,3282,24908,28190
2015-12-18 06:00:00-05:00,0,12,6,4,0,3179,27216,30395
2015-12-18 07:00:00-05:00,0,12,7,4,0,3139,25657,28796
2015-12-18 08:00:00-05:00,0,12,8,4,0,2959,24126,27085
2015-12-18 09:00:00-05:00,0,12,9,4,0,2450,20980,23430
2015-12-18 10:00:00-05:00,0,12,10,4,0,1759,15488,17247
2015-12-18 11:00:00-05:00,0.01,12,11,4,0,1183,9718,10901
2015-12-18 12:00:00-05:00,0,12,12,4,0,790,6296,7086
2015-12-18 13:00:00-05:00,0,12,13,4,0,605,4892,5497
2015-12-18 14:00:00-05:00,0,12,14,4,0,505,4955,5460
2015-12-18 15:00:00-05:00,0,12,15,4,0,877,10611,11488
2015-12-18 16:00:00-05:00,0,12,16,4,0,1978,18939,20917
2015-12-18 17:00:00-05:00,0,12,17,4,0,2863,22622,25485
2015-12-18 18:00:00-05:00,0,12,18,4,0,2727,21502,24229
2015-12-18 19:00:00-05:00,0,12,19,4,0,2605,21203,23808
2015-12-18 20:00:00-05:00,0,12,20,4,0,2436,21050,23486
2015-12-18 21:00:00-05:00,0,12,21,4,0,2105,20147,22252
2015-12-18 22:00:00-05:00,0,12,22,4,0,2209,20066,22275
2015-12-18 23:00:00-05:00,0,12,23,4,0,2607,21042,23649
2015-12-19 00:00:00-05:00,0,12,0,5,0,3173,19348,22521
2015-12-19 01:00:00-05:00,0,12,1,5,0,3516,16200,19716
2015-12-19 02:00:00-05:00,0,12,2,5,0,4351,21216,25567
2015-12-19 03:00:00-05:00,0,12,3,5,0,4900,26492,31392
2015-12-19 04:00:00-05:00,0,12,4,5,0,4993,27724,32717
2015-12-19 05:00:00-05:00,0,12,5,5,0,4980,26963,31943
2015-12-19 06:00:00-05:00,0,12,6,5,0,4719,26936,31655
2015-12-19 07:00:00-05:00,0,12,7,5,0,4671,27362,32033
2015-12-19 08:00:00-05:00,0,12,8,5,0,4733,26949,31682
2015-12-19 09:00:00-05:00,0,12,9,5,0,4578,25162,29740
2015-12-19 10:00:00-05:00,0,12,10,5,0,3972,22699,26671
2015-12-19 11:00:00-05:00,0,12,11,5,0,3236,19023,22259
2015-12-19 12:00:00-05:00,0,12,12,5,0,2636,13885,16521
2015-12-19 13:00:00-05:00,0,12,13,5,0,2005,9109,11114
2015-12-19 14:00:00-05:00,0,12,14,5,0,1043,4556,5599
2015-12-19 15:00:00-05:00,0,12,15,5,0,803,5145,5948
2015-12-19 16:00:00-05:00,0,12,16,5,0,934,6861,7795
2015-12-19 17:00:00-05:00,0,12,17,5,0,1276,10694,11970
2015-12-19 18:00:00-05:00,0,12,18,5,0,1827,15267,17094
2015-12-19 19:00:00-05:00,0,12,19,5,0,2111,19092,21203
2015-12-19 20:00:00-05:00,0,12,20,5,0,2440,22546,24986
2015-12-19 21:00:00-05:00,0,12,21,5,0,2617,24100,26717
2015-12-19 22:00:00-05:00,0,12,22,5,0,2805,24727,27532
2015-12-19 23:00:00-05:00,0,12,23,5,0,2878,24416,27294
2015-12-20 00:00:00-05:00,0,12,0,6,0,3414,23459,26873
2015-12-20 01:00:00-05:00,0,12,1,6,0,3623,19694,23317
2015-12-20 02:00:00-05:00,0,12,2,6,0,4020,21710,25730
2015-12-20 03:00:00-05:00,0,12,3,6,0,4322,25354,29676
2015-12-20 04:00:00-05:00,0,12,4,6,0,4691,26660,31351
2015-12-20 05:00:00-05:00,0,12,5,6,0,4497,23145,27642
2015-12-20 06:00:00-05:00,0,12,6,6,0,4415,22960,27375
2015-12-20 07:00:00-05:00,0,12,7,6,0,4487,24765,29252
2015-12-20 08:00:00-05:00,0,12,8,6,0,4805,25957,30762
2015-12-20 09:00:00-05:00,0,12,9,6,0,4714,25343,30057
2015-12-20 10:00:00-05:00,0,12,10,6,0,4032,22899,26931
2015-12-20 11:00:00-05:00,0,12,11,6,0,3476,19260,22736
2015-12-20 12:00:00-05:00,0,12,12,6,0,2985,15100,18085
2015-12-20 13:00:00-05:00,0,12,13,6,0,2118,9534,11652
2015-12-20 14:00:00-05:00,0,12,14,6,0,1257,4447,5704
2015-12-20 15:00:00-05:00,0,12,15,6,0,762,4213,4975
2015-12-20 16:00:00-05:00,0,12,16,6,0,793,5306,6099
2015-12-20 17:00:00-05:00,0,12,17,6,0,929,8096,9025
2015-12-20 18:00:00-05:00,0,12,18,6,0,1368,12349,13717
2015-12-20 19:00:00-05:00,0,12,19,6,0,1785,17118,18903
2015-12-20 20:00:00-05:00,0,12,20,6,0,2055,19977,22032
2015-12-20 21:00:00-05:00,0,12,21,6,0,2207,21476,23683
2015-12-20 22:00:00-05:00,0,12,22,6,0,2258,20107,22365
2015-12-20 23:00:00-05:00,0,12,23,6,0,2469,20464,22933
2015-12-21 00:00:00-05:00,0,12,0,0,0,2808,20093,22901
2015-12-21 01:00:00-05:00,0,12,1,0,0,3025,18815,21840
2015-12-21 02:00:00-05:00,0,12,2,0,0,3227,19900,23127
2015-12-21 03:00:00-05:00,0,12,3,0,0,3206,20681,23887
2015-12-21 04:00:00-05:00,0,12,4,0,0,3156,18833,21989
2015-12-21 05:00:00-05:00,0,12,5,0,0,2876,17569,20445
2015-12-21 06:00:00-05:00,0,12,6,0,0,2592,16939,19531
2015-12-21 07:00:00-05:00,0,12,7,0,0,2367,15233,17600
2015-12-21 08:00:00-05:00,0,12,8,0,0,1923,11403,13326
2015-12-21 09:00:00-05:00,0,12,9,0,0,1479,8235,9714
2015-12-21 10:00:00-05:00,0,12,10,0,0,1102,5315,6417
2015-12-21 11:00:00-05:00,0,12,11,0,0,707,3262,3969
2015-12-21 12:00:00-05:00,0,12,12,0,0,504,2388,2892
2015-12-21 13:00:00-05:00,0,12,13,0,0,574,2791,3365
2015-12-21 14:00:00-05:00,0,12,14,0,0,493,3752,4245
2015-12-21 15:00:00-05:00,0,12,15,0,0,778,8997,9775
2015-12-21 16:00:00-05:00,0,12,16,0,0,1761,14349,16110
2015-12-21 17:00:00-05:00,0,12,17,0,0,2525,17743,20268
2015-12-21 18:00:00-05:00,0,12,18,0,0,2346,17750,20096
2015-12-21 19:00:00-05:00,0,12,19,0,0,2006,16794,18800
2015-12-21 20:00:00-05:00,0,12,20,0,0,1885,17518,19403
2015-12-21 21:00:00-05:00,0,12,21,0,0,1959,18345,20304
2015-12-21 22:00:00-05:00,0,12,22,0,0,2058,19065,21123
2015-12-21 23:00:00-05:00,0,12,23,0,0,2179,20066,22245
2015-12-22 00:00:00-05:00,0,12,0,1,0,2439,18966,21405
2015-12-22 01:00:00-05:00,0,12,1,1,0,2581,16022,18603
2015-12-22 02:00:00-05:00,0,12,2,1,0,2851,18772,21623
2015-12-22 03:00:00-05:00,0,12,3,1,0,3148,22585,25733
2015-12-22 04:00:00-05:00,0,12,4,1,0,2986,21766,24752
2015-12-22 05:00:00-05:00,0,12,5,1,0,2672,20136,22808
2015-12-22 06:00:00-05:00,0,12,6,1,0,2435,20529,22964
2015-12-22 07:00:00-05:00,0,12,7,1,0,2056,18282,20338
2015-12-22 08:00:00-05:00,0,12,8,1,0,1913,13854,15767
2015-12-22 09:00:00-05:00,0.03,12,9,1,0,1414,9714,11128
2015-12-22 10:00:00-05:00,0.01,12,10,1,0,979,6377,7356
2015-12-22 11:00:00-05:00,0.1,12,11,1,0,650,4121,4771
2015-12-22 12:00:00-05:00,0.02,12,12,1,0,460,2839,3299
2015-12-22 13:00:00-05:00,0.01,12,13,1,0,456,2831,3287
2015-12-22 14:00:00-05:00,0.01,12,14,1,0,452,3795,4247
2015-12-22 15:00:00-05:00,0,12,15,1,0,750,8555,9305
2015-12-22 16:00:00-05:00,0,12,16,1,0,1629,13852,15481
2015-12-22 17:00:00-05:00,0,12,17,1,0,2424,18965,21389
2015-12-22 18:00:00-05:00,0,12,18,1,0,2401,19924,22325
2015-12-22 19:00:00-05:00,0,12,19,1,0,2208,17677,19885
2015-12-22 20:00:00-05:00,0,12,20,1,0,2340,20839,23179
2015-12-22 21:00:00-05:00,0,12,21,1,0,2164,18483,20647
2015-12-22 22:00:00-05:00,0,12,22,1,0,2267,18931,21198
2015-12-22 23:00:00-05:00,0,12,23,1,0,2418,19036,21454
2015-12-23 00:00:00-05:00,0,12,0,2,0,2592,17517,20109
2015-12-23 01:00:00-05:00,0,12,1,2,0,2642,14793,17435
2015-12-23 02:00:00-05:00,0,12,2,2,0,2838,18450,21288
2015-12-23 03:00:00-05:00,0,12,3,2,0,3122,22095,25217
2015-12-23 04:00:00-05:00,0,12,4,2,0,3237,21041,24278
2015-12-23 05:00:00-05:00,0,12,5,2,0,2789,19502,22291
2015-12-23 06:00:00-05:00,0,12,6,2,0,2575,20888,23463
2015-12-23 07:00:00-05:00,0,12,7,2,0,2235,19267,21502
2015-12-23 08:00:00-05:00,0,12,8,2,0,2106,15713,17819
2015-12-23 09:00:00-05:00,0,12,9,2,0,1546,11305,12851
2015-12-23 10:00:00-05:00,0,12,10,2,0,1074,7621,8695
2015-12-23 11:00:00-05:00,0,12,11,2,0,704,5141,5845
2015-12-23 12:00:00-05:00,0,12,12,2,0,557,3450,4007
2015-12-23 13:00:00-05:00,0.01,12,13,2,0,548,3369,3917
2015-12-23 14:00:00-05:00,0,12,14,2,0,445,3811,4256
2015-12-23 15:00:00-05:00,0.1,12,15,2,0,720,7887,8607
2015-12-23 16:00:00-05:00,0.47,12,16,2,0,1556,12535,14091
2015-12-23 17:00:00-05:00,0.45,12,17,2,0,2242,15957,18199
2015-12-23 18:00:00-05:00,0.09,12,18,2,0,2236,16253,18489
2015-12-23 19:00:00-05:00,0.08,12,19,2,0,2129,16674,18803
2015-12-23 20:00:00-05:00,0.17,12,20,2,0,2316,18961,21277
2015-12-23 21:00:00-05:00,0.01,12,21,2,0,2237,19931,22168
2015-12-23 22:00:00-05:00,0.04,12,22,2,0,2459,20749,23208
2015-12-23 23:00:00-05:00,0.03,12,23,2,0,2739,19975,22714
2015-12-24 00:00:00-05:00,0,12,0,3,0,3412,20011,23423
2015-12-24 01:00:00-05:00,0,12,1,3,0,3674,14513,18187
2015-12-24 02:00:00-05:00,0.01,12,2,3,0,3739,16992,20731
2015-12-24 03:00:00-05:00,0,12,3,3,0,3725,20325,24050
2015-12-24 04:00:00-05:00,0,12,4,3,0,3777,20867,24644
2015-12-24 05:00:00-05:00,0,12,5,3,0,3271,17818,21089
2015-12-24 06:00:00-05:00,0,12,6,3,0,2713,16228,18941
2015-12-24 07:00:00-05:00,0,12,7,3,0,2746,16279,19025
2015-12-24 08:00:00-05:00,0,12,8,3,0,2215,12703,14918
2015-12-24 09:00:00-05:00,0,12,9,3,0,1834,9937,11771
2015-12-24 10:00:00-05:00,0,12,10,3,0,1308,7476,8784
2015-12-24 11:00:00-05:00,0,12,11,3,0,930,5315,6245
2015-12-24 12:00:00-05:00,0,12,12,3,0,797,3548,4345
2015-12-24 13:00:00-05:00,0,12,13,3,0,703,3128,3831
2015-12-24 14:00:00-05:00,0,12,14,3,0,500,3157,3657
2015-12-24 15:00:00-05:00,0,12,15,3,0,640,5779,6419
2015-12-24 16:00:00-05:00,0,12,16,3,0,1131,8096,9227
2015-12-24 17:00:00-05:00,0,12,17,3,0,1582,11124,12706
2015-12-24 18:00:00-05:00,0,12,18,3,0,1827,12960,14787
2015-12-24 19:00:00-05:00,0,12,19,3,0,1908,14625,16533
2015-12-24 20:00:00-05:00,0,12,20,3,0,2168,16560,18728
2015-12-24 21:00:00-05:00,0,12,21,3,0,2372,18841,21213
2015-12-24 22:00:00-05:00,0,12,22,3,0,2742,19570,22312
2015-12-24 23:00:00-05:00,0,12,23,3,0,2993,18993,21986
2015-12-25 00:00:00-05:00,0,12,0,4,1,3226,18464,21690
2015-12-25 01:00:00-05:00,0,12,1,4,1,3642,16679,20321
2015-12-25 02:00:00-05:00,0,12,2,4,1,3859,17581,21440
2015-12-25 03:00:00-05:00,0,12,3,4,1,4108,17718,21826
2015-12-25 04:00:00-05:00,0,12,4,4,1,4032,15211,19243
2015-12-25 05:00:00-05:00,0,12,5,4,1,3838,13512,17350
2015-12-25 06:00:00-05:00,0,12,6,4,1,3718,13257,16975
2015-12-25 07:00:00-05:00,0,12,7,4,1,3480,13426,16906
2015-12-25 08:00:00-05:00,0,12,8,4,1,3082,12210,15292
2015-12-25 09:00:00-05:00,0,12,9,4,1,2661,10662,13323
2015-12-25 10:00:00-05:00,0,12,10,4,1,2489,8206,10695
2015-12-25 11:00:00-05:00,0,12,11,4,1,1985,5811,7796
2015-12-25 12:00:00-05:00,0,12,12,4,1,1535,4064,5599
2015-12-25 13:00:00-05:00,0,12,13,4,1,1168,3088,4256
2015-12-25 14:00:00-05:00,0,12,14,4,1,689,2103,2792
2015-12-25 15:00:00-05:00,0,12,15,4,1,530,2531,3061
2015-12-25 16:00:00-05:00,0.01,12,16,4,1,535,3164,3699
2015-12-25 17:00:00-05:00,0.01,12,17,4,1,587,3711,4298
2015-12-25 18:00:00-05:00,0.01,12,18,4,1,679,5306,5985
2015-12-25 19:00:00-05:00,0.01,12,19,4,1,916,7163,8079
2015-12-25 20:00:00-05:00,0,12,20,4,1,1031,8505,9536
2015-12-25 21:00:00-05:00,0,12,21,4,1,1231,10386,11617
2015-12-25 22:00:00-05:00,0,12,22,4,1,1450,10662,12112
2015-12-25 23:00:00-05:00,0,12,23,4,1,1674,10741,12415
2015-12-26 00:00:00-05:00,0,12,0,5,0,2080,11153,13233
2015-12-26 01:00:00-05:00,0,12,1,5,0,2333,11319,13652
2015-12-26 02:00:00-05:00,0,12,2,5,0,2491,11305,13796
2015-12-26 03:00:00-05:00,0,12,3,5,0,2443,11249,13692
2015-12-26 04:00:00-05:00,0,12,4,5,0,2264,10321,12585
2015-12-26 05:00:00-05:00,0,12,5,5,0,2257,9282,11539
2015-12-26 06:00:00-05:00,0,12,6,5,0,2121,9698,11819
2015-12-26 07:00:00-05:00,0,12,7,5,0,2141,9619,11760
2015-12-26 08:00:00-05:00,0,12,8,5,0,1946,8205,10151
2015-12-26 09:00:00-05:00,0,12,9,5,0,1779,6252,8031
2015-12-26 10:00:00-05:00,0,12,10,5,0,1410,4362,5772
2015-12-26 11:00:00-05:00,0,12,11,5,0,1028,3179,4207
2015-12-26 12:00:00-05:00,0,12,12,5,0,800,2496,3296
2015-12-26 13:00:00-05:00,0,12,13,5,0,731,2076,2807
2015-12-26 14:00:00-05:00,0,12,14,5,0,465,1598,2063
2015-12-26 15:00:00-05:00,0,12,15,5,0,431,2212,2643
2015-12-26 16:00:00-05:00,0,12,16,5,0,559,3372,3931
2015-12-26 17:00:00-05:00,0,12,17,5,0,717,4912,5629
2015-12-26 18:00:00-05:00,0,12,18,5,0,989,7409,8398
2015-12-26 19:00:00-05:00,0,12,19,5,0,1161,9857,11018
2015-12-26 20:00:00-05:00,0,12,20,5,0,1408,11570,12978
2015-12-26 21:00:00-05:00,0,12,21,5,0,1563,13476,15039
2015-12-26 22:00:00-05:00,0,12,22,5,0,1727,14637,16364
2015-12-26 23:00:00-05:00,0.01,12,23,5,0,1882,14247,16129
2015-12-27 00:00:00-05:00,0.09,12,0,6,0,2272,15733,18005
2015-12-27 01:00:00-05:00,0.03,12,1,6,0,2318,14265,16583
2015-12-27 02:00:00-05:00,0,12,2,6,0,2386,15159,17545
2015-12-27 03:00:00-05:00,0,12,3,6,0,2602,15921,18523
2015-12-27 04:00:00-05:00,0.01,12,4,6,0,2632,15909,18541
2015-12-27 05:00:00-05:00,0,12,5,6,0,2610,13756,16366
2015-12-27 06:00:00-05:00,0,12,6,6,0,2559,14087,16646
2015-12-27 07:00:00-05:00,0,12,7,6,0,2573,15769,18342
2015-12-27 08:00:00-05:00,0,12,8,6,0,2853,16392,19245
2015-12-27 09:00:00-05:00,0,12,9,6,0,2955,14706,17661
2015-12-27 10:00:00-05:00,0,12,10,6,0,2307,11003,13310
2015-12-27 11:00:00-05:00,0,12,11,6,0,1881,9219,11100
2015-12-27 12:00:00-05:00,0,12,12,6,0,1663,7551,9214
2015-12-27 13:00:00-05:00,0,12,13,6,0,1331,5494,6825
2015-12-27 14:00:00-05:00,0,12,14,6,0,676,2748,3424
2015-12-27 15:00:00-05:00,0,12,15,6,0,463,2819,3282
2015-12-27 16:00:00-05:00,0,12,16,6,0,562,3603,4165
2015-12-27 17:00:00-05:00,0,12,17,6,0,671,5465,6136
2015-12-27 18:00:00-05:00,0,12,18,6,0,936,7846,8782
2015-12-27 19:00:00-05:00,0,12,19,6,0,1247,11053,12300
2015-12-27 20:00:00-05:00,0.02,12,20,6,0,1398,13120,14518
2015-12-27 21:00:00-05:00,0,12,21,6,0,1561,14523,16084
2015-12-27 22:00:00-05:00,0,12,22,6,0,1704,14848,16552
2015-12-27 23:00:00-05:00,0,12,23,6,0,1816,14989,16805
2015-12-28 00:00:00-05:00,0,12,0,0,0,1974,15187,17161
2015-12-28 01:00:00-05:00,0,12,1,0,0,2046,14966,17012
2015-12-28 02:00:00-05:00,0,12,2,0,0,2122,15059,17181
2015-12-28 03:00:00-05:00,0,12,3,0,0,2405,16526,18931
2015-12-28 04:00:00-05:00,0,12,4,0,0,2265,15083,17348
2015-12-28 05:00:00-05:00,0,12,5,0,0,2276,15528,17804
2015-12-28 06:00:00-05:00,0,12,6,0,0,1937,13737,15674
2015-12-28 07:00:00-05:00,0,12,7,0,0,1745,13083,14828
2015-12-28 08:00:00-05:00,0,12,8,0,0,1573,10685,12258
2015-12-28 09:00:00-05:00,0,12,9,0,0,1266,7928,9194
2015-12-28 10:00:00-05:00,0,12,10,0,0,849,5189,6038
2015-12-28 11:00:00-05:00,0,12,11,0,0,593,3323,3916
2015-12-28 12:00:00-05:00,0,12,12,0,0,472,2375,2847
2015-12-28 13:00:00-05:00,0,12,13,0,0,459,2265,2724
2015-12-28 14:00:00-05:00,0,12,14,0,0,375,2676,3051
2015-12-28 15:00:00-05:00,0,12,15,0,0,547,5839,6386
2015-12-28 16:00:00-05:00,0,12,16,0,0,946,8367,9313
2015-12-28 17:00:00-05:00,0,12,17,0,0,1546,11364,12910
2015-12-28 18:00:00-05:00,0,12,18,0,0,1652,12888,14540
2015-12-28 19:00:00-05:00,0.03,12,19,0,0,1506,13638,15144
2015-12-28 20:00:00-05:00,0.01,12,20,0,0,1493,15037,16530
2015-12-28 21:00:00-05:00,0,12,21,0,0,1518,16768,18286
2015-12-28 22:00:00-05:00,0.01,12,22,0,0,1762,17262,19024
2015-12-28 23:00:00-05:00,0,12,23,0,0,1887,18370,20257
2015-12-29 00:00:00-05:00,0,12,0,1,0,2177,17956,20133
2015-12-29 01:00:00-05:00,0,12,1,1,0,2353,15987,18340
2015-12-29 02:00:00-05:00,0.04,12,2,1,0,2597,17931,20528
2015-12-29 03:00:00-05:00,0.07,12,3,1,0,2865,20778,23643
2015-12-29 04:00:00-05:00,0.04,12,4,1,0,3259,22177,25436
2015-12-29 05:00:00-05:00,0.03,12,5,1,0,2554,17794,20348
2015-12-29 06:00:00-05:00,0.14,12,6,1,0,2186,16544,18730
2015-12-29 07:00:00-05:00,0.04,12,7,1,0,1918,16169,18087
2015-12-29 08:00:00-05:00,0.01,12,8,1,0,1832,12773,14605
2015-12-29 09:00:00-05:00,0.01,12,9,1,0,1395,9244,10639
2015-12-29 10:00:00-05:00,0.05,12,10,1,0,1043,6118,7161
2015-12-29 11:00:00-05:00,0.02,12,11,1,0,596,3773,4369
2015-12-29 12:00:00-05:00,0,12,12,1,0,442,2497,2939
2015-12-29 13:00:00-05:00,0,12,13,1,0,397,2165,2562
2015-12-29 14:00:00-05:00,0,12,14,1,0,326,2916,3242
2015-12-29 15:00:00-05:00,0,12,15,1,0,551,6757,7308
2015-12-29 16:00:00-05:00,0,12,16,1,0,959,9469,10428
2015-12-29 17:00:00-05:00,0,12,17,1,0,1548,12184,13732
2015-12-29 18:00:00-05:00,0,12,18,1,0,1883,15638,17521
2015-12-29 19:00:00-05:00,0,12,19,1,0,1744,15163,16907
2015-12-29 20:00:00-05:00,0,12,20,1,0,1574,15784,17358
2015-12-29 21:00:00-05:00,0,12,21,1,0,1647,16932,18579
2015-12-29 22:00:00-05:00,0,12,22,1,0,1666,16954,18620
2015-12-29 23:00:00-05:00,0,12,23,1,0,1910,17326,19236
2015-12-30 00:00:00-05:00,0,12,0,2,0,2056,17603,19659
2015-12-30 01:00:00-05:00,0,12,1,2,0,2276,15975,18251
2015-12-30 02:00:00-05:00,0,12,2,2,0,2522,18208,20730
2015-12-30 03:00:00-05:00,0,12,3,2,0,2761,20631,23392
2015-12-30 04:00:00-05:00,0,12,4,2,0,2590,19075,21665
2015-12-30 05:00:00-05:00,0,12,5,2,0,2390,17072,19462
2015-12-30 06:00:00-05:00,0,12,6,2,0,2130,18238,20368
2015-12-30 07:00:00-05:00,0,12,7,2,0,1944,17180,19124
2015-12-30 08:00:00-05:00,0,12,8,2,0,1872,14828,16700
2015-12-30 09:00:00-05:00,0,12,9,2,0,1500,11293,12793
2015-12-30 10:00:00-05:00,0,12,10,2,0,1148,7647,8795
2015-12-30 11:00:00-05:00,0,12,11,2,0,795,5157,5952
2015-12-30 12:00:00-05:00,0,12,12,2,0,594,3563,4157
2015-12-30 13:00:00-05:00,0,12,13,2,0,486,2992,3478
2015-12-30 14:00:00-05:00,0,12,14,2,0,402,2907,3309
2015-12-30 15:00:00-05:00,0,12,15,2,0,513,6017,6530
2015-12-30 16:00:00-05:00,0,12,16,2,0,949,8205,9154
2015-12-30 17:00:00-05:00,0,12,17,2,0,1594,11759,13353
2015-12-30 18:00:00-05:00,0,12,18,2,0,1795,13690,15485
2015-12-30 19:00:00-05:00,0,12,19,2,0,1717,14161,15878
2015-12-30 20:00:00-05:00,0,12,20,2,0,1869,15038,16907
2015-12-30 21:00:00-05:00,0,12,21,2,0,1785,15534,17319
2015-12-30 22:00:00-05:00,0.06,12,22,2,0,1960,16376,18336
2015-12-30 23:00:00-05:00,0.1,12,23,2,0,2095,17677,19772
2015-12-31 00:00:00-05:00,0.04,12,0,3,0,2373,17047,19420
2015-12-31 01:00:00-05:00,0,12,1,3,0,2608,15120,17728
2015-12-31 02:00:00-05:00,0,12,2,3,0,2898,17436,20334
2015-12-31 03:00:00-05:00,0,12,3,3,0,3022,19729,22751
2015-12-31 04:00:00-05:00,0,12,4,3,0,3003,19592,22595
2015-12-31 05:00:00-05:00,0,12,5,3,0,2884,18365,21249
2015-12-31 06:00:00-05:00,0,12,6,3,0,2751,18668,21419
2015-12-31 07:00:00-05:00,0,12,7,3,0,3176,21505,24681
2015-12-31 08:00:00-05:00,0,12,8,3,0,2779,20171,22950
2015-12-31 09:00:00-05:00,0,12,9,3,0,2168,14375,16543
2015-12-31 10:00:00-05:00,0,12,10,3,0,1492,9738,11230
2015-12-31 11:00:00-05:00,0,12,11,3,0,1124,7342,8466
2015-12-31 12:00:00-05:00,0,12,12,3,0,792,5053,5845
2015-12-31 13:00:00-05:00,0,12,13,3,0,625,3534,4159
2015-12-31 14:00:00-05:00,0,12,14,3,0,406,2823,3229
2015-12-31 15:00:00-05:00,0,12,15,3,0,514,5067,5581
2015-12-31 16:00:00-05:00,0,12,16,3,0,901,7482,8383
2015-12-31 17:00:00-05:00,0,12,17,3,0,1401,10239,11640
2015-12-31 18:00:00-05:00,0,12,18,3,0,1652,11586,13238
2015-12-31 19:00:00-05:00,0,12,19,3,0,1796,13165,14961
2015-12-31 20:00:00-05:00,0,12,20,3,0,1860,15270,17130
2015-12-31 21:00:00-05:00,0,12,21,3,0,2142,16887,19029
2015-12-31 22:00:00-05:00,0,12,22,3,0,2413,17722,20135
2015-12-31 23:00:00-05:00,0,12,23,3,0,2742,18816,21558
2016-01-01 00:00:00-05:00,0,1,0,4,1,3349,19098,22447
2016-01-01 01:00:00-05:00,0,1,1,4,1,3645,17659,21304
2016-01-01 02:00:00-05:00,0,1,2,4,1,4061,18169,22230
2016-01-01 03:00:00-05:00,0,1,3,4,1,4371,19440,23811
2016-01-01 04:00:00-05:00,0,1,4,4,1,4923,21086,26009
2016-01-01 05:00:00-05:00,0,1,5,4,1,5837,22814,28651
2016-01-01 06:00:00-05:00,0,1,6,4,1,6435,23857,30292
2016-01-01 07:00:00-05:00,0,1,7,4,1,6553,21387,27940
2016-01-01 08:00:00-05:00,0,1,8,4,1,5758,17330,23088
2016-01-01 09:00:00-05:00,0,1,9,4,1,6419,25270,31689
2016-01-01 10:00:00-05:00,0,1,10,4,1,6858,28511,35369
2016-01-01 11:00:00-05:00,0,1,11,4,1,6347,25490,31837
2016-01-01 12:00:00-05:00,0,1,12,4,1,5658,21277,26935
2016-01-01 13:00:00-05:00,0,1,13,4,1,4700,15419,20119
2016-01-01 14:00:00-05:00,0,1,14,4,1,2992,8102,11094
2016-01-01 15:00:00-05:00,0,1,15,4,1,1913,6051,7964
2016-01-01 16:00:00-05:00,0,1,16,4,1,1297,5254,6551
2016-01-01 17:00:00-05:00,0,1,17,4,1,900,4940,5840
2016-01-01 18:00:00-05:00,0,1,18,4,1,798,6055,6853
2016-01-01 19:00:00-05:00,0,1,19,4,1,837,8435,9272
2016-01-01 20:00:00-05:00,0,1,20,4,1,1009,11752,12761
2016-01-01 21:00:00-05:00,0,1,21,4,1,1123,14027,15150
2016-01-01 22:00:00-05:00,0,1,22,4,1,1281,15694,16975
2016-01-01 23:00:00-05:00,0,1,23,4,1,1618,16552,18170
2016-01-02 00:00:00-05:00,0,1,0,5,0,1961,16139,18100
2016-01-02 01:00:00-05:00,0,1,1,5,0,1978,14786,16764
2016-01-02 02:00:00-05:00,0,1,2,5,0,2314,15847,18161
2016-01-02 03:00:00-05:00,0,1,3,5,0,2470,16780,19250
2016-01-02 04:00:00-05:00,0,1,4,5,0,2501,15669,18170
2016-01-02 05:00:00-05:00,0,1,5,5,0,2462,13249,15711
2016-01-02 06:00:00-05:00,0,1,6,5,0,2312,13073,15385
2016-01-02 07:00:00-05:00,0,1,7,5,0,2379,13742,16121
2016-01-02 08:00:00-05:00,0,1,8,5,0,2269,12923,15192
2016-01-02 09:00:00-05:00,0,1,9,5,0,2043,11265,13308
2016-01-02 10:00:00-05:00,0,1,10,5,0,1672,8549,10221
2016-01-02 11:00:00-05:00,0,1,11,5,0,1278,6644,7922
2016-01-02 12:00:00-05:00,0,1,12,5,0,1104,5416,6520
2016-01-02 13:00:00-05:00,0,1,13,5,0,943,4038,4981
2016-01-02 14:00:00-05:00,0,1,14,5,0,510,2396,2906
2016-01-02 15:00:00-05:00,0,1,15,5,0,428,3271,3699
2016-01-02 16:00:00-05:00,0,1,16,5,0,555,4229,4784
2016-01-02 17:00:00-05:00,0,1,17,5,0,835,6171,7006
2016-01-02 18:00:00-05:00,0,1,18,5,0,1205,9274,10479
2016-01-02 19:00:00-05:00,0,1,19,5,0,1502,12561,14063
2016-01-02 20:00:00-05:00,0,1,20,5,0,1686,15075,16761
2016-01-02 21:00:00-05:00,0,1,21,5,0,1747,17021,18768
2016-01-02 22:00:00-05:00,0,1,22,5,0,2065,17829,19894
2016-01-02 23:00:00-05:00,0,1,23,5,0,2149,17939,20088
2016-01-03 00:00:00-05:00,0,1,0,6,0,2594,18526,21120
2016-01-03 01:00:00-05:00,0,1,1,6,0,2747,17770,20517
2016-01-03 02:00:00-05:00,0,1,2,6,0,2844,19371,22215
2016-01-03 03:00:00-05:00,0,1,3,6,0,3199,20650,23849
2016-01-03 04:00:00-05:00,0,1,4,6,0,3161,20769,23930
2016-01-03 05:00:00-05:00,0,1,5,6,0,3068,17542,20610
2016-01-03 06:00:00-05:00,0,1,6,6,0,3209,17944,21153
2016-01-03 07:00:00-05:00,0,1,7,6,0,3238,19157,22395
2016-01-03 08:00:00-05:00,0,1,8,6,0,3176,19424,22600
2016-01-03 09:00:00-05:00,0,1,9,6,0,3257,18290,21547
2016-01-03 10:00:00-05:00,0,1,10,6,0,2807,15949,18756
2016-01-03 11:00:00-05:00,0,1,11,6,0,2366,13396,15762
2016-01-03 12:00:00-05:00,0,1,12,6,0,2050,10146,12196
2016-01-03 13:00:00-05:00,0,1,13,6,0,1635,7159,8794
2016-01-03 14:00:00-05:00,0,1,14,6,0,795,3384,4179
2016-01-03 15:00:00-05:00,0,1,15,6,0,525,3464,3989
2016-01-03 16:00:00-05:00,0,1,16,6,0,587,4285,4872
2016-01-03 17:00:00-05:00,0,1,17,6,0,706,6000,6706
2016-01-03 18:00:00-05:00,0,1,18,6,0,1111,9314,10425
2016-01-03 19:00:00-05:00,0,1,19,6,0,1491,13136,14627
2016-01-03 20:00:00-05:00,0,1,20,6,0,1772,15270,17042
2016-01-03 21:00:00-05:00,0,1,21,6,0,1757,17113,18870
2016-01-03 22:00:00-05:00,0,1,22,6,0,1980,17082,19062
2016-01-03 23:00:00-05:00,0,1,23,6,0,2151,17886,20037
2016-01-04 00:00:00-05:00,0,1,0,0,0,2338,17144,19482
2016-01-04 01:00:00-05:00,0,1,1,0,0,2484,17849,20333
2016-01-04 02:00:00-05:00,0,1,2,0,0,2469,17864,20333
2016-01-04 03:00:00-05:00,0,1,3,0,0,2518,17735,20253
2016-01-04 04:00:00-05:00,0,1,4,0,0,2453,15599,18052
2016-01-04 05:00:00-05:00,0,1,5,0,0,2150,13467,15617
2016-01-04 06:00:00-05:00,0,1,6,0,0,1911,12216,14127
2016-01-04 07:00:00-05:00,0,1,7,0,0,1569,10712,12281
2016-01-04 08:00:00-05:00,0,1,8,0,0,1388,8418,9806
2016-01-04 09:00:00-05:00,0,1,9,0,0,1018,5749,6767
2016-01-04 10:00:00-05:00,0,1,10,0,0,671,3580,4251
2016-01-04 11:00:00-05:00,0,1,11,0,0,479,2304,2783
2016-01-04 12:00:00-05:00,0,1,12,0,0,376,1595,1971
2016-01-04 13:00:00-05:00,0,1,13,0,0,378,1999,2377
2016-01-04 14:00:00-05:00,0,1,14,0,0,353,3426,3779
2016-01-04 15:00:00-05:00,0,1,15,0,0,724,9684,10408
2016-01-04 16:00:00-05:00,0,1,16,0,0,1775,15934,17709
2016-01-04 17:00:00-05:00,0,1,17,0,0,2786,19263,22049
2016-01-04 18:00:00-05:00,0,1,18,0,0,2437,17283,19720
2016-01-04 19:00:00-05:00,0,1,19,0,0,1887,14268,16155
2016-01-04 20:00:00-05:00,0,1,20,0,0,1687,13800,15487
2016-01-04 21:00:00-05:00,0,1,21,0,0,1582,14778,16360
2016-01-04 22:00:00-05:00,0,1,22,0,0,1725,14906,16631
2016-01-04 23:00:00-05:00,0,1,23,0,0,2037,16916,18953
2016-01-05 00:00:00-05:00,0,1,0,1,0,2309,18000,20309
2016-01-05 01:00:00-05:00,0,1,1,1,0,2668,17000,19668
2016-01-05 02:00:00-05:00,0,1,2,1,0,3124,20224,23348
2016-01-05 03:00:00-05:00,0,1,3,1,0,3498,23229,26727
2016-01-05 04:00:00-05:00,0,1,4,1,0,3299,22147,25446
2016-01-05 05:00:00-05:00,0,1,5,1,0,2830,18838,21668
2016-01-05 06:00:00-05:00,0,1,6,1,0,2391,16737,19128
2016-01-05 07:00:00-05:00,0,1,7,1,0,2075,14778,16853
2016-01-05 08:00:00-05:00,0,1,8,1,0,1631,9733,11364
2016-01-05 09:00:00-05:00,0,1,9,1,0,1232,6779,8011
2016-01-05 10:00:00-05:00,0,1,10,1,0,778,4232,5010
2016-01-05 11:00:00-05:00,0,1,11,1,0,453,2458,2911
2016-01-05 12:00:00-05:00,0,1,12,1,0,259,1642,1901
2016-01-05 13:00:00-05:00,0,1,13,1,0,291,1710,2001
2016-01-05 14:00:00-05:00,0,1,14,1,0,302,3622,3924
2016-01-05 15:00:00-05:00,0,1,15,1,0,710,10158,10868
2016-01-05 16:00:00-05:00,0,1,16,1,0,1880,18543,20423
2016-01-05 17:00:00-05:00,0,1,17,1,0,2804,22385,25189
2016-01-05 18:00:00-05:00,0,1,18,1,0,2339,19837,22176
2016-01-05 19:00:00-05:00,0,1,19,1,0,1956,16759,18715
2016-01-05 20:00:00-05:00,0,1,20,1,0,1737,16513,18250
2016-01-05 21:00:00-05:00,0,1,21,1,0,1737,16673,18410
2016-01-05 22:00:00-05:00,0,1,22,1,0,1711,16248,17959
2016-01-05 23:00:00-05:00,0,1,23,1,0,2009,17975,19984
2016-01-06 00:00:00-05:00,0,1,0,2,0,2396,18705,21101
2016-01-06 01:00:00-05:00,0,1,1,2,0,2559,16477,19036
2016-01-06 02:00:00-05:00,0,1,2,2,0,2840,19647,22487
2016-01-06 03:00:00-05:00,0,1,3,2,0,3290,23358,26648
2016-01-06 04:00:00-05:00,0,1,4,2,0,3100,21829,24929
2016-01-06 05:00:00-05:00,0,1,5,2,0,2491,20647,23138
2016-01-06 06:00:00-05:00,0,1,6,2,0,2134,19593,21727
2016-01-06 07:00:00-05:00,0,1,7,2,0,1836,15932,17768
2016-01-06 08:00:00-05:00,0,1,8,2,0,1498,11529,13027
2016-01-06 09:00:00-05:00,0,1,9,2,0,1108,7185,8293
2016-01-06 10:00:00-05:00,0,1,10,2,0,735,4397,5132
2016-01-06 11:00:00-05:00,0,1,11,2,0,460,2740,3200
2016-01-06 12:00:00-05:00,0,1,12,2,0,356,1903,2259
2016-01-06 13:00:00-05:00,0,1,13,2,0,330,2006,2336
2016-01-06 14:00:00-05:00,0,1,14,2,0,306,3302,3608
2016-01-06 15:00:00-05:00,0,1,15,2,0,666,9561,10227
2016-01-06 16:00:00-05:00,0,1,16,2,0,1677,17779,19456
2016-01-06 17:00:00-05:00,0,1,17,2,0,2557,21130,23687
2016-01-06 18:00:00-05:00,0,1,18,2,0,2245,19661,21906
2016-01-06 19:00:00-05:00,0,1,19,2,0,1950,16624,18574
2016-01-06 20:00:00-05:00,0,1,20,2,0,1717,16279,17996
2016-01-06 21:00:00-05:00,0,1,21,2,0,1726,16901,18627
2016-01-06 22:00:00-05:00,0,1,22,2,0,1790,16622,18412
2016-01-06 23:00:00-05:00,0,1,23,2,0,1914,17907,19821
2016-01-07 00:00:00-05:00,0,1,0,3,0,2171,18067,20238
2016-01-07 01:00:00-05:00,0,1,1,3,0,2443,15807,18250
2016-01-07 02:00:00-05:00,0,1,2,3,0,2789,19412,22201
2016-01-07 03:00:00-05:00,0,1,3,3,0,3154,23640,26794
2016-01-07 04:00:00-05:00,0,1,4,3,0,2980,23302,26282
2016-01-07 05:00:00-05:00,0,1,5,3,0,2694,21800,24494
2016-01-07 06:00:00-05:00,0,1,6,3,0,2407,20928,23335
2016-01-07 07:00:00-05:00,0,1,7,3,0,2092,18821,20913
2016-01-07 08:00:00-05:00,0,1,8,3,0,1758,12742,14500
2016-01-07 09:00:00-05:00,0,1,9,3,0,1308,8286,9594
2016-01-07 10:00:00-05:00,0,1,10,3,0,901,5177,6078
2016-01-07 11:00:00-05:00,0,1,11,3,0,509,3280,3789
2016-01-07 12:00:00-05:00,0,1,12,3,0,342,2123,2465
2016-01-07 13:00:00-05:00,0,1,13,3,0,392,2060,2452
2016-01-07 14:00:00-05:00,0,1,14,3,0,330,3488,3818
2016-01-07 15:00:00-05:00,0,1,15,3,0,715,10087,10802
2016-01-07 16:00:00-05:00,0,1,16,3,0,1653,18072,19725
2016-01-07 17:00:00-05:00,0,1,17,3,0,2564,21081,23645
2016-01-07 18:00:00-05:00,0,1,18,3,0,2129,19409,21538
2016-01-07 19:00:00-05:00,0,1,19,3,0,1930,16624,18554
2016-01-07 20:00:00-05:00,0,1,20,3,0,1689,16299,17988
2016-01-07 21:00:00-05:00,0,1,21,3,0,1744,17052,18796
2016-01-07 22:00:00-05:00,0,1,22,3,0,1804,16878,18682
2016-01-07 23:00:00-05:00,0,1,23,3,0,1962,18738,20700
2016-01-08 00:00:00-05:00,0,1,0,4,0,2327,18473,20800
2016-01-08 01:00:00-05:00,0,1,1,4,0,2405,15862,18267
2016-01-08 02:00:00-05:00,0,1,2,4,0,2665,19309,21974
2016-01-08 03:00:00-05:00,0,1,3,4,0,3094,24107,27201
2016-01-08 04:00:00-05:00,0,1,4,4,0,3052,24565,27617
2016-01-08 05:00:00-05:00,0,1,5,4,0,2629,22632,25261
2016-01-08 06:00:00-05:00,0,1,6,4,0,2487,22787,25274
2016-01-08 07:00:00-05:00,0,1,7,4,0,2223,21342,23565
2016-01-08 08:00:00-05:00,0,1,8,4,0,1957,17163,19120
2016-01-08 09:00:00-05:00,0,1,9,4,0,1594,11397,12991
2016-01-08 10:00:00-05:00,0,1,10,4,0,1095,7559,8654
2016-01-08 11:00:00-05:00,0,1,11,4,0,712,4955,5667
2016-01-08 12:00:00-05:00,0,1,12,4,0,552,3268,3820
2016-01-08 13:00:00-05:00,0,1,13,4,0,454,2795,3249
2016-01-08 14:00:00-05:00,0,1,14,4,0,350,3679,4029
2016-01-08 15:00:00-05:00,0,1,15,4,0,661,9472,10133
2016-01-08 16:00:00-05:00,0,1,16,4,0,1758,17665,19423
2016-01-08 17:00:00-05:00,0,1,17,4,0,2506,20882,23388
2016-01-08 18:00:00-05:00,0,1,18,4,0,2477,19803,22280
2016-01-08 19:00:00-05:00,0,1,19,4,0,2062,17244,19306
2016-01-08 20:00:00-05:00,0,1,20,4,0,1830,17317,19147
2016-01-08 21:00:00-05:00,0,1,21,4,0,1734,17966,19700
2016-01-08 22:00:00-05:00,0,1,22,4,0,1809,17959,19768
2016-01-08 23:00:00-05:00,0,1,23,4,0,2224,19779,22003
2016-01-09 00:00:00-05:00,0,1,0,5,0,2555,19226,21781
2016-01-09 01:00:00-05:00,0,1,1,5,0,2730,16969,19699
2016-01-09 02:00:00-05:00,0,1,2,5,0,3152,20651,23803
2016-01-09 03:00:00-05:00,0,1,3,5,0,3621,25044,28665
2016-01-09 04:00:00-05:00,0,1,4,5,0,3619,26264,29883
2016-01-09 05:00:00-05:00,0,1,5,5,0,3393,23062,26455
2016-01-09 06:00:00-05:00,0,1,6,5,0,3339,22279,25618
2016-01-09 07:00:00-05:00,0,1,7,5,0,3329,23885,27214
2016-01-09 08:00:00-05:00,0,1,8,5,0,3431,22950,26381
2016-01-09 09:00:00-05:00,0,1,9,5,0,3314,21207,24521
2016-01-09 10:00:00-05:00,0,1,10,5,0,3077,18460,21537
2016-01-09 11:00:00-05:00,0,1,11,5,0,2438,14862,17300
2016-01-09 12:00:00-05:00,0,1,12,5,0,2013,10869,12882
2016-01-09 13:00:00-05:00,0,1,13,5,0,1546,6651,8197
2016-01-09 14:00:00-05:00,0,1,14,5,0,766,3191,3957
2016-01-09 15:00:00-05:00,0,1,15,5,0,588,4136,4724
2016-01-09 16:00:00-05:00,0,1,16,5,0,738,6477,7215
2016-01-09 17:00:00-05:00,0,1,17,5,0,1192,9282,10474
2016-01-09 18:00:00-05:00,0,1,18,5,0,1617,14043,15660
2016-01-09 19:00:00-05:00,0,1,19,5,0,1824,16625,18449
2016-01-09 20:00:00-05:00,0,1,20,5,0,2009,18863,20872
2016-01-09 21:00:00-05:00,0,1,21,5,0,2131,22641,24772
2016-01-09 22:00:00-05:00,0,1,22,5,0,2298,20855,23153
2016-01-09 23:00:00-05:00,0,1,23,5,0,2471,19791,22262
2016-01-10 00:00:00-05:00,0,1,0,6,0,2738,20854,23592
2016-01-10 01:00:00-05:00,0,1,1,6,0,2755,19750,22505
2016-01-10 02:00:00-05:00,0,1,2,6,0,2972,21420,24392
2016-01-10 03:00:00-05:00,0.02,1,3,6,0,3195,23729,26924
2016-01-10 04:00:00-05:00,0.17,1,4,6,0,3448,24437,27885
2016-01-10 05:00:00-05:00,0.24,1,5,6,0,3443,21147,24590
2016-01-10 06:00:00-05:00,0.2,1,6,6,0,3337,20023,23360
2016-01-10 07:00:00-05:00,0.3,1,7,6,0,3414,22837,26251
2016-01-10 08:00:00-05:00,0.27,1,8,6,0,3537,23675,27212
2016-01-10 09:00:00-05:00,0.01,1,9,6,0,3899,24816,28715
2016-01-10 10:00:00-05:00,0,1,10,6,0,3560,21287,24847
2016-01-10 11:00:00-05:00,0.01,1,11,6,0,2965,18182,21147
2016-01-10 12:00:00-05:00,0.02,1,12,6,0,2588,13562,16150
2016-01-10 13:00:00-05:00,0,1,13,6,0,1948,7895,9843
2016-01-10 14:00:00-05:00,0,1,14,6,0,1013,3309,4322
2016-01-10 15:00:00-05:00,0,1,15,6,0,576,3581,4157
2016-01-10 16:00:00-05:00,0.16,1,16,6,0,655,5267,5922
2016-01-10 17:00:00-05:00,0.02,1,17,6,0,861,8211,9072
2016-01-10 18:00:00-05:00,0,1,18,6,0,1219,11423,12642
2016-01-10 19:00:00-05:00,0,1,19,6,0,1772,16645,18417
2016-01-10 20:00:00-05:00,0,1,20,6,0,1953,18736,20689
2016-01-10 21:00:00-05:00,0,1,21,6,0,1990,19768,21758
2016-01-10 22:00:00-05:00,0,1,22,6,0,2113,18535,20648
2016-01-10 23:00:00-05:00,0,1,23,6,0,2087,18119,20206
2016-01-11 00:00:00-05:00,0,1,0,0,0,2761,20541,23302
2016-01-11 01:00:00-05:00,0,1,1,0,0,2745,18154,20899
2016-01-11 02:00:00-05:00,0,1,2,0,0,2541,18498,21039
2016-01-11 03:00:00-05:00,0,1,3,0,0,2480,19086,21566
2016-01-11 04:00:00-05:00,0,1,4,0,0,2308,16058,18366
2016-01-11 05:00:00-05:00,0,1,5,0,0,2299,14398,16697
2016-01-11 06:00:00-05:00,0,1,6,0,0,2076,13647,15723
2016-01-11 07:00:00-05:00,0,1,7,0,0,1866,12245,14111
2016-01-11 08:00:00-05:00,0,1,8,0,0,1602,9825,11427
2016-01-11 09:00:00-05:00,0,1,9,0,0,1162,6211,7373
2016-01-11 10:00:00-05:00,0,1,10,0,0,820,3860,4680
2016-01-11 11:00:00-05:00,0,1,11,0,0,500,2349,2849
2016-01-11 12:00:00-05:00,0,1,12,0,0,391,1606,1997
2016-01-11 13:00:00-05:00,0,1,13,0,0,446,2055,2501
2016-01-11 14:00:00-05:00,0,1,14,0,0,421,3710,4131
2016-01-11 15:00:00-05:00,0,1,15,0,0,746,10267,11013
2016-01-11 16:00:00-05:00,0,1,16,0,0,1842,17591,19433
2016-01-11 17:00:00-05:00,0,1,17,0,0,2618,20482,23100
2016-01-11 18:00:00-05:00,0,1,18,0,0,2297,18992,21289
2016-01-11 19:00:00-05:00,0,1,19,0,0,1825,16486,18311
2016-01-11 20:00:00-05:00,0,1,20,0,0,1736,15877,17613
2016-01-11 21:00:00-05:00,0,1,21,0,0,1721,16530,18251
2016-01-11 22:00:00-05:00,0,1,22,0,0,1711,16129,17840
2016-01-11 23:00:00-05:00,0,1,23,0,0,1966,17724,19690
2016-01-12 00:00:00-05:00,0,1,0,1,0,2197,18480,20677
2016-01-12 01:00:00-05:00,0,1,1,1,0,2380,17025,19405
2016-01-12 02:00:00-05:00,0,1,2,1,0,2725,20743,23468
2016-01-12 03:00:00-05:00,0,1,3,1,0,3077,24236,27313
2016-01-12 04:00:00-05:00,0,1,4,1,0,2959,23463,26422
2016-01-12 05:00:00-05:00,0,1,5,1,0,2534,21694,24228
2016-01-12 06:00:00-05:00,0,1,6,1,0,2191,19712,21903
2016-01-12 07:00:00-05:00,0,1,7,1,0,1871,16523,18394
2016-01-12 08:00:00-05:00,0,1,8,1,0,1467,10906,12373
2016-01-12 09:00:00-05:00,0,1,9,1,0,1126,8440,9566
2016-01-12 10:00:00-05:00,0,1,10,1,0,759,4428,5187
2016-01-12 11:00:00-05:00,0,1,11,1,0,447,2720,3167
2016-01-12 12:00:00-05:00,0,1,12,1,0,286,1871,2157
2016-01-12 13:00:00-05:00,0,1,13,1,0,315,1991,2306
2016-01-12 14:00:00-05:00,0,1,14,1,0,305,3474,3779
2016-01-12 15:00:00-05:00,0,1,15,1,0,643,9786,10429
2016-01-12 16:00:00-05:00,0,1,16,1,0,1617,18577,20194
2016-01-12 17:00:00-05:00,0,1,17,1,0,2410,22328,24738
2016-01-12 18:00:00-05:00,0,1,18,1,0,2260,20624,22884
2016-01-12 19:00:00-05:00,0,1,19,1,0,1942,18020,19962
2016-01-12 20:00:00-05:00,0,1,20,1,0,1782,18782,20564
2016-01-12 21:00:00-05:00,0,1,21,1,0,1697,17329,19026
2016-01-12 22:00:00-05:00,0,1,22,1,0,1700,17094,18794
2016-01-12 23:00:00-05:00,0,1,23,1,0,1945,18547,20492
2016-01-13 00:00:00-05:00,0,1,0,2,0,2228,18853,21081
2016-01-13 01:00:00-05:00,0,1,1,2,0,2490,16697,19187
2016-01-13 02:00:00-05:00,0,1,2,2,0,2683,19703,22386
2016-01-13 03:00:00-05:00,0,1,3,2,0,2897,24108,27005
2016-01-13 04:00:00-05:00,0,1,4,2,0,2756,23161,25917
2016-01-13 05:00:00-05:00,0,1,5,2,0,2514,22819,25333
2016-01-13 06:00:00-05:00,0,1,6,2,0,2483,23203,25686
2016-01-13 07:00:00-05:00,0,1,7,2,0,2100,20954,23054
2016-01-13 08:00:00-05:00,0,1,8,2,0,1739,13881,15620
2016-01-13 09:00:00-05:00,0,1,9,2,0,1197,8730,9927
2016-01-13 10:00:00-05:00,0,1,10,2,0,779,4994,5773
2016-01-13 11:00:00-05:00,0,1,11,2,0,523,3064,3587
2016-01-13 12:00:00-05:00,0,1,12,2,0,349,2115,2464
2016-01-13 13:00:00-05:00,0,1,13,2,0,328,2218,2546
2016-01-13 14:00:00-05:00,0,1,14,2,0,341,3709,4050
2016-01-13 15:00:00-05:00,0,1,15,2,0,726,10710,11436
2016-01-13 16:00:00-05:00,0,1,16,2,0,1804,19703,21507
2016-01-13 17:00:00-05:00,0,1,17,2,0,2718,23579,26297
2016-01-13 18:00:00-05:00,0,1,18,2,0,2484,21021,23505
2016-01-13 19:00:00-05:00,0,1,19,2,0,2152,18537,20689
2016-01-13 20:00:00-05:00,0,1,20,2,0,1886,18425,20311
2016-01-13 21:00:00-05:00,0,1,21,2,0,1839,19164,21003
2016-01-13 22:00:00-05:00,0,1,22,2,0,1908,18564,20472
2016-01-13 23:00:00-05:00,0,1,23,2,0,2105,20224,22329
2016-01-14 00:00:00-05:00,0,1,0,3,0,2377,19864,22241
2016-01-14 01:00:00-05:00,0,1,1,3,0,2601,17219,19820
2016-01-14 02:00:00-05:00,0,1,2,3,0,3059,21481,24540
2016-01-14 03:00:00-05:00,0,1,3,3,0,3360,26295,29655
2016-01-14 04:00:00-05:00,0,1,4,3,0,3433,26557,29990
2016-01-14 05:00:00-05:00,0,1,5,3,0,2924,25790,28714
2016-01-14 06:00:00-05:00,0,1,6,3,0,2736,25123,27859
2016-01-14 07:00:00-05:00,0,1,7,3,0,2321,22154,24475
2016-01-14 08:00:00-05:00,0,1,8,3,0,1889,15850,17739
2016-01-14 09:00:00-05:00,0,1,9,3,0,1362,9911,11273
2016-01-14 10:00:00-05:00,0,1,10,3,0,925,5745,6670
2016-01-14 11:00:00-05:00,0,1,11,3,0,562,3632,4194
2016-01-14 12:00:00-05:00,0,1,12,3,0,389,2513,2902
2016-01-14 13:00:00-05:00,0,1,13,3,0,380,2287,2667
2016-01-14 14:00:00-05:00,0,1,14,3,0,357,3867,4224
2016-01-14 15:00:00-05:00,0,1,15,3,0,728,10563,11291
2016-01-14 16:00:00-05:00,0,1,16,3,0,1887,19478,21365
2016-01-14 17:00:00-05:00,0,1,17,3,0,2812,23033,25845
2016-01-14 18:00:00-05:00,0,1,18,3,0,2363,20803,23166
2016-01-14 19:00:00-05:00,0,1,19,3,0,2077,18019,20096
2016-01-14 20:00:00-05:00,0,1,20,3,0,1940,18056,19996
2016-01-14 21:00:00-05:00,0,1,21,3,0,1923,19549,21472
2016-01-14 22:00:00-05:00,0,1,22,3,0,1889,18647,20536
2016-01-14 23:00:00-05:00,0,1,23,3,0,2056,20880,22936
2016-01-15 00:00:00-05:00,0,1,0,4,0,2308,20248,22556
2016-01-15 01:00:00-05:00,0,1,1,4,0,2521,16899,19420
2016-01-15 02:00:00-05:00,0,1,2,4,0,2942,20250,23192
2016-01-15 03:00:00-05:00,0,1,3,4,0,3257,24855,28112
2016-01-15 04:00:00-05:00,0,1,4,4,0,3216,25604,28820
2016-01-15 05:00:00-05:00,0,1,5,4,0,2768,24928,27696
2016-01-15 06:00:00-05:00,0,1,6,4,0,2673,25015,27688
2016-01-15 07:00:00-05:00,0,1,7,4,0,2351,22984,25335
2016-01-15 08:00:00-05:00,0,1,8,4,0,2160,18707,20867
2016-01-15 09:00:00-05:00,0,1,9,4,0,1684,13262,14946
2016-01-15 10:00:00-05:00,0,1,10,4,0,1185,8393,9578
2016-01-15 11:00:00-05:00,0,1,11,4,0,771,5552,6323
2016-01-15 12:00:00-05:00,0,1,12,4,0,543,3822,4365
2016-01-15 13:00:00-05:00,0,1,13,4,0,519,3335,3854
2016-01-15 14:00:00-05:00,0,1,14,4,0,433,4100,4533
2016-01-15 15:00:00-05:00,0,1,15,4,0,747,9989,10736
2016-01-15 16:00:00-05:00,0,1,16,4,0,1797,18419,20216
2016-01-15 17:00:00-05:00,0,1,17,4,0,2603,21816,24419
2016-01-15 18:00:00-05:00,0,1,18,4,0,2428,20103,22531
2016-01-15 19:00:00-05:00,0,1,19,4,0,2031,17322,19353
2016-01-15 20:00:00-05:00,0,1,20,4,0,1840,17294,19134
2016-01-15 21:00:00-05:00,0.01,1,21,4,0,1721,18355,20076
2016-01-15 22:00:00-05:00,0,1,22,4,0,1787,18046,19833
2016-01-15 23:00:00-05:00,0,1,23,4,0,2197,20471,22668
2016-01-16 00:00:00-05:00,0,1,0,5,0,2566,19534,22100
2016-01-16 01:00:00-05:00,0.03,1,1,5,0,2820,17079,19899
2016-01-16 02:00:00-05:00,0.11,1,2,5,0,3265,20635,23900
2016-01-16 03:00:00-05:00,0.02,1,3,5,0,3746,25422,29168
2016-01-16 04:00:00-05:00,0.05,1,4,5,0,3686,25914,29600
2016-01-16 05:00:00-05:00,0.01,1,5,5,0,3528,23177,26705
2016-01-16 06:00:00-05:00,0.01,1,6,5,0,3711,22982,26693
2016-01-16 07:00:00-05:00,0.02,1,7,5,0,3461,23007,26468
2016-01-16 08:00:00-05:00,0,1,8,5,0,3650,23260,26910
2016-01-16 09:00:00-05:00,0,1,9,5,0,3699,21300,24999
2016-01-16 10:00:00-05:00,0,1,10,5,0,3356,19986,23342
2016-01-16 11:00:00-05:00,0,1,11,5,0,2852,15845,18697
2016-01-16 12:00:00-05:00,0,1,12,5,0,2209,10932,13141
2016-01-16 13:00:00-05:00,0,1,13,5,0,1619,7052,8671
2016-01-16 14:00:00-05:00,0,1,14,5,0,725,3611,4336
2016-01-16 15:00:00-05:00,0,1,15,5,0,571,4339,4910
2016-01-16 16:00:00-05:00,0,1,16,5,0,821,6395,7216
2016-01-16 17:00:00-05:00,0,1,17,5,0,1152,9381,10533
2016-01-16 18:00:00-05:00,0,1,18,5,0,1564,13444,15008
2016-01-16 19:00:00-05:00,0,1,19,5,0,1747,16214,17961
2016-01-16 20:00:00-05:00,0,1,20,5,0,1969,18352,20321
2016-01-16 21:00:00-05:00,0,1,21,5,0,2074,19868,21942
2016-01-16 22:00:00-05:00,0,1,22,5,0,2302,20475,22777
2016-01-16 23:00:00-05:00,0,1,23,5,0,2385,19751,22136
2016-01-17 00:00:00-05:00,0,1,0,6,0,2664,21192,23856
2016-01-17 01:00:00-05:00,0,1,1,6,0,3004,21143,24147
2016-01-17 02:00:00-05:00,0,1,2,6,0,3217,23005,26222
2016-01-17 03:00:00-05:00,0,1,3,6,0,3369,24449,27818
2016-01-17 04:00:00-05:00,0,1,4,6,0,3648,24751,28399
2016-01-17 05:00:00-05:00,0,1,5,6,0,3563,21665,25228
2016-01-17 06:00:00-05:00,0,1,6,6,0,3546,21173,24719
2016-01-17 07:00:00-05:00,0,1,7,6,0,3652,23180,26832
2016-01-17 08:00:00-05:00,0,1,8,6,0,3918,24396,28314
2016-01-17 09:00:00-05:00,0,1,9,6,0,4047,23510,27557
2016-01-17 10:00:00-05:00,0,1,10,6,0,3690,21035,24725
2016-01-17 11:00:00-05:00,0,1,11,6,0,3208,18030,21238
2016-01-17 12:00:00-05:00,0,1,12,6,0,2606,13652,16258
2016-01-17 13:00:00-05:00,0,1,13,6,0,2017,8462,10479
2016-01-17 14:00:00-05:00,0,1,14,6,0,930,3596,4526
2016-01-17 15:00:00-05:00,0,1,15,6,0,605,3615,4220
2016-01-17 16:00:00-05:00,0.01,1,16,6,0,659,5012,5671
2016-01-17 17:00:00-05:00,0.03,1,17,6,0,840,7782,8622
2016-01-17 18:00:00-05:00,0.01,1,18,6,0,1247,11237,12484
2016-01-17 19:00:00-05:00,0,1,19,6,0,1648,15803,17451
2016-01-17 20:00:00-05:00,0,1,20,6,0,1893,18519,20412
2016-01-17 21:00:00-05:00,0,1,21,6,0,2035,21463,23498
2016-01-17 22:00:00-05:00,0,1,22,6,0,2312,21647,23959
2016-01-17 23:00:00-05:00,0,1,23,6,0,2488,21013,23501
2016-01-18 00:00:00-05:00,0,1,0,0,1,2643,20935,23578
2016-01-18 01:00:00-05:00,0,1,1,0,1,2955,20852,23807
2016-01-18 02:00:00-05:00,0,1,2,0,1,2754,20342,23096
2016-01-18 03:00:00-05:00,0,1,3,0,1,2809,20976,23785
2016-01-18 04:00:00-05:00,0,1,4,0,1,2615,18866,21481
2016-01-18 05:00:00-05:00,0,1,5,0,1,2495,17101,19596
2016-01-18 06:00:00-05:00,0,1,6,0,1,2183,16189,18372
2016-01-18 07:00:00-05:00,0,1,7,0,1,2137,16083,18220
2016-01-18 08:00:00-05:00,0,1,8,0,1,1987,13436,15423
2016-01-18 09:00:00-05:00,0,1,9,0,1,1651,10601,12252
2016-01-18 10:00:00-05:00,0,1,10,0,1,1283,7261,8544
2016-01-18 11:00:00-05:00,0,1,11,0,1,959,5063,6022
2016-01-18 12:00:00-05:00,0,1,12,0,1,786,3576,4362
2016-01-18 13:00:00-05:00,0,1,13,0,1,700,2923,3623
2016-01-18 14:00:00-05:00,0,1,14,0,1,470,2782,3252
2016-01-18 15:00:00-05:00,0,1,15,0,1,515,5319,5834
2016-01-18 16:00:00-05:00,0,1,16,0,1,797,8356,9153
2016-01-18 17:00:00-05:00,0,1,17,0,1,1223,13052,14275
2016-01-18 18:00:00-05:00,0,1,18,0,1,1476,15228,16704
2016-01-18 19:00:00-05:00,0,1,19,0,1,1462,16266,17728
2016-01-18 20:00:00-05:00,0,1,20,0,1,1628,17923,19551
2016-01-18 21:00:00-05:00,0,1,21,0,1,1745,20059,21804
2016-01-18 22:00:00-05:00,0,1,22,0,1,1869,19821,21690
2016-01-18 23:00:00-05:00,0,1,23,0,1,1936,20880,22816
2016-01-19 00:00:00-05:00,0,1,0,1,0,2277,21376,23653
2016-01-19 01:00:00-05:00,0,1,1,1,0,2428,20100,22528
2016-01-19 02:00:00-05:00,0,1,2,1,0,2498,22146,24644
2016-01-19 03:00:00-05:00,0,1,3,1,0,2786,24311,27097
2016-01-19 04:00:00-05:00,0,1,4,1,0,2738,22036,24774
2016-01-19 05:00:00-05:00,0,1,5,1,0,2311,18836,21147
2016-01-19 06:00:00-05:00,0,1,6,1,0,2099,17157,19256
2016-01-19 07:00:00-05:00,0,1,7,1,0,1824,15697,17521
2016-01-19 08:00:00-05:00,0,1,8,1,0,1452,10712,12164
2016-01-19 09:00:00-05:00,0,1,9,1,0,1027,7671,8698
2016-01-19 10:00:00-05:00,0,1,10,1,0,670,4207,4877
2016-01-19 11:00:00-05:00,0,1,11,1,0,432,2359,2791
2016-01-19 12:00:00-05:00,0,1,12,1,0,300,1616,1916
2016-01-19 13:00:00-05:00,0,1,13,1,0,347,1916,2263
2016-01-19 14:00:00-05:00,0,1,14,1,0,353,3971,4324
2016-01-19 15:00:00-05:00,0,1,15,1,0,760,11232,11992
2016-01-19 16:00:00-05:00,0,1,16,1,0,1932,20710,22642
2016-01-19 17:00:00-05:00,0,1,17,1,0,2811,23994,26805
2016-01-19 18:00:00-05:00,0,1,18,1,0,2618,21701,24319
2016-01-19 19:00:00-05:00,0,1,19,1,0,2118,19739,21857
2016-01-19 20:00:00-05:00,0,1,20,1,0,1934,18992,20926
2016-01-19 21:00:00-05:00,0,1,21,1,0,1780,19070,20850
2016-01-19 22:00:00-05:00,0,1,22,1,0,1841,19080,20921
2016-01-19 23:00:00-05:00,0,1,23,1,0,2100,20208,22308
2016-01-20 00:00:00-05:00,0,1,0,2,0,2339,20190,22529
2016-01-20 01:00:00-05:00,0,1,1,2,0,2608,17860,20468
2016-01-20 02:00:00-05:00,0,1,2,2,0,2907,20718,23625
2016-01-20 03:00:00-05:00,0,1,3,2,0,3289,25278,28567
2016-01-20 04:00:00-05:00,0,1,4,2,0,3138,24995,28133
2016-01-20 05:00:00-05:00,0,1,5,2,0,2717,23922,26639
2016-01-20 06:00:00-05:00,0,1,6,2,0,2320,23108,25428
2016-01-20 07:00:00-05:00,0,1,7,2,0,2006,19612,21618
2016-01-20 08:00:00-05:00,0,1,8,2,0,1616,13038,14654
2016-01-20 09:00:00-05:00,0,1,9,2,0,1173,8723,9896
2016-01-20 10:00:00-05:00,0,1,10,2,0,804,4956,5760
2016-01-20 11:00:00-05:00,0,1,11,2,0,444,2935,3379
2016-01-20 12:00:00-05:00,0,1,12,2,0,327,2197,2524
2016-01-20 13:00:00-05:00,0,1,13,2,0,324,2144,2468
2016-01-20 14:00:00-05:00,0,1,14,2,0,321,3942,4263
2016-01-20 15:00:00-05:00,0,1,15,2,0,709,10524,11233
2016-01-20 16:00:00-05:00,0,1,16,2,0,1743,19351,21094
2016-01-20 17:00:00-05:00,0,1,17,2,0,2631,22692,25323
2016-01-20 18:00:00-05:00,0,1,18,2,0,2413,20656,23069
2016-01-20 19:00:00-05:00,0,1,19,2,0,1965,18131,20096
2016-01-20 20:00:00-05:00,0,1,20,2,0,1797,18216,20013
2016-01-20 21:00:00-05:00,0,1,21,2,0,1775,18347,20122
2016-01-20 22:00:00-05:00,0,1,22,2,0,1880,17851,19731
2016-01-20 23:00:00-05:00,0,1,23,2,0,2060,19501,21561
2016-01-21 01:00:00-05:00,0,1,1,3,0,2218,19123,21341
2016-01-21 02:00:00-05:00,0,1,2,3,0,2503,16526,19029
2016-01-21 03:00:00-05:00,0,1,3,3,0,2883,20001,22884
2016-01-21 04:00:00-05:00,0,1,4,3,0,3120,24876,27996
2016-01-21 05:00:00-05:00,0,1,5,3,0,3105,25199,28304
2016-01-21 06:00:00-05:00,0,1,6,3,0,2736,24062,26798
2016-01-21 07:00:00-05:00,0,1,7,3,0,2592,24202,26794
2016-01-21 08:00:00-05:00,0,1,8,3,0,2254,22376,24630
2016-01-21 09:00:00-05:00,0,1,9,3,0,1957,15574,17531
2016-01-21 10:00:00-05:00,0,1,10,3,0,1356,9397,10753
2016-01-21 11:00:00-05:00,0,1,11,3,0,921,5694,6615
2016-01-21 12:00:00-05:00,0,1,12,3,0,563,3599,4162
2016-01-21 13:00:00-05:00,0,1,13,3,0,424,2420,2844
2016-01-21 14:00:00-05:00,0,1,14,3,0,421,2388,2809
2016-01-21 15:00:00-05:00,0,1,15,3,0,400,3841,4241
2016-01-21 16:00:00-05:00,0,1,16,3,0,747,10652,11399
2016-01-21 17:00:00-05:00,0,1,17,3,0,1820,19496,21316
2016-01-21 18:00:00-05:00,0,1,18,3,0,2663,22488,25151
2016-01-21 19:00:00-05:00,0,1,19,3,0,2424,20825,23249
2016-01-21 20:00:00-05:00,0,1,20,3,0,1976,18312,20288
2016-01-21 21:00:00-05:00,0,1,21,3,0,1903,18153,20056
2016-01-21 22:00:00-05:00,0,1,22,3,0,1841,18987,20828
2016-01-21 23:00:00-05:00,0,1,23,3,0,1873,18668,20541
2016-01-22 00:00:00-05:00,0,1,0,4,0,2161,20244,22405
2016-01-22 01:00:00-05:00,0,1,1,4,0,2436,19484,21920
2016-01-22 02:00:00-05:00,0,1,2,4,0,2771,16866,19637
2016-01-22 03:00:00-05:00,0,1,3,4,0,3183,20599,23782
2016-01-22 04:00:00-05:00,0,1,4,4,0,3570,25839,29409
2016-01-22 05:00:00-05:00,0,1,5,4,0,3618,26854,30472
2016-01-22 06:00:00-05:00,0,1,6,4,0,3378,25712,29090
2016-01-22 07:00:00-05:00,0,1,7,4,0,3045,25707,28752
2016-01-22 08:00:00-05:00,0,1,8,4,0,2722,24124,26846
2016-01-22 09:00:00-05:00,0,1,9,4,0,2390,19305,21695
2016-01-22 10:00:00-05:00,0,1,10,4,0,1897,14318,16215
2016-01-22 11:00:00-05:00,0,1,11,4,0,1334,8828,10162
2016-01-22 12:00:00-05:00,0,1,12,4,0,831,5624,6455
2016-01-22 13:00:00-05:00,0,1,13,4,0,625,3818,4443
2016-01-22 14:00:00-05:00,0,1,14,4,0,519,3324,3843
2016-01-22 15:00:00-05:00,0,1,15,4,0,391,4267,4658
2016-01-22 16:00:00-05:00,0,1,16,4,0,784,10266,11050
2016-01-22 17:00:00-05:00,0,1,17,4,0,1877,19211,21088
2016-01-22 18:00:00-05:00,0,1,18,4,0,2695,22932,25627
2016-01-22 19:00:00-05:00,0,1,19,4,0,2516,20798,23314
2016-01-22 20:00:00-05:00,0,1,20,4,0,2151,18443,20594
2016-01-22 21:00:00-05:00,0,1,21,4,0,1982,18602,20584
2016-01-22 22:00:00-05:00,0,1,22,4,0,1831,19564,21395
2016-01-22 23:00:00-05:00,0,1,23,4,0,1929,20063,21992
2016-01-23 00:00:00-05:00,0.02,1,0,5,0,2435,21547,23982
2016-01-23 01:00:00-05:00,0.02,1,1,5,0,2817,20647,23464
2016-01-23 02:00:00-05:00,0.01,1,2,5,0,3275,17949,21224
2016-01-23 03:00:00-05:00,0,1,3,5,0,3725,21981,25706
2016-01-23 04:00:00-05:00,0.01,1,4,5,0,4319,26909,31228
2016-01-23 05:00:00-05:00,0.03,1,5,5,0,4426,27989,32415
2016-01-23 06:00:00-05:00,0.07,1,6,5,0,4069,23953,28022
2016-01-23 07:00:00-05:00,0.04,1,7,5,0,3806,23043,26849
2016-01-23 08:00:00-05:00,0.03,1,8,5,0,3755,23926,27681
2016-01-23 09:00:00-05:00,0.07,1,9,5,0,3563,22160,25723
2016-01-23 10:00:00-05:00,0.05,1,10,5,0,2987,18986,21973
2016-01-23 11:00:00-05:00,0.04,1,11,5,0,2203,13927,16130
2016-01-23 12:00:00-05:00,0.07,1,12,5,0,1643,10390,12033
2016-01-23 13:00:00-05:00,0.06,1,13,5,0,1313,7878,9191
2016-01-23 14:00:00-05:00,0.07,1,14,5,0,822,4250,5072
2016-01-23 15:00:00-05:00,0.07,1,15,5,0,324,1588,1912
2016-01-23 16:00:00-05:00,0.05,1,16,5,0,222,1555,1777
2016-01-23 17:00:00-05:00,0.05,1,17,5,0,153,1789,1942
2016-01-23 18:00:00-05:00,0.05,1,18,5,0,130,1991,2121
2016-01-23 19:00:00-05:00,0.05,1,19,5,0,125,2307,2432
2016-01-23 20:00:00-05:00,0.05,1,20,5,0,186,2664,2850
2016-01-23 21:00:00-05:00,0.05,1,21,5,0,205,3043,3248
2016-01-23 22:00:00-05:00,0,1,22,5,0,210,2993,3203
2016-01-23 23:00:00-05:00,0,1,23,5,0,182,2548,2730
2016-01-24 00:00:00-05:00,0,1,0,6,0,118,1285,1403
2016-01-24 01:00:00-05:00,0,1,1,6,0,62,586,648
2016-01-24 02:00:00-05:00,0,1,2,6,0,53,183,236
2016-01-24 03:00:00-05:00,0,1,3,6,0,27,65,92
2016-01-24 04:00:00-05:00,0,1,4,6,0,22,43,65
2016-01-24 05:00:00-05:00,0,1,5,6,0,14,16,30
2016-01-24 06:00:00-05:00,0,1,6,6,0,11,8,19
2016-01-24 07:00:00-05:00,0,1,7,6,0,5,10,15
2016-01-24 08:00:00-05:00,0,1,8,6,0,9,11,20
2016-01-24 09:00:00-05:00,0,1,9,6,0,5,17,22
2016-01-24 10:00:00-05:00,0,1,10,6,0,4,18,22
2016-01-24 11:00:00-05:00,0,1,11,6,0,2,9,11
2016-01-24 12:00:00-05:00,0,1,12,6,0,3,13,16
2016-01-24 13:00:00-05:00,0,1,13,6,0,0,13,13
2016-01-24 14:00:00-05:00,0,1,14,6,0,1,19,20
2016-01-24 15:00:00-05:00,0,1,15,6,0,5,32,37
2016-01-24 16:00:00-05:00,0,1,16,6,0,12,124,136
2016-01-24 17:00:00-05:00,0,1,17,6,0,83,660,743
2016-01-24 18:00:00-05:00,0,1,18,6,0,196,1424,1620
2016-01-24 19:00:00-05:00,0,1,19,6,0,423,2754,3177
2016-01-24 20:00:00-05:00,0,1,20,6,0,667,4996,5663
2016-01-24 21:00:00-05:00,0,1,21,6,0,833,7461,8294
2016-01-24 22:00:00-05:00,0,1,22,6,0,1069,9372,10441
2016-01-24 23:00:00-05:00,0,1,23,6,0,1251,10196,11447
2016-01-25 00:00:00-05:00,0,1,0,0,0,1574,12027,13601
2016-01-25 01:00:00-05:00,0,1,1,0,0,1816,12797,14613
2016-01-25 02:00:00-05:00,0,1,2,0,0,1891,12492,14383
2016-01-25 03:00:00-05:00,0,1,3,0,0,1926,13114,15040
2016-01-25 04:00:00-05:00,0,1,4,0,0,2125,15027,17152
2016-01-25 05:00:00-05:00,0,1,5,0,0,1971,14029,16000
2016-01-25 06:00:00-05:00,0,1,6,0,0,1837,12237,14074
2016-01-25 07:00:00-05:00,0,1,7,0,0,1622,12070,13692
2016-01-25 08:00:00-05:00,0,1,8,0,0,1506,11040,12546
2016-01-25 09:00:00-05:00,0,1,9,0,0,1193,7842,9035
2016-01-25 10:00:00-05:00,0,1,10,0,0,935,5804,6739
2016-01-25 11:00:00-05:00,0,1,11,0,0,628,3470,4098
2016-01-25 12:00:00-05:00,0,1,12,0,0,395,2471,2866
2016-01-25 13:00:00-05:00,0,1,13,0,0,338,1789,2127
2016-01-25 14:00:00-05:00,0,1,14,0,0,297,2260,2557
2016-01-25 15:00:00-05:00,0,1,15,0,0,382,3772,4154
2016-01-25 16:00:00-05:00,0,1,16,0,0,682,8223,8905
2016-01-25 17:00:00-05:00,0,1,17,0,0,1591,12974,14565
2016-01-25 18:00:00-05:00,0,1,18,0,0,2360,14424,16784
2016-01-25 19:00:00-05:00,0,1,19,0,0,2256,13884,16140
2016-01-25 20:00:00-05:00,0,1,20,0,0,2044,12911,14955
2016-01-25 21:00:00-05:00,0,1,21,0,0,1969,12718,14687
2016-01-25 22:00:00-05:00,0,1,22,0,0,1980,12918,14898
2016-01-25 23:00:00-05:00,0,1,23,0,0,1884,12869,14753
2016-01-26 00:00:00-05:00,0,1,0,1,0,2214,14200,16414
2016-01-26 01:00:00-05:00,0,1,1,1,0,2529,14808,17337
2016-01-26 02:00:00-05:00,0,1,2,1,0,2621,13531,16152
2016-01-26 03:00:00-05:00,0,1,3,1,0,2944,16455,19399
2016-01-26 04:00:00-05:00,0,1,4,1,0,3280,19632,22912
2016-01-26 05:00:00-05:00,0,1,5,1,0,3125,19732,22857
2016-01-26 06:00:00-05:00,0,1,6,1,0,2624,18679,21303
2016-01-26 07:00:00-05:00,0,1,7,1,0,2345,17638,19983
2016-01-26 08:00:00-05:00,0,1,8,1,0,1934,15670,17604
2016-01-26 09:00:00-05:00,0,1,9,1,0,1587,11255,12842
2016-01-26 10:00:00-05:00,0,1,10,1,0,1073,7704,8777
2016-01-26 11:00:00-05:00,0,1,11,1,0,664,4436,5100
2016-01-26 12:00:00-05:00,0,1,12,1,0,408,2650,3058
2016-01-26 13:00:00-05:00,0,1,13,1,0,264,1833,2097
2016-01-26 14:00:00-05:00,0,1,14,1,0,312,2029,2341
2016-01-26 15:00:00-05:00,0,1,15,1,0,372,4036,4408
2016-01-26 16:00:00-05:00,0,1,16,1,0,722,10048,10770
2016-01-26 17:00:00-05:00,0,1,17,1,0,1696,16734,18430
2016-01-26 18:00:00-05:00,0,1,18,1,0,2528,18808,21336
2016-01-26 19:00:00-05:00,0,1,19,1,0,2421,17113,19534
2016-01-26 20:00:00-05:00,0,1,20,1,0,2044,15118,17162
2016-01-26 21:00:00-05:00,0,1,21,1,0,1900,14471,16371
2016-01-26 22:00:00-05:00,0,1,22,1,0,1881,14859,16740
2016-01-26 23:00:00-05:00,0,1,23,1,0,1843,14776,16619
2016-01-27 00:00:00-05:00,0,1,0,2,0,2061,15898,17959
2016-01-27 01:00:00-05:00,0,1,1,2,0,2317,16153,18470
2016-01-27 02:00:00-05:00,0,1,2,2,0,2632,13663,16295
2016-01-27 03:00:00-05:00,0,1,3,2,0,3059,17154,20213
2016-01-27 04:00:00-05:00,0.01,1,4,2,0,3427,21398,24825
2016-01-27 05:00:00-05:00,0,1,5,2,0,3413,21498,24911
2016-01-27 06:00:00-05:00,0,1,6,2,0,2898,21191,24089
2016-01-27 07:00:00-05:00,0,1,7,2,0,2489,21392,23881
2016-01-27 08:00:00-05:00,0,1,8,2,0,2166,20242,22408
2016-01-27 09:00:00-05:00,0,1,9,2,0,1731,14451,16182
2016-01-27 10:00:00-05:00,0,1,10,2,0,1347,8847,10194
2016-01-27 11:00:00-05:00,0,1,11,2,0,769,5073,5842
2016-01-27 12:00:00-05:00,0,1,12,2,0,494,3300,3794
2016-01-27 13:00:00-05:00,0,1,13,2,0,341,2214,2555
2016-01-27 14:00:00-05:00,0,1,14,2,0,349,2267,2616
2016-01-27 15:00:00-05:00,0,1,15,2,0,331,3715,4046
2016-01-27 16:00:00-05:00,0,1,16,2,0,701,10360,11061
2016-01-27 17:00:00-05:00,0,1,17,2,0,1784,17961,19745
2016-01-27 18:00:00-05:00,0,1,18,2,0,2615,20409,23024
2016-01-27 19:00:00-05:00,0,1,19,2,0,2453,18662,21115
2016-01-27 20:00:00-05:00,0,1,20,2,0,1982,16145,18127
2016-01-27 21:00:00-05:00,0,1,21,2,0,1835,15455,17290
2016-01-27 22:00:00-05:00,0,1,22,2,0,1766,16123,17889
2016-01-27 23:00:00-05:00,0,1,23,2,0,1800,16144,17944
2016-01-28 00:00:00-05:00,0,1,0,3,0,2097,17040,19137
2016-01-28 01:00:00-05:00,0,1,1,3,0,2348,17146,19494
2016-01-28 02:00:00-05:00,0,1,2,3,0,2619,14592,17211
2016-01-28 03:00:00-05:00,0,1,3,3,0,3084,18709,21793
2016-01-28 04:00:00-05:00,0,1,4,3,0,3510,23485,26995
2016-01-28 05:00:00-05:00,0,1,5,3,0,3334,24228,27562
2016-01-28 06:00:00-05:00,0,1,6,3,0,3036,23615,26651
2016-01-28 07:00:00-05:00,0,1,7,3,0,2700,23541,26241
2016-01-28 08:00:00-05:00,0,1,8,3,0,2355,21969,24324
2016-01-28 09:00:00-05:00,0,1,9,3,0,2142,18180,20322
2016-01-28 10:00:00-05:00,0,1,10,3,0,1597,10679,12276
2016-01-28 11:00:00-05:00,0,1,11,3,0,1049,6207,7256
2016-01-28 12:00:00-05:00,0,1,12,3,0,598,3955,4553
2016-01-28 13:00:00-05:00,0,1,13,3,0,436,2580,3016
2016-01-28 14:00:00-05:00,0,1,14,3,0,440,2503,2943
2016-01-28 15:00:00-05:00,0,1,15,3,0,392,3964,4356
2016-01-28 16:00:00-05:00,0,1,16,3,0,748,10829,11577
2016-01-28 17:00:00-05:00,0,1,17,3,0,1772,18535,20307
2016-01-28 18:00:00-05:00,0,1,18,3,0,2596,21051,23647
2016-01-28 19:00:00-05:00,0,1,19,3,0,2403,19347,21750
2016-01-28 20:00:00-05:00,0,1,20,3,0,2037,17172,19209
2016-01-28 21:00:00-05:00,0,1,21,3,0,1795,16752,18547
2016-01-28 22:00:00-05:00,0,1,22,3,0,1764,17148,18912
2016-01-28 23:00:00-05:00,0,1,23,3,0,1861,16677,18538
2016-01-29 00:00:00-05:00,0,1,0,4,0,2077,18647,20724
2016-01-29 01:00:00-05:00,0,1,1,4,0,2420,18147,20567
2016-01-29 02:00:00-05:00,0,1,2,4,0,2763,15243,18006
2016-01-29 03:00:00-05:00,0,1,3,4,0,3108,19206,22314
2016-01-29 04:00:00-05:00,0,1,4,4,0,3562,24310,27872
2016-01-29 05:00:00-05:00,0,1,5,4,0,3435,25318,28753
2016-01-29 06:00:00-05:00,0,1,6,4,0,3083,24975,28058
2016-01-29 07:00:00-05:00,0,1,7,4,0,2806,25353,28159
2016-01-29 08:00:00-05:00,0,1,8,4,0,2543,24270,26813
2016-01-29 09:00:00-05:00,0,1,9,4,0,2234,20458,22692
2016-01-29 10:00:00-05:00,0,1,10,4,0,1651,14189,15840
2016-01-29 11:00:00-05:00,0,1,11,4,0,1185,8956,10141
2016-01-29 12:00:00-05:00,0,1,12,4,0,835,5987,6822
2016-01-29 13:00:00-05:00,0,1,13,4,0,552,3883,4435
2016-01-29 14:00:00-05:00,0,1,14,4,0,509,3484,3993
2016-01-29 15:00:00-05:00,0,1,15,4,0,461,3923,4384
2016-01-29 16:00:00-05:00,0,1,16,4,0,729,10256,10985
2016-01-29 17:00:00-05:00,0,1,17,4,0,1824,18442,20266
2016-01-29 18:00:00-05:00,0,1,18,4,0,2619,21619,24238
2016-01-29 19:00:00-05:00,0,1,19,4,0,2504,19482,21986
2016-01-29 20:00:00-05:00,0,1,20,4,0,2147,17107,19254
2016-01-29 21:00:00-05:00,0,1,21,4,0,1939,16999,18938
2016-01-29 22:00:00-05:00,0,1,22,4,0,1937,18438,20375
2016-01-29 23:00:00-05:00,0,1,23,4,0,1970,18713,20683
2016-01-30 00:00:00-05:00,0,1,0,5,0,2339,20271,22610
2016-01-30 01:00:00-05:00,0,1,1,5,0,2648,18773,21421
2016-01-30 02:00:00-05:00,0,1,2,5,0,3161,16649,19810
2016-01-30 03:00:00-05:00,0,1,3,5,0,3496,21195,24691
2016-01-30 04:00:00-05:00,0,1,4,5,0,4306,26002,30308
2016-01-30 05:00:00-05:00,0,1,5,5,0,4368,27612,31980
2016-01-30 06:00:00-05:00,0,1,6,5,0,4177,25665,29842
2016-01-30 07:00:00-05:00,0,1,7,5,0,4022,25185,29207
2016-01-30 08:00:00-05:00,0,1,8,5,0,3883,26070,29953
2016-01-30 09:00:00-05:00,0,1,9,5,0,4108,25139,29247
2016-01-30 10:00:00-05:00,0,1,10,5,0,3837,23410,27247
2016-01-30 11:00:00-05:00,0,1,11,5,0,3246,19874,23120
2016-01-30 12:00:00-05:00,0,1,12,5,0,2681,16697,19378
2016-01-30 13:00:00-05:00,0,1,13,5,0,2199,12403,14602
2016-01-30 14:00:00-05:00,0,1,14,5,0,1619,7787,9406
2016-01-30 15:00:00-05:00,0,1,15,5,0,843,3756,4599
2016-01-30 16:00:00-05:00,0,1,16,5,0,624,4343,4967
2016-01-30 17:00:00-05:00,0,1,17,5,0,851,6559,7410
2016-01-30 18:00:00-05:00,0,1,18,5,0,1329,10682,12011
2016-01-30 19:00:00-05:00,0,1,19,5,0,1766,14886,16652
2016-01-30 20:00:00-05:00,0,1,20,5,0,2076,17970,20046
2016-01-30 21:00:00-05:00,0,1,21,5,0,2210,19995,22205
2016-01-30 22:00:00-05:00,0,1,22,5,0,2272,21626,23898
2016-01-30 23:00:00-05:00,0,1,23,5,0,2491,21758,24249
2016-01-31 00:00:00-05:00,0,1,0,6,0,2607,20867,23474
2016-01-31 01:00:00-05:00,0,1,1,6,0,2913,21328,24241
2016-01-31 02:00:00-05:00,0,1,2,6,0,3227,19704,22931
2016-01-31 03:00:00-05:00,0,1,3,6,0,3485,22312,25797
2016-01-31 04:00:00-05:00,0,1,4,6,0,4101,26385,30486
2016-01-31 05:00:00-05:00,0,1,5,6,0,4227,26854,31081
2016-01-31 06:00:00-05:00,0,1,6,6,0,4095,22721,26816
2016-01-31 07:00:00-05:00,0,1,7,6,0,4040,22815,26855
2016-01-31 08:00:00-05:00,0,1,8,6,0,4169,25033,29202
2016-01-31 09:00:00-05:00,0,1,9,6,0,4507,25604,30111
2016-01-31 10:00:00-05:00,0,1,10,6,0,4201,24079,28280
2016-01-31 11:00:00-05:00,0,1,11,6,0,3726,21285,25011
2016-01-31 12:00:00-05:00,0,1,12,6,0,3248,18674,21922
2016-01-31 13:00:00-05:00,0,1,13,6,0,2658,14598,17256
2016-01-31 14:00:00-05:00,0,1,14,6,0,2085,9175,11260
2016-01-31 15:00:00-05:00,0,1,15,6,0,998,3993,4991
2016-01-31 16:00:00-05:00,0,1,16,6,0,638,3822,4460
2016-01-31 17:00:00-05:00,0,1,17,6,0,675,5109,5784
2016-01-31 18:00:00-05:00,0,1,18,6,0,892,8117,9009
2016-01-31 19:00:00-05:00,0,1,19,6,0,1366,11958,13324
2016-01-31 20:00:00-05:00,0,1,20,6,0,1680,16318,17998
2016-01-31 21:00:00-05:00,0,1,21,6,0,1988,18565,20553
2016-01-31 22:00:00-05:00,0,1,22,6,0,2013,19577,21590
2016-01-31 23:00:00-05:00,0,1,23,6,0,2204,19429,21633
2016-02-01 00:00:00-05:00,0,2,0,0,0,2356,19809,22165
2016-02-01 01:00:00-05:00,0,2,1,0,0,2510,18663,21173
2016-02-01 02:00:00-05:00,0,2,2,0,0,2640,18648,21288
2016-02-01 03:00:00-05:00,0,2,3,0,0,2679,19883,22562
2016-02-01 04:00:00-05:00,0,2,4,0,0,2809,20899,23708
2016-02-01 05:00:00-05:00,0,2,5,0,0,2652,17659,20311
2016-02-01 06:00:00-05:00,0,2,6,0,0,2453,14886,17339
2016-02-01 07:00:00-05:00,0,2,7,0,0,2081,14190,16271
2016-02-01 08:00:00-05:00,0,2,8,0,0,1997,12911,14908
2016-02-01 09:00:00-05:00,0,2,9,0,0,1739,9258,10997
2016-02-01 10:00:00-05:00,0,2,10,0,0,1290,6317,7607
2016-02-01 11:00:00-05:00,0,2,11,0,0,819,3804,4623
2016-02-01 12:00:00-05:00,0,2,12,0,0,583,2411,2994
2016-02-01 13:00:00-05:00,0,2,13,0,0,431,1671,2102
2016-02-01 14:00:00-05:00,0,2,14,0,0,463,2185,2648
2016-02-01 15:00:00-05:00,0,2,15,0,0,460,4164,4624
2016-02-01 16:00:00-05:00,0,2,16,0,0,776,10385,11161
2016-02-01 17:00:00-05:00,0,2,17,0,0,1883,17272,19155
2016-02-01 18:00:00-05:00,0,2,18,0,0,2648,20399,23047
2016-02-01 19:00:00-05:00,0,2,19,0,0,2454,18535,20989
2016-02-01 20:00:00-05:00,0,2,20,0,0,1898,15444,17342
2016-02-01 21:00:00-05:00,0,2,21,0,0,1773,15106,16879
2016-02-01 22:00:00-05:00,0,2,22,0,0,1726,15665,17391
2016-02-01 23:00:00-05:00,0,2,23,0,0,1918,16598,18516
2016-02-02 00:00:00-05:00,0,2,0,1,0,2215,18347,20562
2016-02-02 01:00:00-05:00,0,2,1,1,0,2377,20232,22609
2016-02-02 02:00:00-05:00,0,2,2,1,0,2685,18076,20761
2016-02-02 03:00:00-05:00,0,2,3,1,0,2780,20887,23667
2016-02-02 04:00:00-05:00,0,2,4,1,0,2976,24027,27003
2016-02-02 05:00:00-05:00,0,2,5,1,0,2790,22395,25185
2016-02-02 06:00:00-05:00,0,2,6,1,0,2358,20694,23052
2016-02-02 07:00:00-05:00,0,2,7,1,0,2012,19759,21771
2016-02-02 08:00:00-05:00,0,2,8,1,0,1730,16456,18186
2016-02-02 09:00:00-05:00,0,2,9,1,0,1411,10494,11905
2016-02-02 10:00:00-05:00,0,2,10,1,0,1116,6898,8014
2016-02-02 11:00:00-05:00,0,2,11,1,0,738,3985,4723
2016-02-02 12:00:00-05:00,0,2,12,1,0,463,2482,2945
2016-02-02 13:00:00-05:00,0,2,13,1,0,334,1666,2000
2016-02-02 14:00:00-05:00,0,2,14,1,0,341,2011,2352
2016-02-02 15:00:00-05:00,0,2,15,1,0,353,3830,4183
2016-02-02 16:00:00-05:00,0,2,16,1,0,685,10114,10799
2016-02-02 17:00:00-05:00,0,2,17,1,0,1673,18549,20222
2016-02-02 18:00:00-05:00,0,2,18,1,0,2501,21695,24196
2016-02-02 19:00:00-05:00,0,2,19,1,0,2270,19561,21831
2016-02-02 20:00:00-05:00,0,2,20,1,0,1904,17275,19179
2016-02-02 21:00:00-05:00,0,2,21,1,0,1823,16515,18338
2016-02-02 22:00:00-05:00,0,2,22,1,0,1704,17100,18804
2016-02-02 23:00:00-05:00,0,2,23,1,0,1769,16974,18743
2016-02-03 00:00:00-05:00,0,2,0,2,0,2014,18197,20211
2016-02-03 01:00:00-05:00,0,2,1,2,0,2178,18467,20645
2016-02-03 02:00:00-05:00,0,2,2,2,0,2424,16368,18792
2016-02-03 03:00:00-05:00,0,2,3,2,0,2812,19920,22732
2016-02-03 04:00:00-05:00,0,2,4,2,0,3127,24458,27585
2016-02-03 05:00:00-05:00,0,2,5,2,0,3033,23941,26974
2016-02-03 06:00:00-05:00,0,2,6,2,0,2690,23857,26547
2016-02-03 07:00:00-05:00,0,2,7,2,0,2467,23785,26252
2016-02-03 08:00:00-05:00,0,2,8,2,0,2170,21344,23514
2016-02-03 09:00:00-05:00,0,2,9,2,0,1856,14170,16026
2016-02-03 10:00:00-05:00,0,2,10,2,0,1320,8936,10256
2016-02-03 11:00:00-05:00,0,2,11,2,0,871,5000,5871
2016-02-03 12:00:00-05:00,0.03,2,12,2,0,497,3236,3733
2016-02-03 13:00:00-05:00,0.09,2,13,2,0,325,2156,2481
2016-02-03 14:00:00-05:00,0.12,2,14,2,0,328,2179,2507
2016-02-03 15:00:00-05:00,0.16,2,15,2,0,354,3785,4139
2016-02-03 16:00:00-05:00,0.2,2,16,2,0,694,10317,11011
2016-02-03 17:00:00-05:00,0.07,2,17,2,0,1917,19911,21828
2016-02-03 18:00:00-05:00,0.01,2,18,2,0,2718,22855,25573
2016-02-03 19:00:00-05:00,0.01,2,19,2,0,2478,20537,23015
2016-02-03 20:00:00-05:00,0,2,20,2,0,1998,17260,19258
2016-02-03 21:00:00-05:00,0,2,21,2,0,1878,17153,19031
2016-02-03 22:00:00-05:00,0,2,22,2,0,2034,19459,21493
2016-02-03 23:00:00-05:00,0,2,23,2,0,2298,20263,22561
2016-02-04 00:00:00-05:00,0,2,0,3,0,2687,20906,23593
2016-02-04 01:00:00-05:00,0,2,1,3,0,2908,19554,22462
2016-02-04 02:00:00-05:00,0,2,2,3,0,3070,15519,18589
2016-02-04 03:00:00-05:00,0,2,3,3,0,3064,18504,21568
2016-02-04 04:00:00-05:00,0,2,4,3,0,3242,22329,25571
2016-02-04 05:00:00-05:00,0,2,5,3,0,3064,23566,26630
2016-02-04 06:00:00-05:00,0,2,6,3,0,2581,22317,24898
2016-02-04 07:00:00-05:00,0,2,7,3,0,2210,21885,24095
2016-02-04 08:00:00-05:00,0,2,8,3,0,1919,19245,21164
2016-02-04 09:00:00-05:00,0,2,9,3,0,1660,15149,16809
2016-02-04 10:00:00-05:00,0,2,10,3,0,1210,9769,10979
2016-02-04 11:00:00-05:00,0,2,11,3,0,837,5506,6343
2016-02-04 12:00:00-05:00,0,2,12,3,0,496,3333,3829
2016-02-04 13:00:00-05:00,0,2,13,3,0,346,2257,2603
2016-02-04 14:00:00-05:00,0,2,14,3,0,352,2376,2728
2016-02-04 15:00:00-05:00,0,2,15,3,0,338,3921,4259
2016-02-04 16:00:00-05:00,0,2,16,3,0,700,10588,11288
2016-02-04 17:00:00-05:00,0,2,17,3,0,1900,19170,21070
2016-02-04 18:00:00-05:00,0,2,18,3,0,2617,22704,25321
2016-02-04 19:00:00-05:00,0,2,19,3,0,2647,20756,23403
2016-02-04 20:00:00-05:00,0,2,20,3,0,2081,17634,19715
2016-02-04 21:00:00-05:00,0,2,21,3,0,1950,17037,18987
2016-02-04 22:00:00-05:00,0.01,2,22,3,0,1911,17918,19829
2016-02-04 23:00:00-05:00,0,2,23,3,0,1983,18168,20151
2016-02-05 00:00:00-05:00,0,2,0,4,0,2249,19989,22238
2016-02-05 01:00:00-05:00,0.01,2,1,4,0,2470,19294,21764
2016-02-05 02:00:00-05:00,0.03,2,2,4,0,2673,16155,18828
2016-02-05 03:00:00-05:00,0.05,2,3,4,0,3114,20382,23496
2016-02-05 04:00:00-05:00,0.06,2,4,4,0,3409,25084,28493
2016-02-05 05:00:00-05:00,0.11,2,5,4,0,3388,26278,29666
2016-02-05 06:00:00-05:00,0.04,2,6,4,0,3220,26208,29428
2016-02-05 07:00:00-05:00,0.03,2,7,4,0,2863,25898,28761
2016-02-05 08:00:00-05:00,0.01,2,8,4,0,2897,24216,27113
2016-02-05 09:00:00-05:00,0.01,2,9,4,0,2412,20058,22470
2016-02-05 10:00:00-05:00,0,2,10,4,0,1941,14111,16052
2016-02-05 11:00:00-05:00,0,2,11,4,0,1329,8630,9959
2016-02-05 12:00:00-05:00,0,2,12,4,0,853,5744,6597
2016-02-05 13:00:00-05:00,0,2,13,4,0,590,4011,4601
2016-02-05 14:00:00-05:00,0,2,14,4,0,536,3344,3880
2016-02-05 15:00:00-05:00,0,2,15,4,0,424,4346,4770
2016-02-05 16:00:00-05:00,0,2,16,4,0,810,11326,12136
2016-02-05 17:00:00-05:00,0,2,17,4,0,1746,18498,20244
2016-02-05 18:00:00-05:00,0,2,18,4,0,2635,21535,24170
2016-02-05 19:00:00-05:00,0,2,19,4,0,2477,19445,21922
2016-02-05 20:00:00-05:00,0,2,20,4,0,2105,16853,18958
2016-02-05 21:00:00-05:00,0,2,21,4,0,1943,16071,18014
2016-02-05 22:00:00-05:00,0,2,22,4,0,1750,16625,18375
2016-02-05 23:00:00-05:00,0,2,23,4,0,1693,16815,18508
2016-02-06 00:00:00-05:00,0,2,0,5,0,2186,18377,20563
2016-02-06 01:00:00-05:00,0,2,1,5,0,2505,19205,21710
2016-02-06 02:00:00-05:00,0,2,2,5,0,2970,18063,21033
2016-02-06 03:00:00-05:00,0,2,3,5,0,3492,22505,25997
2016-02-06 04:00:00-05:00,0,2,4,5,0,4115,26987,31102
2016-02-06 05:00:00-05:00,0,2,5,5,0,4225,27975,32200
2016-02-06 06:00:00-05:00,0,2,6,5,0,3761,25047,28808
2016-02-06 07:00:00-05:00,0,2,7,5,0,3783,23960,27743
2016-02-06 08:00:00-05:00,0,2,8,5,0,3825,25179,29004
2016-02-06 09:00:00-05:00,0,2,9,5,0,3827,24801,28628
2016-02-06 10:00:00-05:00,0,2,10,5,0,3611,22571,26182
2016-02-06 11:00:00-05:00,0,2,11,5,0,3183,18981,22164
2016-02-06 12:00:00-05:00,0,2,12,5,0,2598,15927,18525
2016-02-06 13:00:00-05:00,0,2,13,5,0,2133,11144,13277
2016-02-06 14:00:00-05:00,0,2,14,5,0,1490,7265,8755
2016-02-06 15:00:00-05:00,0,2,15,5,0,684,3571,4255
2016-02-06 16:00:00-05:00,0,2,16,5,0,612,4458,5070
2016-02-06 17:00:00-05:00,0,2,17,5,0,806,6197,7003
2016-02-06 18:00:00-05:00,0,2,18,5,0,1296,10203,11499
2016-02-06 19:00:00-05:00,0,2,19,5,0,1745,14550,16295
2016-02-06 20:00:00-05:00,0,2,20,5,0,2001,17155,19156
2016-02-06 21:00:00-05:00,0,2,21,5,0,2311,19490,21801
2016-02-06 22:00:00-05:00,0,2,22,5,0,2509,21799,24308
2016-02-06 23:00:00-05:00,0,2,23,5,0,2740,21606,24346
2016-02-07 00:00:00-05:00,0,2,0,6,0,2676,21102,23778
2016-02-07 01:00:00-05:00,0,2,1,6,0,2831,21246,24077
2016-02-07 02:00:00-05:00,0,2,2,6,0,3253,20463,23716
2016-02-07 03:00:00-05:00,0,2,3,6,0,3422,22925,26347
2016-02-07 04:00:00-05:00,0,2,4,6,0,3909,26219,30128
2016-02-07 05:00:00-05:00,0,2,5,6,0,4257,27561,31818
2016-02-07 06:00:00-05:00,0,2,6,6,0,4017,22319,26336
2016-02-07 07:00:00-05:00,0,2,7,6,0,4015,21472,25487
2016-02-07 08:00:00-05:00,0,2,8,6,0,4099,23951,28050
2016-02-07 09:00:00-05:00,0,2,9,6,0,4442,26310,30752
2016-02-07 10:00:00-05:00,0,2,10,6,0,4036,24033,28069
2016-02-07 11:00:00-05:00,0,2,11,6,0,3558,21246,24804
2016-02-07 12:00:00-05:00,0,2,12,6,0,3231,18263,21494
2016-02-07 13:00:00-05:00,0,2,13,6,0,2600,13574,16174
2016-02-07 14:00:00-05:00,0,2,14,6,0,1859,8041,9900
2016-02-07 15:00:00-05:00,0,2,15,6,0,824,3425,4249
2016-02-07 16:00:00-05:00,0,2,16,6,0,593,3477,4070
2016-02-07 17:00:00-05:00,0,2,17,6,0,639,4411,5050
2016-02-07 18:00:00-05:00,0,2,18,6,0,881,7223,8104
2016-02-07 19:00:00-05:00,0,2,19,6,0,1326,11100,12426
2016-02-07 20:00:00-05:00,0,2,20,6,0,1724,15334,17058
2016-02-07 21:00:00-05:00,0,2,21,6,0,1960,17428,19388
2016-02-07 22:00:00-05:00,0,2,22,6,0,1985,18962,20947
2016-02-07 23:00:00-05:00,0,2,23,6,0,2278,19136,21414
2016-02-08 00:00:00-05:00,0,2,0,0,0,2395,18913,21308
2016-02-08 01:00:00-05:00,0,2,1,0,0,2529,19452,21981
2016-02-08 02:00:00-05:00,0,2,2,0,0,3015,20310,23325
2016-02-08 03:00:00-05:00,0,2,3,0,0,3548,24531,28079
2016-02-08 04:00:00-05:00,0,2,4,0,0,3771,23549,27320
2016-02-08 05:00:00-05:00,0,2,5,0,0,2589,13934,16523
2016-02-08 06:00:00-05:00,0,2,6,0,0,2246,13337,15583
2016-02-08 07:00:00-05:00,0,2,7,0,0,2461,15393,17854
2016-02-08 08:00:00-05:00,0,2,8,0,0,3283,21843,25126
2016-02-08 09:00:00-05:00,0,2,9,0,0,2938,16286,19224
2016-02-08 10:00:00-05:00,0.04,2,10,0,0,1893,7886,9779
2016-02-08 11:00:00-05:00,0.01,2,11,0,0,1142,4457,5599
2016-02-08 12:00:00-05:00,0.01,2,12,0,0,745,2774,3519
2016-02-08 13:00:00-05:00,0,2,13,0,0,494,2028,2522
2016-02-08 14:00:00-05:00,0,2,14,0,0,556,2451,3007
2016-02-08 15:00:00-05:00,0,2,15,0,0,424,3958,4382
2016-02-08 16:00:00-05:00,0,2,16,0,0,729,10149,10878
2016-02-08 17:00:00-05:00,0,2,17,0,0,1457,16950,18407
2016-02-08 18:00:00-05:00,0,2,18,0,0,2370,20575,22945
2016-02-08 19:00:00-05:00,0,2,19,0,0,2486,19317,21803
2016-02-08 20:00:00-05:00,0,2,20,0,0,2044,16598,18642
2016-02-08 21:00:00-05:00,0,2,21,0,0,1865,16456,18321
2016-02-08 22:00:00-05:00,0,2,22,0,0,1700,15950,17650
2016-02-08 23:00:00-05:00,0,2,23,0,0,1752,15893,17645
2016-02-09 00:00:00-05:00,0,2,0,1,0,1894,17440,19334
2016-02-09 01:00:00-05:00,0,2,1,1,0,2138,18021,20159
2016-02-09 02:00:00-05:00,0,2,2,1,0,2272,16446,18718
2016-02-09 03:00:00-05:00,0,2,3,1,0,2638,20027,22665
2016-02-09 04:00:00-05:00,0,2,4,1,0,3029,24139,27168
2016-02-09 05:00:00-05:00,0,2,5,1,0,2813,22305,25118
2016-02-09 06:00:00-05:00,0,2,6,1,0,2326,20484,22810
2016-02-09 07:00:00-05:00,0,2,7,1,0,1964,20269,22233
2016-02-09 08:00:00-05:00,0,2,8,1,0,1741,16777,18518
2016-02-09 09:00:00-05:00,0,2,9,1,0,1503,11716,13219
2016-02-09 10:00:00-05:00,0,2,10,1,0,974,7007,7981
2016-02-09 11:00:00-05:00,0,2,11,1,0,584,3994,4578
2016-02-09 12:00:00-05:00,0,2,12,1,0,413,2442,2855
2016-02-09 13:00:00-05:00,0,2,13,1,0,267,1694,1961
2016-02-09 14:00:00-05:00,0,2,14,1,0,283,1805,2088
2016-02-09 15:00:00-05:00,0,2,15,1,0,336,3619,3955
2016-02-09 16:00:00-05:00,0,2,16,1,0,717,10465,11182
2016-02-09 17:00:00-05:00,0,2,17,1,0,1750,18790,20540
2016-02-09 18:00:00-05:00,0,2,18,1,0,2651,22479,25130
2016-02-09 19:00:00-05:00,0,2,19,1,0,2378,20325,22703
2016-02-09 20:00:00-05:00,0,2,20,1,0,1947,17343,19290
2016-02-09 21:00:00-05:00,0,2,21,1,0,1788,16579,18367
2016-02-09 22:00:00-05:00,0,2,22,1,0,1683,17314,18997
2016-02-09 23:00:00-05:00,0,2,23,1,0,1722,17380,19102
2016-02-10 00:00:00-05:00,0,2,0,2,0,1997,18543,20540
2016-02-10 01:00:00-05:00,0,2,1,2,0,2172,18761,20933
2016-02-10 02:00:00-05:00,0,2,2,2,0,2381,16922,19303
2016-02-10 03:00:00-05:00,0.01,2,3,2,0,2848,20301,23149
2016-02-10 04:00:00-05:00,0,2,4,2,0,3188,24904,28092
2016-02-10 05:00:00-05:00,0,2,5,2,0,3038,24846,27884
2016-02-10 06:00:00-05:00,0,2,6,2,0,2589,23550,26139
2016-02-10 07:00:00-05:00,0,2,7,2,0,2358,23291,25649
2016-02-10 08:00:00-05:00,0,2,8,2,0,1907,21232,23139
2016-02-10 09:00:00-05:00,0,2,9,2,0,1658,14406,16064
2016-02-10 10:00:00-05:00,0,2,10,2,0,1153,8915,10068
2016-02-10 11:00:00-05:00,0,2,11,2,0,706,5049,5755
2016-02-10 12:00:00-05:00,0,2,12,2,0,468,3141,3609
2016-02-10 13:00:00-05:00,0,2,13,2,0,303,2148,2451
2016-02-10 14:00:00-05:00,0,2,14,2,0,315,2194,2509
2016-02-10 15:00:00-05:00,0,2,15,2,0,337,3804,4141
2016-02-10 16:00:00-05:00,0,2,16,2,0,684,10619,11303
2016-02-10 17:00:00-05:00,0,2,17,2,0,1850,19901,21751
2016-02-10 18:00:00-05:00,0,2,18,2,0,2701,23160,25861
2016-02-10 19:00:00-05:00,0,2,19,2,0,2467,20780,23247
2016-02-10 20:00:00-05:00,0,2,20,2,0,2004,18100,20104
2016-02-10 21:00:00-05:00,0,2,21,2,0,1891,17489,19380
2016-02-10 22:00:00-05:00,0,2,22,2,0,1896,18401,20297
2016-02-10 23:00:00-05:00,0,2,23,2,0,2094,18185,20279
2016-02-11 00:00:00-05:00,0,2,0,3,0,2327,19861,22188
2016-02-11 01:00:00-05:00,0,2,1,3,0,2395,19486,21881
2016-02-11 02:00:00-05:00,0,2,2,3,0,2801,17209,20010
2016-02-11 03:00:00-05:00,0,2,3,3,0,3247,21860,25107
2016-02-11 04:00:00-05:00,0,2,4,3,0,3660,26378,30038
2016-02-11 05:00:00-05:00,0,2,5,3,0,3508,26962,30470
2016-02-11 06:00:00-05:00,0,2,6,3,0,3258,25727,28985
2016-02-11 07:00:00-05:00,0,2,7,3,0,2827,25231,28058
2016-02-11 08:00:00-05:00,0,2,8,3,0,2438,22654,25092
2016-02-11 09:00:00-05:00,0,2,9,3,0,1985,16146,18131
2016-02-11 10:00:00-05:00,0,2,10,3,0,1465,10101,11566
2016-02-11 11:00:00-05:00,0,2,11,3,0,1054,5862,6916
2016-02-11 12:00:00-05:00,0,2,12,3,0,606,3661,4267
2016-02-11 13:00:00-05:00,0,2,13,3,0,380,2403,2783
2016-02-11 14:00:00-05:00,0,2,14,3,0,355,2465,2820
2016-02-11 15:00:00-05:00,0,2,15,3,0,372,4280,4652
2016-02-11 16:00:00-05:00,0,2,16,3,0,755,11180,11935
2016-02-11 17:00:00-05:00,0,2,17,3,0,1919,20678,22597
2016-02-11 18:00:00-05:00,0,2,18,3,0,2806,24080,26886
2016-02-11 19:00:00-05:00,0,2,19,3,0,2695,22207,24902
2016-02-11 20:00:00-05:00,0,2,20,3,0,2289,19491,21780
2016-02-11 21:00:00-05:00,0,2,21,3,0,2104,19715,21819
2016-02-11 22:00:00-05:00,0,2,22,3,0,2116,21117,23233
2016-02-11 23:00:00-05:00,0,2,23,3,0,2346,20702,23048
2016-02-12 00:00:00-05:00,0,2,0,4,0,2686,22707,25393
2016-02-12 01:00:00-05:00,0,2,1,4,0,2962,21494,24456
2016-02-12 02:00:00-05:00,0,2,2,4,0,3324,18198,21522
2016-02-12 03:00:00-05:00,0,2,3,4,0,3837,22503,26340
2016-02-12 04:00:00-05:00,0,2,4,4,0,4473,27495,31968
2016-02-12 05:00:00-05:00,0,2,5,4,0,4377,28616,32993
2016-02-12 06:00:00-05:00,0,2,6,4,0,3970,27972,31942
2016-02-12 07:00:00-05:00,0,2,7,4,0,3551,27508,31059
2016-02-12 08:00:00-05:00,0,2,8,4,0,2997,25590,28587
2016-02-12 09:00:00-05:00,0,2,9,4,0,2661,21181,23842
2016-02-12 10:00:00-05:00,0,2,10,4,0,1894,14719,16613
2016-02-12 11:00:00-05:00,0,2,11,4,0,1247,9095,10342
2016-02-12 12:00:00-05:00,0,2,12,4,0,771,5600,6371
2016-02-12 13:00:00-05:00,0,2,13,4,0,555,3870,4425
2016-02-12 14:00:00-05:00,0,2,14,4,0,488,3455,3943
2016-02-12 15:00:00-05:00,0,2,15,4,0,422,4545,4967
2016-02-12 16:00:00-05:00,0,2,16,4,0,879,11060,11939
2016-02-12 17:00:00-05:00,0,2,17,4,0,2053,19838,21891
2016-02-12 18:00:00-05:00,0,2,18,4,0,3016,23570,26586
2016-02-12 19:00:00-05:00,0,2,19,4,0,2673,21374,24047
2016-02-12 20:00:00-05:00,0,2,20,4,0,2311,19145,21456
2016-02-12 21:00:00-05:00,0,2,21,4,0,2175,19701,21876
2016-02-12 22:00:00-05:00,0,2,22,4,0,2024,20795,22819
2016-02-12 23:00:00-05:00,0,2,23,4,0,2106,21053,23159
2016-02-13 00:00:00-05:00,0,2,0,5,0,2716,22721,25437
2016-02-13 01:00:00-05:00,0,2,1,5,0,3009,20753,23762
2016-02-13 02:00:00-05:00,0,2,2,5,0,3517,17639,21156
2016-02-13 03:00:00-05:00,0,2,3,5,0,4040,21577,25617
2016-02-13 04:00:00-05:00,0,2,4,5,0,4564,26458,31022
2016-02-13 05:00:00-05:00,0,2,5,5,0,4725,27796,32521
2016-02-13 06:00:00-05:00,0,2,6,5,0,4432,25365,29797
2016-02-13 07:00:00-05:00,0,2,7,5,0,4048,25063,29111
2016-02-13 08:00:00-05:00,0,2,8,5,0,3870,24693,28563
2016-02-13 09:00:00-05:00,0,2,9,5,0,3828,24465,28293
2016-02-13 10:00:00-05:00,0,2,10,5,0,3736,21088,24824
2016-02-13 11:00:00-05:00,0,2,11,5,0,3164,18193,21357
2016-02-13 12:00:00-05:00,0,2,12,5,0,2686,14746,17432
2016-02-13 13:00:00-05:00,0,2,13,5,0,2076,11010,13086
2016-02-13 14:00:00-05:00,0,2,14,5,0,1517,6978,8495
2016-02-13 15:00:00-05:00,0,2,15,5,0,774,3469,4243
2016-02-13 16:00:00-05:00,0,2,16,5,0,619,4582,5201
2016-02-13 17:00:00-05:00,0,2,17,5,0,813,6754,7567
2016-02-13 18:00:00-05:00,0,2,18,5,0,1269,10575,11844
2016-02-13 19:00:00-05:00,0,2,19,5,0,1958,14844,16802
2016-02-13 20:00:00-05:00,0,2,20,5,0,2139,18570,20709
2016-02-13 21:00:00-05:00,0,2,21,5,0,2502,22062,24564
2016-02-13 22:00:00-05:00,0,2,22,5,0,2714,24806,27520
2016-02-13 23:00:00-05:00,0,2,23,5,0,2926,25728,28654
2016-02-14 00:00:00-05:00,0,2,0,6,0,3155,24087,27242
2016-02-14 01:00:00-05:00,0,2,1,6,0,3384,24332,27716
2016-02-14 02:00:00-05:00,0,2,2,6,0,3957,22923,26880
2016-02-14 03:00:00-05:00,0,2,3,6,0,4199,24603,28802
2016-02-14 04:00:00-05:00,0,2,4,6,0,4824,28127,32951
2016-02-14 05:00:00-05:00,0,2,5,6,0,5124,28583,33707
2016-02-14 06:00:00-05:00,0,2,6,6,0,4721,23474,28195
2016-02-14 07:00:00-05:00,0,2,7,6,0,4295,21738,26033
2016-02-14 08:00:00-05:00,0,2,8,6,0,3947,23543,27490
2016-02-14 09:00:00-05:00,0,2,9,6,0,4153,23796,27949
2016-02-14 10:00:00-05:00,0,2,10,6,0,3511,19792,23303
2016-02-14 11:00:00-05:00,0,2,11,6,0,2738,16441,19179
2016-02-14 12:00:00-05:00,0,2,12,6,0,2216,13506,15722
2016-02-14 13:00:00-05:00,0,2,13,6,0,1752,10008,11760
2016-02-14 14:00:00-05:00,0,2,14,6,0,1348,6389,7737
2016-02-14 15:00:00-05:00,0,2,15,6,0,646,2973,3619
2016-02-14 16:00:00-05:00,0,2,16,6,0,601,3615,4216
2016-02-14 17:00:00-05:00,0,2,17,6,0,675,5176,5851
2016-02-14 18:00:00-05:00,0,2,18,6,0,954,8896,9850
2016-02-14 19:00:00-05:00,0,2,19,6,0,1365,12646,14011
2016-02-14 20:00:00-05:00,0,2,20,6,0,1837,17406,19243
2016-02-14 21:00:00-05:00,0,2,21,6,0,2267,21011,23278
2016-02-14 22:00:00-05:00,0,2,22,6,0,2447,23243,25690
2016-02-14 23:00:00-05:00,0,2,23,6,0,2694,23319,26013
2016-02-15 00:00:00-05:00,0,2,0,0,1,2793,22998,25791
2016-02-15 01:00:00-05:00,0,2,1,0,1,2946,22242,25188
2016-02-15 02:00:00-05:00,0,2,2,0,1,3273,22230,25503
2016-02-15 03:00:00-05:00,0,2,3,0,1,3480,23342,26822
2016-02-15 04:00:00-05:00,0,2,4,0,1,3861,25619,29480
2016-02-15 05:00:00-05:00,0,2,5,0,1,3934,24093,28027
2016-02-15 06:00:00-05:00,0,2,6,0,1,3562,20831,24393
2016-02-15 07:00:00-05:00,0,2,7,0,1,3140,20352,23492
2016-02-15 08:00:00-05:00,0,2,8,0,1,3015,19547,22562
2016-02-15 09:00:00-05:00,0,2,9,0,1,2847,16773,19620
2016-02-15 10:00:00-05:00,0,2,10,0,1,2294,13065,15359
2016-02-15 11:00:00-05:00,0,2,11,0,1,1667,8772,10439
2016-02-15 12:00:00-05:00,0,2,12,0,1,1181,5967,7148
2016-02-15 13:00:00-05:00,0,2,13,0,1,927,3995,4922
2016-02-15 14:00:00-05:00,0.01,2,14,0,1,791,3333,4124
2016-02-15 15:00:00-05:00,0.02,2,15,0,1,601,3240,3841
2016-02-15 16:00:00-05:00,0.02,2,16,0,1,713,5928,6641
2016-02-15 17:00:00-05:00,0.04,2,17,0,1,1038,8453,9491
2016-02-15 18:00:00-05:00,0.05,2,18,0,1,1598,14090,15688
2016-02-15 19:00:00-05:00,0.04,2,19,0,1,1949,16394,18343
2016-02-15 20:00:00-05:00,0.02,2,20,0,1,1864,17452,19316
2016-02-15 21:00:00-05:00,0.05,2,21,0,1,1876,19556,21432
2016-02-15 22:00:00-05:00,0.12,2,22,0,1,1961,21739,23700
2016-02-15 23:00:00-05:00,0.13,2,23,0,1,2169,21357,23526
2016-02-16 00:00:00-05:00,0,2,0,1,0,2368,21561,23929
2016-02-16 01:00:00-05:00,0,2,1,1,0,2646,21166,23812
2016-02-16 02:00:00-05:00,0,2,2,1,0,2706,18599,21305
2016-02-16 03:00:00-05:00,0,2,3,1,0,2522,19258,21780
2016-02-16 04:00:00-05:00,0,2,4,1,0,2695,21316,24011
2016-02-16 05:00:00-05:00,0,2,5,1,0,2554,20991,23545
2016-02-16 06:00:00-05:00,0,2,6,1,0,2437,18156,20593
2016-02-16 07:00:00-05:00,0,2,7,1,0,2115,16950,19065
2016-02-16 08:00:00-05:00,0,2,8,1,0,1989,16637,18626
2016-02-16 09:00:00-05:00,0.01,2,9,1,0,1608,12424,14032
2016-02-16 10:00:00-05:00,0,2,10,1,0,1047,7891,8938
2016-02-16 11:00:00-05:00,0,2,11,1,0,633,5002,5635
2016-02-16 12:00:00-05:00,0.04,2,12,1,0,444,3740,4184
2016-02-16 13:00:00-05:00,0.14,2,13,1,0,264,2072,2336
2016-02-16 14:00:00-05:00,0.41,2,14,1,0,303,2097,2400
2016-02-16 15:00:00-05:00,0.2,2,15,1,0,391,3768,4159
2016-02-16 16:00:00-05:00,0,2,16,1,0,700,10150,10850
2016-02-16 17:00:00-05:00,0,2,17,1,0,1426,15774,17200
2016-02-16 18:00:00-05:00,0,2,18,1,0,2338,21008,23346
2016-02-16 19:00:00-05:00,0,2,19,1,0,2648,22133,24781
2016-02-16 20:00:00-05:00,0,2,20,1,0,2037,17771,19808
2016-02-16 21:00:00-05:00,0,2,21,1,0,1941,17960,19901
2016-02-16 22:00:00-05:00,0,2,22,1,0,2094,20032,22126
2016-02-16 23:00:00-05:00,0,2,23,1,0,2515,22190,24705
2016-02-17 00:00:00-05:00,0,2,0,2,0,2855,22522,25377
2016-02-17 01:00:00-05:00,0,2,1,2,0,2340,16961,19301
2016-02-17 02:00:00-05:00,0,2,2,2,0,2246,14727,16973
2016-02-17 03:00:00-05:00,0,2,3,2,0,2540,17806,20346
2016-02-17 04:00:00-05:00,0,2,4,2,0,2923,22464,25387
2016-02-17 05:00:00-05:00,0,2,5,2,0,2810,21655,24465
2016-02-17 06:00:00-05:00,0,2,6,2,0,2473,21181,23654
2016-02-17 07:00:00-05:00,0,2,7,2,0,2200,21248,23448
2016-02-17 08:00:00-05:00,0,2,8,2,0,1911,19054,20965
2016-02-17 09:00:00-05:00,0,2,9,2,0,1600,14630,16230
2016-02-17 10:00:00-05:00,0,2,10,2,0,1242,9696,10938
2016-02-17 11:00:00-05:00,0,2,11,2,0,854,5887,6741
2016-02-17 12:00:00-05:00,0,2,12,2,0,534,3492,4026
2016-02-17 13:00:00-05:00,0,2,13,2,0,329,2212,2541
2016-02-17 14:00:00-05:00,0,2,14,2,0,344,2362,2706
2016-02-17 15:00:00-05:00,0,2,15,2,0,352,3869,4221
2016-02-17 16:00:00-05:00,0,2,16,2,0,708,10029,10737
2016-02-17 17:00:00-05:00,0,2,17,2,0,1446,17371,18817
2016-02-17 18:00:00-05:00,0,2,18,2,0,2313,21085,23398
2016-02-17 19:00:00-05:00,0,2,19,2,0,2336,20305,22641
2016-02-17 20:00:00-05:00,0,2,20,2,0,2111,17980,20091
2016-02-17 21:00:00-05:00,0,2,21,2,0,2016,18369,20385
2016-02-17 22:00:00-05:00,0,2,22,2,0,1987,19052,21039
2016-02-17 23:00:00-05:00,0,2,23,2,0,2046,19053,21099
2016-02-18 00:00:00-05:00,0,2,0,3,0,2214,19656,21870
2016-02-18 01:00:00-05:00,0,2,1,3,0,2460,19403,21863
2016-02-18 02:00:00-05:00,0,2,2,3,0,2689,17055,19744
2016-02-18 03:00:00-05:00,0,2,3,3,0,2912,20392,23304
2016-02-18 04:00:00-05:00,0,2,4,3,0,3323,24759,28082
2016-02-18 05:00:00-05:00,0,2,5,3,0,3360,25261,28621
2016-02-18 06:00:00-05:00,0,2,6,3,0,2858,24536,27394
2016-02-18 07:00:00-05:00,0,2,7,3,0,2663,24519,27182
2016-02-18 08:00:00-05:00,0,2,8,3,0,2313,22644,24957
2016-02-18 09:00:00-05:00,0,2,9,3,0,2056,17995,20051
2016-02-18 10:00:00-05:00,0,2,10,3,0,1514,11214,12728
2016-02-18 11:00:00-05:00,0,2,11,3,0,973,6456,7429
2016-02-18 12:00:00-05:00,0,2,12,3,0,645,4120,4765
2016-02-18 13:00:00-05:00,0,2,13,3,0,446,2721,3167
2016-02-18 14:00:00-05:00,0,2,14,3,0,401,2675,3076
2016-02-18 15:00:00-05:00,0,2,15,3,0,358,3869,4227
2016-02-18 16:00:00-05:00,0,2,16,3,0,703,10451,11154
2016-02-18 17:00:00-05:00,0,2,17,3,0,1543,17966,19509
2016-02-18 18:00:00-05:00,0,2,18,3,0,2436,21520,23956
2016-02-18 19:00:00-05:00,0,2,19,3,0,2537,20736,23273
2016-02-18 20:00:00-05:00,0,2,20,3,0,2200,18518,20718
2016-02-18 21:00:00-05:00,0,2,21,3,0,2064,18350,20414
2016-02-18 22:00:00-05:00,0,2,22,3,0,1975,19076,21051
2016-02-18 23:00:00-05:00,0,2,23,3,0,2145,18997,21142
2016-02-19 00:00:00-05:00,0,2,0,4,0,2169,20385,22554
2016-02-19 01:00:00-05:00,0,2,1,4,0,2421,20273,22694
2016-02-19 02:00:00-05:00,0,2,2,4,0,2926,17463,20389
2016-02-19 03:00:00-05:00,0,2,3,4,0,3291,21279,24570
2016-02-19 04:00:00-05:00,0,2,4,4,0,3858,26224,30082
2016-02-19 05:00:00-05:00,0,2,5,4,0,3762,26944,30706
2016-02-19 06:00:00-05:00,0,2,6,4,0,3416,26925,30341
2016-02-19 07:00:00-05:00,0,2,7,4,0,3264,27060,30324
2016-02-19 08:00:00-05:00,0,2,8,4,0,2936,25467,28403
2016-02-19 09:00:00-05:00,0,2,9,4,0,2629,21952,24581
2016-02-19 10:00:00-05:00,0,2,10,4,0,1871,14821,16692
2016-02-19 11:00:00-05:00,0,2,11,4,0,1329,9196,10525
2016-02-19 12:00:00-05:00,0,2,12,4,0,953,6015,6968
2016-02-19 13:00:00-05:00,0,2,13,4,0,685,4225,4910
2016-02-19 14:00:00-05:00,0,2,14,4,0,536,3581,4117
2016-02-19 15:00:00-05:00,0,2,15,4,0,422,4385,4807
2016-02-19 16:00:00-05:00,0,2,16,4,0,762,10234,10996
2016-02-19 17:00:00-05:00,0,2,17,4,0,1597,17377,18974
2016-02-19 18:00:00-05:00,0,2,18,4,0,2514,21342,23856
2016-02-19 19:00:00-05:00,0,2,19,4,0,2541,20307,22848
2016-02-19 20:00:00-05:00,0,2,20,4,0,2163,17904,20067
2016-02-19 21:00:00-05:00,0,2,21,4,0,1974,17941,19915
2016-02-19 22:00:00-05:00,0,2,22,4,0,1892,19257,21149
2016-02-19 23:00:00-05:00,0,2,23,4,0,1895,19667,21562
2016-02-20 00:00:00-05:00,0,2,0,5,0,2298,20958,23256
2016-02-20 01:00:00-05:00,0,2,1,5,0,2618,20208,22826
2016-02-20 02:00:00-05:00,0,2,2,5,0,3269,17993,21262
2016-02-20 03:00:00-05:00,0,2,3,5,0,3639,21732,25371
2016-02-20 04:00:00-05:00,0,2,4,5,0,4294,26630,30924
2016-02-20 05:00:00-05:00,0,2,5,5,0,4314,28066,32380
2016-02-20 06:00:00-05:00,0,2,6,5,0,3938,25092,29030
2016-02-20 07:00:00-05:00,0,2,7,5,0,3854,24152,28006
2016-02-20 08:00:00-05:00,0,2,8,5,0,3776,24430,28206
2016-02-20 09:00:00-05:00,0,2,9,5,0,3870,25283,29153
2016-02-20 10:00:00-05:00,0,2,10,5,0,3781,23383,27164
2016-02-20 11:00:00-05:00,0,2,11,5,0,3298,19454,22752
2016-02-20 12:00:00-05:00,0,2,12,5,0,2694,16061,18755
2016-02-20 13:00:00-05:00,0,2,13,5,0,2277,12070,14347
2016-02-20 14:00:00-05:00,0,2,14,5,0,1646,7750,9396
2016-02-20 15:00:00-05:00,0,2,15,5,0,824,3745,4569
2016-02-20 16:00:00-05:00,0,2,16,5,0,687,4825,5512
2016-02-20 17:00:00-05:00,0,2,17,5,0,964,6359,7323
2016-02-20 18:00:00-05:00,0,2,18,5,0,1350,9868,11218
2016-02-20 19:00:00-05:00,0,2,19,5,0,1788,14114,15902
2016-02-20 20:00:00-05:00,0,2,20,5,0,2079,16916,18995
2016-02-20 21:00:00-05:00,0,2,21,5,0,2301,18775,21076
2016-02-20 22:00:00-05:00,0,2,22,5,0,2465,20805,23270
2016-02-20 23:00:00-05:00,0,2,23,5,0,2663,21647,24310
2016-02-21 00:00:00-05:00,0,2,0,6,0,2752,19674,22426
2016-02-21 01:00:00-05:00,0,2,1,6,0,2885,20140,23025
2016-02-21 02:00:00-05:00,0,2,2,6,0,3297,19605,22902
2016-02-21 03:00:00-05:00,0,2,3,6,0,3502,22010,25512
2016-02-21 04:00:00-05:00,0,2,4,6,0,4045,26070,30115
2016-02-21 05:00:00-05:00,0,2,5,6,0,4264,26529,30793
2016-02-21 06:00:00-05:00,0,2,6,6,0,4131,22648,26779
2016-02-21 07:00:00-05:00,0,2,7,6,0,4108,21965,26073
2016-02-21 08:00:00-05:00,0,2,8,6,0,4242,24362,28604
2016-02-21 09:00:00-05:00,0,2,9,6,0,4470,26008,30478
2016-02-21 10:00:00-05:00,0,2,10,6,0,4212,24616,28828
2016-02-21 11:00:00-05:00,0,2,11,6,0,3872,22090,25962
2016-02-21 12:00:00-05:00,0,2,12,6,0,3265,19392,22657
2016-02-21 13:00:00-05:00,0,2,13,6,0,2762,14701,17463
2016-02-21 14:00:00-05:00,0,2,14,6,0,2018,9192,11210
2016-02-21 15:00:00-05:00,0,2,15,6,0,951,3923,4874
2016-02-21 16:00:00-05:00,0,2,16,6,0,684,3984,4668
2016-02-21 17:00:00-05:00,0,2,17,6,0,702,5190,5892
2016-02-21 18:00:00-05:00,0.02,2,18,6,0,954,7969,8923
2016-02-21 19:00:00-05:00,0,2,19,6,0,1390,11967,13357
2016-02-21 20:00:00-05:00,0,2,20,6,0,1741,15931,17672
2016-02-21 21:00:00-05:00,0.02,2,21,6,0,1990,18396,20386
2016-02-21 22:00:00-05:00,0.01,2,22,6,0,2113,20162,22275
2016-02-21 23:00:00-05:00,0,2,23,6,0,2359,20032,22391
2016-02-22 00:00:00-05:00,0,2,0,0,0,2424,20134,22558
2016-02-22 01:00:00-05:00,0,2,1,0,0,2592,19267,21859
2016-02-22 02:00:00-05:00,0,2,2,0,0,2781,18985,21766
2016-02-22 03:00:00-05:00,0,2,3,0,0,2972,20294,23266
2016-02-22 04:00:00-05:00,0,2,4,0,0,3292,22491,25783
2016-02-22 05:00:00-05:00,0,2,5,0,0,2873,17710,20583
2016-02-22 06:00:00-05:00,0,2,6,0,0,2812,17334,20146
2016-02-22 07:00:00-05:00,0,2,7,0,0,2510,15690,18200
2016-02-22 08:00:00-05:00,0,2,8,0,0,2186,13091,15277
2016-02-22 09:00:00-05:00,0,2,9,0,0,1687,9587,11274
2016-02-22 10:00:00-05:00,0,2,10,0,0,1216,5833,7049
2016-02-22 11:00:00-05:00,0,2,11,0,0,822,3757,4579
2016-02-22 12:00:00-05:00,0,2,12,0,0,494,2241,2735
2016-02-22 13:00:00-05:00,0,2,13,0,0,301,1555,1856
2016-02-22 14:00:00-05:00,0,2,14,0,0,448,2096,2544
2016-02-22 15:00:00-05:00,0,2,15,0,0,428,4059,4487
2016-02-22 16:00:00-05:00,0,2,16,0,0,870,10647,11517
2016-02-22 17:00:00-05:00,0,2,17,0,0,1957,18057,20014
2016-02-22 18:00:00-05:00,0,2,18,0,0,2582,21076,23658
2016-02-22 19:00:00-05:00,0,2,19,0,0,2368,18949,21317
2016-02-22 20:00:00-05:00,0,2,20,0,0,1971,16155,18126
2016-02-22 21:00:00-05:00,0,2,21,0,0,1740,15151,16891
2016-02-22 22:00:00-05:00,0,2,22,0,0,1612,16498,18110
2016-02-22 23:00:00-05:00,0,2,23,0,0,1711,16371,18082
2016-02-23 00:00:00-05:00,0,2,0,1,0,1985,17540,19525
2016-02-23 01:00:00-05:00,0,2,1,1,0,2100,18203,20303
2016-02-23 02:00:00-05:00,0,2,2,1,0,2373,16890,19263
2016-02-23 03:00:00-05:00,0,2,3,1,0,2699,19951,22650
2016-02-23 04:00:00-05:00,0,2,4,1,0,2961,24870,27831
2016-02-23 05:00:00-05:00,0,2,5,1,0,2807,23582,26389
2016-02-23 06:00:00-05:00,0,2,6,1,0,2398,21287,23685
2016-02-23 07:00:00-05:00,0,2,7,1,0,2073,20504,22577
2016-02-23 08:00:00-05:00,0,2,8,1,0,1812,18397,20209
2016-02-23 09:00:00-05:00,0,2,9,1,0,1451,13087,14538
2016-02-23 10:00:00-05:00,0,2,10,1,0,1067,7929,8996
2016-02-23 11:00:00-05:00,0,2,11,1,0,672,4502,5174
2016-02-23 12:00:00-05:00,0.01,2,12,1,0,422,2682,3104
2016-02-23 13:00:00-05:00,0.03,2,13,1,0,303,1893,2196
2016-02-23 14:00:00-05:00,0.01,2,14,1,0,297,2041,2338
2016-02-23 15:00:00-05:00,0.01,2,15,1,0,345,3793,4138
2016-02-23 16:00:00-05:00,0,2,16,1,0,780,10655,11435
2016-02-23 17:00:00-05:00,0,2,17,1,0,1895,19170,21065
2016-02-23 18:00:00-05:00,0.01,2,18,1,0,2643,22984,25627
2016-02-23 19:00:00-05:00,0.01,2,19,1,0,2544,20760,23304
2016-02-23 20:00:00-05:00,0.06,2,20,1,0,2007,18468,20475
2016-02-23 21:00:00-05:00,0.03,2,21,1,0,2081,19608,21689
2016-02-23 22:00:00-05:00,0.02,2,22,1,0,2207,20849,23056
2016-02-23 23:00:00-05:00,0.02,2,23,1,0,2148,20468,22616
2016-02-24 00:00:00-05:00,0.01,2,0,2,0,2579,21792,24371
2016-02-24 01:00:00-05:00,0.02,2,1,2,0,2792,21026,23818
2016-02-24 02:00:00-05:00,0,2,2,2,0,2955,16994,19949
2016-02-24 03:00:00-05:00,0.02,2,3,2,0,3400,20908,24308
2016-02-24 04:00:00-05:00,0.02,2,4,2,0,3845,24595,28440
2016-02-24 05:00:00-05:00,0.01,2,5,2,0,3725,26042,29767
2016-02-24 06:00:00-05:00,0.01,2,6,2,0,3561,26438,29999
2016-02-24 07:00:00-05:00,0.02,2,7,2,0,2888,25066,27954
2016-02-24 08:00:00-05:00,0.02,2,8,2,0,2473,21476,23949
2016-02-24 09:00:00-05:00,0.03,2,9,2,0,1894,15651,17545
2016-02-24 10:00:00-05:00,0.02,2,10,2,0,1296,9588,10884
2016-02-24 11:00:00-05:00,0.23,2,11,2,0,746,5450,6196
2016-02-24 12:00:00-05:00,0.21,2,12,2,0,448,3323,3771
2016-02-24 13:00:00-05:00,0.28,2,13,2,0,291,2175,2466
2016-02-24 14:00:00-05:00,0.04,2,14,2,0,331,2292,2623
2016-02-24 15:00:00-05:00,0.03,2,15,2,0,374,3940,4314
2016-02-24 16:00:00-05:00,0,2,16,2,0,819,11658,12477
2016-02-24 17:00:00-05:00,0.09,2,17,2,0,1933,20993,22926
2016-02-24 18:00:00-05:00,0,2,18,2,0,2869,24784,27653
2016-02-24 19:00:00-05:00,0.04,2,19,2,0,2779,21955,24734
2016-02-24 20:00:00-05:00,0,2,20,2,0,2262,19355,21617
2016-02-24 21:00:00-05:00,0.02,2,21,2,0,2434,20575,23009
2016-02-24 22:00:00-05:00,0.03,2,22,2,0,2521,22011,24532
2016-02-24 23:00:00-05:00,0.4,2,23,2,0,2436,19696,22132
2016-02-25 00:00:00-05:00,0,2,0,3,0,2278,19407,21685
2016-02-25 01:00:00-05:00,0.02,2,1,3,0,2381,17997,20378
2016-02-25 02:00:00-05:00,0,2,2,3,0,2890,16767,19657
2016-02-25 03:00:00-05:00,0,2,3,3,0,3349,20530,23879
2016-02-25 04:00:00-05:00,0,2,4,3,0,3500,24352,27852
2016-02-25 05:00:00-05:00,0,2,5,3,0,3521,25329,28850
2016-02-25 06:00:00-05:00,0,2,6,3,0,2911,24451,27362
2016-02-25 07:00:00-05:00,0,2,7,3,0,2710,24420,27130
2016-02-25 08:00:00-05:00,0,2,8,3,0,2400,22618,25018
2016-02-25 09:00:00-05:00,0,2,9,3,0,2189,16389,18578
2016-02-25 10:00:00-05:00,0,2,10,3,0,1367,9580,10947
2016-02-25 11:00:00-05:00,0,2,11,3,0,811,6158,6969
2016-02-25 12:00:00-05:00,0,2,12,3,0,507,4644,5151
2016-02-25 13:00:00-05:00,0,2,13,3,0,367,2963,3330
2016-02-25 14:00:00-05:00,0,2,14,3,0,385,2702,3087
2016-02-25 15:00:00-05:00,0,2,15,3,0,382,4102,4484
2016-02-25 16:00:00-05:00,0,2,16,3,0,821,10958,11779
2016-02-25 17:00:00-05:00,0,2,17,3,0,1931,19822,21753
2016-02-25 18:00:00-05:00,0,2,18,3,0,2705,22477,25182
2016-02-25 19:00:00-05:00,0,2,19,3,0,2505,20765,23270
2016-02-25 20:00:00-05:00,0,2,20,3,0,2164,18238,20402
2016-02-25 21:00:00-05:00,0,2,21,3,0,1753,17367,19120
2016-02-25 22:00:00-05:00,0,2,22,3,0,1909,19015,20924
2016-02-25 23:00:00-05:00,0,2,23,3,0,1957,19136,21093
2016-02-26 00:00:00-05:00,0,2,0,4,0,2533,21351,23884
2016-02-26 01:00:00-05:00,0,2,1,4,0,2911,21525,24436
2016-02-26 02:00:00-05:00,0,2,2,4,0,3271,17788,21059
2016-02-26 03:00:00-05:00,0,2,3,4,0,3534,21498,25032
2016-02-26 04:00:00-05:00,0,2,4,4,0,3875,26319,30194
2016-02-26 05:00:00-05:00,0,2,5,4,0,3780,26829,30609
2016-02-26 06:00:00-05:00,0,2,6,4,0,3425,26589,30014
2016-02-26 07:00:00-05:00,0,2,7,4,0,3248,26670,29918
2016-02-26 08:00:00-05:00,0,2,8,4,0,2843,25487,28330
2016-02-26 09:00:00-05:00,0,2,9,4,0,2509,21661,24170
2016-02-26 10:00:00-05:00,0,2,10,4,0,1834,14972,16806
2016-02-26 11:00:00-05:00,0,2,11,4,0,1214,9568,10782
2016-02-26 12:00:00-05:00,0,2,12,4,0,872,6150,7022
2016-02-26 13:00:00-05:00,0,2,13,4,0,671,4178,4849
2016-02-26 14:00:00-05:00,0,2,14,4,0,574,3646,4220
2016-02-26 15:00:00-05:00,0,2,15,4,0,462,4607,5069
2016-02-26 16:00:00-05:00,0,2,16,4,0,834,10886,11720
2016-02-26 17:00:00-05:00,0,2,17,4,0,2047,19293,21340
2016-02-26 18:00:00-05:00,0,2,18,4,0,2703,22647,25350
2016-02-26 19:00:00-05:00,0,2,19,4,0,2491,20654,23145
2016-02-26 20:00:00-05:00,0,2,20,4,0,2143,19331,21474
2016-02-26 21:00:00-05:00,0,2,21,4,0,1975,19486,21461
2016-02-26 22:00:00-05:00,0,2,22,4,0,1830,20526,22356
2016-02-26 23:00:00-05:00,0,2,23,4,0,1986,19832,21818
2016-02-27 00:00:00-05:00,0,2,0,5,0,2473,21873,24346
2016-02-27 01:00:00-05:00,0,2,1,5,0,2805,20218,23023
2016-02-27 02:00:00-05:00,0,2,2,5,0,3236,17375,20611
2016-02-27 03:00:00-05:00,0,2,3,5,0,3871,21745,25616
2016-02-27 04:00:00-05:00,0,2,4,5,0,4480,27190,31670
2016-02-27 05:00:00-05:00,0,2,5,5,0,4690,28556,33246
2016-02-27 06:00:00-05:00,0,2,6,5,0,4431,26207,30638
2016-02-27 07:00:00-05:00,0,2,7,5,0,4253,25961,30214
2016-02-27 08:00:00-05:00,0,2,8,5,0,4187,26647,30834
2016-02-27 09:00:00-05:00,0,2,9,5,0,4191,26250,30441
2016-02-27 10:00:00-05:00,0,2,10,5,0,3843,23630,27473
2016-02-27 11:00:00-05:00,0,2,11,5,0,3220,19537,22757
2016-02-27 12:00:00-05:00,0,2,12,5,0,2707,15944,18651
2016-02-27 13:00:00-05:00,0,2,13,5,0,2083,11705,13788
2016-02-27 14:00:00-05:00,0,2,14,5,0,1608,7712,9320
2016-02-27 15:00:00-05:00,0,2,15,5,0,716,3615,4331
2016-02-27 16:00:00-05:00,0,2,16,5,0,749,4876,5625
2016-02-27 17:00:00-05:00,0,2,17,5,0,948,6744,7692
2016-02-27 18:00:00-05:00,0,2,18,5,0,1362,10664,12026
2016-02-27 19:00:00-05:00,0,2,19,5,0,1966,15019,16985
2016-02-27 20:00:00-05:00,0,2,20,5,0,2193,19101,21294
2016-02-27 21:00:00-05:00,0,2,21,5,0,2329,20625,22954
2016-02-27 22:00:00-05:00,0,2,22,5,0,2279,21733,24012
2016-02-27 23:00:00-05:00,0,2,23,5,0,2619,22352,24971
2016-02-28 00:00:00-05:00,0,2,0,6,0,2941,20851,23792
2016-02-28 01:00:00-05:00,0,2,1,6,0,3027,21675,24702
2016-02-28 02:00:00-05:00,0,2,2,6,0,3285,20377,23662
2016-02-28 03:00:00-05:00,0,2,3,6,0,3620,22853,26473
2016-02-28 04:00:00-05:00,0,2,4,6,0,4113,26844,30957
2016-02-28 05:00:00-05:00,0,2,5,6,0,4396,27882,32278
2016-02-28 06:00:00-05:00,0,2,6,6,0,4281,22953,27234
2016-02-28 07:00:00-05:00,0,2,7,6,0,4323,22611,26934
2016-02-28 08:00:00-05:00,0,2,8,6,0,4244,24938,29182
2016-02-28 09:00:00-05:00,0,2,9,6,0,4559,26694,31253
2016-02-28 10:00:00-05:00,0,2,10,6,0,4278,24917,29195
2016-02-28 11:00:00-05:00,0,2,11,6,0,3749,22388,26137
2016-02-28 12:00:00-05:00,0,2,12,6,0,3314,19321,22635
2016-02-28 13:00:00-05:00,0,2,13,6,0,2643,14709,17352
2016-02-28 14:00:00-05:00,0,2,14,6,0,2038,8936,10974
2016-02-28 15:00:00-05:00,0,2,15,6,0,903,3814,4717
2016-02-28 16:00:00-05:00,0,2,16,6,0,621,4103,4724
2016-02-28 17:00:00-05:00,0,2,17,6,0,669,4952,5621
2016-02-28 18:00:00-05:00,0,2,18,6,0,899,7447,8346
2016-02-28 19:00:00-05:00,0,2,19,6,0,1387,11596,12983
2016-02-28 20:00:00-05:00,0,2,20,6,0,1728,15892,17620
2016-02-28 21:00:00-05:00,0,2,21,6,0,1960,18204,20164
2016-02-28 22:00:00-05:00,0,2,22,6,0,2077,19785,21862
2016-02-28 23:00:00-05:00,0,2,23,6,0,2366,19916,22282
2016-02-29 00:00:00-05:00,0,2,0,0,0,2492,19795,22287
2016-02-29 01:00:00-05:00,0,2,1,0,0,2536,19107,21643
2016-02-29 02:00:00-05:00,0,2,2,0,0,2672,18737,21409
2016-02-29 03:00:00-05:00,0,2,3,0,0,2824,19749,22573
2016-02-29 04:00:00-05:00,0,2,4,0,0,3062,21655,24717
2016-02-29 05:00:00-05:00,0,2,5,0,0,2859,19032,21891
2016-02-29 06:00:00-05:00,0,2,6,0,0,2524,14902,17426
2016-02-29 07:00:00-05:00,0,2,7,0,0,2342,13822,16164
2016-02-29 08:00:00-05:00,0,2,8,0,0,2072,13457,15529
2016-02-29 09:00:00-05:00,0,2,9,0,0,1724,10019,11743
2016-02-29 10:00:00-05:00,0,2,10,0,0,1828,11995,13823
2016-02-29 11:00:00-05:00,0.06,2,11,0,0,904,3933,4837
2016-02-29 12:00:00-05:00,0.01,2,12,0,0,571,2451,3022
2016-02-29 13:00:00-05:00,0,2,13,0,0,427,1782,2209
2016-02-29 14:00:00-05:00,0,2,14,0,0,474,2256,2730
2016-02-29 15:00:00-05:00,0,2,15,0,0,431,4039,4470
2016-02-29 16:00:00-05:00,0,2,16,0,0,920,10786,11706
2016-02-29 17:00:00-05:00,0,2,17,0,0,1973,17650,19623
2016-02-29 18:00:00-05:00,0,2,18,0,0,2759,20153,22912
2016-02-29 19:00:00-05:00,0,2,19,0,0,2429,18672,21101
2016-02-29 20:00:00-05:00,0,2,20,0,0,2176,17196,19372
2016-02-29 21:00:00-05:00,0,2,21,0,0,2091,18029,20120
2016-02-29 22:00:00-05:00,0,2,22,0,0,1740,15910,17650
2016-02-29 23:00:00-05:00,0,2,23,0,0,1768,15164,16932
2016-03-01 00:00:00-05:00,0,3,0,1,0,2025,17604,19629
2016-03-01 01:00:00-05:00,0,3,1,1,0,2058,17691,19749
2016-03-01 02:00:00-05:00,0,3,2,1,0,2359,16210,18569
2016-03-01 03:00:00-05:00,0,3,3,1,0,2653,19664,22317
2016-03-01 04:00:00-05:00,0,3,4,1,0,2928,24153,27081
2016-03-01 05:00:00-05:00,0,3,5,1,0,2814,22908,25722
2016-03-01 06:00:00-05:00,0,3,6,1,0,2523,20745,23268
2016-03-01 07:00:00-05:00,0,3,7,1,0,2186,20627,22813
2016-03-01 08:00:00-05:00,0,3,8,1,0,1765,16602,18367
2016-03-01 09:00:00-05:00,0,3,9,1,0,1524,11614,13138
2016-03-01 10:00:00-05:00,0,3,10,1,0,1084,7079,8163
2016-03-01 11:00:00-05:00,0,3,11,1,0,772,4148,4920
2016-03-01 12:00:00-05:00,0,3,12,1,0,538,2602,3140
2016-03-01 13:00:00-05:00,0,3,13,1,0,354,1860,2214
2016-03-01 14:00:00-05:00,0,3,14,1,0,329,1929,2258
2016-03-01 15:00:00-05:00,0,3,15,1,0,403,3697,4100
2016-03-01 16:00:00-05:00,0,3,16,1,0,756,10349,11105
2016-03-01 17:00:00-05:00,0,3,17,1,0,1853,18747,20600
2016-03-01 18:00:00-05:00,0,3,18,1,0,2522,21731,24253
2016-03-01 19:00:00-05:00,0,3,19,1,0,2361,19961,22322
2016-03-01 20:00:00-05:00,0,3,20,1,0,1976,16978,18954
2016-03-01 21:00:00-05:00,0,3,21,1,0,1840,16882,18722
2016-03-01 22:00:00-05:00,0,3,22,1,0,1783,17221,19004
2016-03-01 23:00:00-05:00,0,3,23,1,0,1981,17502,19483
2016-03-02 00:00:00-05:00,0,3,0,2,0,2386,19277,21663
2016-03-02 01:00:00-05:00,0,3,1,2,0,2568,19389,21957
2016-03-02 02:00:00-05:00,0,3,2,2,0,2866,17703,20569
2016-03-02 03:00:00-05:00,0.09,3,3,2,0,3091,21407,24498
2016-03-02 04:00:00-05:00,0.02,3,4,2,0,3308,26001,29309
2016-03-02 05:00:00-05:00,0.04,3,5,2,0,3247,25370,28617
2016-03-02 06:00:00-05:00,0.02,3,6,2,0,2811,24034,26845
2016-03-02 07:00:00-05:00,0,3,7,2,0,2565,24093,26658
2016-03-02 08:00:00-05:00,0,3,8,2,0,2154,20815,22969
2016-03-02 09:00:00-05:00,0,3,9,2,0,1801,14093,15894
2016-03-02 10:00:00-05:00,0,3,10,2,0,1195,9097,10292
2016-03-02 11:00:00-05:00,0,3,11,2,0,814,5303,6117
2016-03-02 12:00:00-05:00,0,3,12,2,0,483,3574,4057
2016-03-02 13:00:00-05:00,0,3,13,2,0,370,2317,2687
2016-03-02 14:00:00-05:00,0,3,14,2,0,377,2176,2553
2016-03-02 15:00:00-05:00,0,3,15,2,0,333,4024,4357
2016-03-02 16:00:00-05:00,0,3,16,2,0,791,10810,11601
2016-03-02 17:00:00-05:00,0,3,17,2,0,1973,19793,21766
2016-03-02 18:00:00-05:00,0,3,18,2,0,2792,23017,25809
2016-03-02 19:00:00-05:00,0,3,19,2,0,2620,20388,23008
2016-03-02 20:00:00-05:00,0,3,20,2,0,2020,18225,20245
2016-03-02 21:00:00-05:00,0,3,21,2,0,1971,18092,20063
2016-03-02 22:00:00-05:00,0,3,22,2,0,1920,19051,20971
2016-03-02 23:00:00-05:00,0,3,23,2,0,1969,18529,20498
2016-03-03 00:00:00-05:00,0,3,0,3,0,2246,20469,22715
2016-03-03 01:00:00-05:00,0,3,1,3,0,2481,20101,22582
2016-03-03 02:00:00-05:00,0,3,2,3,0,2763,17805,20568
2016-03-03 03:00:00-05:00,0,3,3,3,0,3354,22450,25804
2016-03-03 04:00:00-05:00,0,3,4,3,0,3706,27306,31012
2016-03-03 05:00:00-05:00,0,3,5,3,0,3788,28113,31901
2016-03-03 06:00:00-05:00,0,3,6,3,0,3312,27442,30754
2016-03-03 07:00:00-05:00,0,3,7,3,0,3107,27134,30241
2016-03-03 08:00:00-05:00,0,3,8,3,0,2671,23785,26456
2016-03-03 09:00:00-05:00,0,3,9,3,0,2275,18186,20461
2016-03-03 10:00:00-05:00,0,3,10,3,0,1468,11096,12564
2016-03-03 11:00:00-05:00,0,3,11,3,0,934,6120,7054
2016-03-03 12:00:00-05:00,0,3,12,3,0,609,3835,4444
2016-03-03 13:00:00-05:00,0,3,13,3,0,450,2385,2835
2016-03-03 14:00:00-05:00,0,3,14,3,0,418,2452,2870
2016-03-03 15:00:00-05:00,0,3,15,3,0,389,4222,4611
2016-03-03 16:00:00-05:00,0,3,16,3,0,875,11121,11996
2016-03-03 17:00:00-05:00,0,3,17,3,0,2034,20929,22963
2016-03-03 18:00:00-05:00,0,3,18,3,0,2793,23421,26214
2016-03-03 19:00:00-05:00,0,3,19,3,0,2914,22251,25165
2016-03-03 20:00:00-05:00,0,3,20,3,0,2305,19407,21712
2016-03-03 21:00:00-05:00,0,3,21,3,0,2356,19527,21883
2016-03-03 22:00:00-05:00,0,3,22,3,0,2133,20370,22503
2016-03-03 23:00:00-05:00,0,3,23,3,0,2191,20468,22659
2016-03-04 00:00:00-05:00,0,3,0,4,0,2402,21448,23850
2016-03-04 01:00:00-05:00,0,3,1,4,0,2631,20886,23517
2016-03-04 02:00:00-05:00,0,3,2,4,0,3138,18463,21601
2016-03-04 03:00:00-05:00,0.02,3,3,4,0,3588,22991,26579
2016-03-04 04:00:00-05:00,0.02,3,4,4,0,3893,27716,31609
2016-03-04 05:00:00-05:00,0,3,5,4,0,3910,28394,32304
2016-03-04 06:00:00-05:00,0,3,6,4,0,3371,27212,30583
2016-03-04 07:00:00-05:00,0,3,7,4,0,3011,26837,29848
2016-03-04 08:00:00-05:00,0.02,3,8,4,0,2702,25296,27998
2016-03-04 09:00:00-05:00,0.01,3,9,4,0,2468,21277,23745
2016-03-04 10:00:00-05:00,0.01,3,10,4,0,1862,14412,16274
2016-03-04 11:00:00-05:00,0,3,11,4,0,1264,9230,10494
2016-03-04 12:00:00-05:00,0,3,12,4,0,784,5936,6720
2016-03-04 13:00:00-05:00,0,3,13,4,0,570,3983,4553
2016-03-04 14:00:00-05:00,0,3,14,4,0,476,3482,3958
2016-03-04 15:00:00-05:00,0,3,15,4,0,457,4635,5092
2016-03-04 16:00:00-05:00,0,3,16,4,0,848,11251,12099
2016-03-04 17:00:00-05:00,0,3,17,4,0,1842,20154,21996
2016-03-04 18:00:00-05:00,0,3,18,4,0,2774,24014,26788
2016-03-04 19:00:00-05:00,0,3,19,4,0,2648,21412,24060
2016-03-04 20:00:00-05:00,0,3,20,4,0,2215,18801,21016
2016-03-04 21:00:00-05:00,0,3,21,4,0,2031,18717,20748
2016-03-04 22:00:00-05:00,0,3,22,4,0,1927,19144,21071
2016-03-04 23:00:00-05:00,0,3,23,4,0,1950,19336,21286
2016-03-05 00:00:00-05:00,0,3,0,5,0,2475,21298,23773
2016-03-05 01:00:00-05:00,0,3,1,5,0,2646,19952,22598
2016-03-05 02:00:00-05:00,0,3,2,5,0,3231,17506,20737
2016-03-05 03:00:00-05:00,0,3,3,5,0,3823,22007,25830
2016-03-05 04:00:00-05:00,0,3,4,5,0,4241,27340,31581
2016-03-05 05:00:00-05:00,0,3,5,5,0,4439,28764,33203
2016-03-05 06:00:00-05:00,0,3,6,5,0,4191,26217,30408
2016-03-05 07:00:00-05:00,0,3,7,5,0,3975,25058,29033
2016-03-05 08:00:00-05:00,0,3,8,5,0,3945,25628,29573
2016-03-05 09:00:00-05:00,0,3,9,5,0,4123,25888,30011
2016-03-05 10:00:00-05:00,0,3,10,5,0,3865,23324,27189
2016-03-05 11:00:00-05:00,0,3,11,5,0,3415,19641,23056
2016-03-05 12:00:00-05:00,0,3,12,5,0,2630,15299,17929
2016-03-05 13:00:00-05:00,0,3,13,5,0,2081,11364,13445
2016-03-05 14:00:00-05:00,0,3,14,5,0,1527,7321,8848
2016-03-05 15:00:00-05:00,0,3,15,5,0,831,3762,4593
2016-03-05 16:00:00-05:00,0,3,16,5,0,684,4816,5500
2016-03-05 17:00:00-05:00,0,3,17,5,0,906,7284,8190
2016-03-05 18:00:00-05:00,0,3,18,5,0,1386,10966,12352
2016-03-05 19:00:00-05:00,0,3,19,5,0,1864,15849,17713
2016-03-05 20:00:00-05:00,0,3,20,5,0,2138,19099,21237
2016-03-05 21:00:00-05:00,0,3,21,5,0,2299,21369,23668
2016-03-05 22:00:00-05:00,0,3,22,5,0,2508,23189,25697
2016-03-05 23:00:00-05:00,0,3,23,5,0,2682,22873,25555
2016-03-06 00:00:00-05:00,0,3,0,6,0,2772,22216,24988
2016-03-06 01:00:00-05:00,0,3,1,6,0,2927,22265,25192
2016-03-06 02:00:00-05:00,0,3,2,6,0,3184,20595,23779
2016-03-06 03:00:00-05:00,0,3,3,6,0,3572,23474,27046
2016-03-06 04:00:00-05:00,0,3,4,6,0,4129,28118,32247
2016-03-06 05:00:00-05:00,0,3,5,6,0,4384,28097,32481
2016-03-06 06:00:00-05:00,0,3,6,6,0,4419,23558,27977
2016-03-06 07:00:00-05:00,0,3,7,6,0,4705,24167,28872
2016-03-06 08:00:00-05:00,0,3,8,6,0,4640,26059,30699
2016-03-06 09:00:00-05:00,0,3,9,6,0,4574,26557,31131
2016-03-06 10:00:00-05:00,0,3,10,6,0,4021,24739,28760
2016-03-06 11:00:00-05:00,0,3,11,6,0,3872,23353,27225
2016-03-06 12:00:00-05:00,0,3,12,6,0,3211,19022,22233
2016-03-06 13:00:00-05:00,0,3,13,6,0,2444,14151,16595
2016-03-06 14:00:00-05:00,0,3,14,6,0,1906,8914,10820
2016-03-06 15:00:00-05:00,0,3,15,6,0,870,3773,4643
2016-03-06 16:00:00-05:00,0,3,16,6,0,641,4120,4761
2016-03-06 17:00:00-05:00,0,3,17,6,0,744,5477,6221
2016-03-06 18:00:00-05:00,0,3,18,6,0,999,8974,9973
2016-03-06 19:00:00-05:00,0,3,19,6,0,1368,13104,14472
2016-03-06 20:00:00-05:00,0,3,20,6,0,1845,17334,19179
2016-03-06 21:00:00-05:00,0,3,21,6,0,2080,19743,21823
2016-03-06 22:00:00-05:00,0,3,22,6,0,2119,21158,23277
2016-03-06 23:00:00-05:00,0,3,23,6,0,2335,21722,24057
2016-03-07 00:00:00-05:00,0,3,0,0,0,2477,21511,23988
2016-03-07 01:00:00-05:00,0,3,1,0,0,2595,20816,23411
2016-03-07 02:00:00-05:00,0,3,2,0,0,2779,20063,22842
2016-03-07 03:00:00-05:00,0,3,3,0,0,2867,20566,23433
2016-03-07 04:00:00-05:00,0,3,4,0,0,3016,21558,24574
2016-03-07 05:00:00-05:00,0,3,5,0,0,2846,19432,22278
2016-03-07 06:00:00-05:00,0,3,6,0,0,2429,17216,19645
2016-03-07 07:00:00-05:00,0,3,7,0,0,2380,15373,17753
2016-03-07 08:00:00-05:00,0,3,8,0,0,2008,12858,14866
2016-03-07 09:00:00-05:00,0,3,9,0,0,1686,10126,11812
2016-03-07 10:00:00-05:00,0,3,10,0,0,1162,6505,7667
2016-03-07 11:00:00-05:00,0,3,11,0,0,750,3960,4710
2016-03-07 12:00:00-05:00,0,3,12,0,0,478,2516,2994
2016-03-07 13:00:00-05:00,0,3,13,0,0,390,1860,2250
2016-03-07 14:00:00-05:00,0,3,14,0,0,442,2160,2602
2016-03-07 15:00:00-05:00,0,3,15,0,0,487,4027,4514
2016-03-07 16:00:00-05:00,0,3,16,0,0,885,10891,11776
2016-03-07 17:00:00-05:00,0,3,17,0,0,1896,18308,20204
2016-03-07 18:00:00-05:00,0,3,18,0,0,2643,21178,23821
2016-03-07 19:00:00-05:00,0,3,19,0,0,2482,20077,22559
2016-03-07 20:00:00-05:00,0,3,20,0,0,1913,16621,18534
2016-03-07 21:00:00-05:00,0,3,21,0,0,1734,15959,17693
2016-03-07 22:00:00-05:00,0,3,22,0,0,1759,16816,18575
2016-03-07 23:00:00-05:00,0,3,23,0,0,1813,16843,18656
2016-03-08 00:00:00-05:00,0,3,0,1,0,2014,17915,19929
2016-03-08 01:00:00-05:00,0,3,1,1,0,2152,18430,20582
2016-03-08 02:00:00-05:00,0,3,2,1,0,2358,16811,19169
2016-03-08 03:00:00-05:00,0,3,3,1,0,2759,19991,22750
2016-03-08 04:00:00-05:00,0,3,4,1,0,2934,24616,27550
2016-03-08 05:00:00-05:00,0,3,5,1,0,2787,22575,25362
2016-03-08 06:00:00-05:00,0,3,6,1,0,2368,21357,23725
2016-03-08 07:00:00-05:00,0,3,7,1,0,2031,20074,22105
2016-03-08 08:00:00-05:00,0,3,8,1,0,1623,17248,18871
2016-03-08 09:00:00-05:00,0,3,9,1,0,1434,11962,13396
2016-03-08 10:00:00-05:00,0,3,10,1,0,1069,7359,8428
2016-03-08 11:00:00-05:00,0,3,11,1,0,620,4289,4909
2016-03-08 12:00:00-05:00,0,3,12,1,0,357,2658,3015
2016-03-08 13:00:00-05:00,0,3,13,1,0,289,1846,2135
2016-03-08 14:00:00-05:00,0,3,14,1,0,293,1921,2214
2016-03-08 15:00:00-05:00,0,3,15,1,0,319,3840,4159
2016-03-08 16:00:00-05:00,0,3,16,1,0,755,10351,11106
2016-03-08 17:00:00-05:00,0,3,17,1,0,1816,18832,20648
2016-03-08 18:00:00-05:00,0,3,18,1,0,2536,20854,23390
2016-03-08 19:00:00-05:00,0,3,19,1,0,2371,19830,22201
2016-03-08 20:00:00-05:00,0,3,20,1,0,1921,17343,19264
2016-03-08 21:00:00-05:00,0,3,21,1,0,1719,16866,18585
2016-03-08 22:00:00-05:00,0,3,22,1,0,1745,17061,18806
2016-03-08 23:00:00-05:00,0,3,23,1,0,1764,17500,19264
2016-03-09 00:00:00-05:00,0,3,0,2,0,2139,18860,20999
2016-03-09 01:00:00-05:00,0,3,1,2,0,2260,18867,21127
2016-03-09 02:00:00-05:00,0,3,2,2,0,2497,16744,19241
2016-03-09 03:00:00-05:00,0,3,3,2,0,2867,21211,24078
2016-03-09 04:00:00-05:00,0,3,4,2,0,3169,25506,28675
2016-03-09 05:00:00-05:00,0,3,5,2,0,3171,24894,28065
2016-03-09 06:00:00-05:00,0,3,6,2,0,2785,24584,27369
2016-03-09 07:00:00-05:00,0,3,7,2,0,2519,24478,26997
2016-03-09 08:00:00-05:00,0,3,8,2,0,2262,21932,24194
2016-03-09 09:00:00-05:00,0,3,9,2,0,1780,15297,17077
2016-03-09 10:00:00-05:00,0,3,10,2,0,1213,8959,10172
2016-03-09 11:00:00-05:00,0,3,11,2,0,781,5280,6061
2016-03-09 12:00:00-05:00,0,3,12,2,0,499,3322,3821
2016-03-09 13:00:00-05:00,0,3,13,2,0,344,2334,2678
2016-03-09 14:00:00-05:00,0,3,14,2,0,326,2332,2658
2016-03-09 15:00:00-05:00,0,3,15,2,0,333,4053,4386
2016-03-09 16:00:00-05:00,0,3,16,2,0,804,10873,11677
2016-03-09 17:00:00-05:00,0,3,17,2,0,1732,19214,20946
2016-03-09 18:00:00-05:00,0,3,18,2,0,2540,21409,23949
2016-03-09 19:00:00-05:00,0,3,19,2,0,2289,19562,21851
2016-03-09 20:00:00-05:00,0,3,20,2,0,1968,17109,19077
2016-03-09 21:00:00-05:00,0,3,21,2,0,1869,17360,19229
2016-03-09 22:00:00-05:00,0,3,22,2,0,1866,17812,19678
2016-03-09 23:00:00-05:00,0,3,23,2,0,2022,17852,19874
2016-03-10 00:00:00-05:00,0,3,0,3,0,2163,19613,21776
2016-03-10 01:00:00-05:00,0,3,1,3,0,2333,19137,21470
2016-03-10 02:00:00-05:00,0,3,2,3,0,2665,17505,20170
2016-03-10 03:00:00-05:00,0,3,3,3,0,3072,20640,23712
2016-03-10 04:00:00-05:00,0,3,4,3,0,3359,24954,28313
2016-03-10 05:00:00-05:00,0,3,5,3,0,3154,25307,28461
2016-03-10 06:00:00-05:00,0,3,6,3,0,2895,24237,27132
2016-03-10 07:00:00-05:00,0,3,7,3,0,2625,24714,27339
2016-03-10 08:00:00-05:00,0,3,8,3,0,2359,23126,25485
2016-03-10 09:00:00-05:00,0,3,9,3,0,2073,17867,19940
2016-03-10 10:00:00-05:00,0,3,10,3,0,1657,11799,13456
2016-03-10 11:00:00-05:00,0,3,11,3,0,1045,6728,7773
2016-03-10 12:00:00-05:00,0,3,12,3,0,656,4084,4740
2016-03-10 13:00:00-05:00,0,3,13,3,0,456,2920,3376
2016-03-10 14:00:00-05:00,0,3,14,3,0,431,2544,2975
2016-03-10 15:00:00-05:00,0,3,15,3,0,380,4358,4738
2016-03-10 16:00:00-05:00,0,3,16,3,0,831,10963,11794
2016-03-10 17:00:00-05:00,0,3,17,3,0,1867,19494,21361
2016-03-10 18:00:00-05:00,0,3,18,3,0,2563,21655,24218
2016-03-10 19:00:00-05:00,0,3,19,3,0,2395,19821,22216
2016-03-10 20:00:00-05:00,0,3,20,3,0,2040,17802,19842
2016-03-10 21:00:00-05:00,0,3,21,3,0,1962,18093,20055
2016-03-10 22:00:00-05:00,0,3,22,3,0,1988,19777,21765
2016-03-10 23:00:00-05:00,0,3,23,3,0,2010,19467,21477
2016-03-11 00:00:00-05:00,0,3,0,4,0,2267,20457,22724
2016-03-11 01:00:00-05:00,0,3,1,4,0,2412,19568,21980
2016-03-11 02:00:00-05:00,0,3,2,4,0,2765,16917,19682
2016-03-11 03:00:00-05:00,0.04,3,3,4,0,3199,21290,24489
2016-03-11 04:00:00-05:00,0,3,4,4,0,3367,25733,29100
2016-03-11 05:00:00-05:00,0,3,5,4,0,3417,26279,29696
2016-03-11 06:00:00-05:00,0,3,6,4,0,3175,25738,28913
2016-03-11 07:00:00-05:00,0,3,7,4,0,2922,25617,28539
2016-03-11 08:00:00-05:00,0,3,8,4,0,2672,23985,26657
2016-03-11 09:00:00-05:00,0,3,9,4,0,2506,21522,24028
2016-03-11 10:00:00-05:00,0,3,10,4,0,1919,15243,17162
2016-03-11 11:00:00-05:00,0,3,11,4,0,1354,9577,10931
2016-03-11 12:00:00-05:00,0,3,12,4,0,953,6451,7404
2016-03-11 13:00:00-05:00,0,3,13,4,0,685,4674,5359
2016-03-11 14:00:00-05:00,0,3,14,4,0,509,3671,4180
2016-03-11 15:00:00-05:00,0,3,15,4,0,446,4502,4948
2016-03-11 16:00:00-05:00,0,3,16,4,0,882,10950,11832
2016-03-11 17:00:00-05:00,0,3,17,4,0,1910,18811,20721
2016-03-11 18:00:00-05:00,0,3,18,4,0,2647,21745,24392
2016-03-11 19:00:00-05:00,0,3,19,4,0,2415,19704,22119
2016-03-11 20:00:00-05:00,0,3,20,4,0,2069,17602,19671
2016-03-11 21:00:00-05:00,0,3,21,4,0,1924,18032,19956
2016-03-11 22:00:00-05:00,0,3,22,4,0,1902,18641,20543
2016-03-11 23:00:00-05:00,0,3,23,4,0,1974,19090,21064
2016-03-12 00:00:00-05:00,0,3,0,5,0,2377,20511,22888
2016-03-12 01:00:00-05:00,0,3,1,5,0,2628,19224,21852
2016-03-12 02:00:00-05:00,0,3,2,5,0,3177,16840,20017
2016-03-12 03:00:00-05:00,0,3,3,5,0,3592,21697,25289
2016-03-12 04:00:00-05:00,0,3,4,5,0,4099,26565,30664
2016-03-12 05:00:00-05:00,0,3,5,5,0,4257,28049,32306
2016-03-12 06:00:00-05:00,0,3,6,5,0,4049,25790,29839
2016-03-12 07:00:00-05:00,0,3,7,5,0,4011,25625,29636
2016-03-12 08:00:00-05:00,0,3,8,5,0,3977,26281,30258
2016-03-12 09:00:00-05:00,0,3,9,5,0,4198,26013,30211
2016-03-12 10:00:00-05:00,0,3,10,5,0,3773,23726,27499
2016-03-12 11:00:00-05:00,0,3,11,5,0,3231,19752,22983
2016-03-12 12:00:00-05:00,0,3,12,5,0,2694,16197,18891
2016-03-12 13:00:00-05:00,0,3,13,5,0,2165,12053,14218
2016-03-12 14:00:00-05:00,0,3,14,5,0,1574,7692,9266
2016-03-12 15:00:00-05:00,0,3,15,5,0,790,3911,4701
2016-03-12 16:00:00-05:00,0,3,16,5,0,700,4910,5610
2016-03-12 17:00:00-05:00,0,3,17,5,0,929,6967,7896
2016-03-12 18:00:00-05:00,0,3,18,5,0,1381,11208,12589
2016-03-12 19:00:00-05:00,0,3,19,5,0,1814,15765,17579
2016-03-12 20:00:00-05:00,0,3,20,5,0,2042,18111,20153
2016-03-12 21:00:00-05:00,0,3,21,5,0,2417,19962,22379
2016-03-12 22:00:00-05:00,0,3,22,5,0,2478,21340,23818
2016-03-12 23:00:00-05:00,0,3,23,5,0,2564,21634,24198
2016-03-13 00:00:00-05:00,0,3,0,6,0,2794,21095,23889
2016-03-13 01:00:00-05:00,0,3,1,6,0,3117,22270,25387
2016-03-13 03:00:00-04:00,0,3,3,6,0,3442,20785,24227
2016-03-13 04:00:00-04:00,0,3,4,6,0,3783,23328,27111
2016-03-13 05:00:00-04:00,0,3,5,6,0,4105,26417,30522
2016-03-13 06:00:00-04:00,0,3,6,6,0,4313,27254,31567
2016-03-13 07:00:00-04:00,0,3,7,6,0,4088,23185,27273
2016-03-13 08:00:00-04:00,0,3,8,6,0,4174,22795,26969
2016-03-13 09:00:00-04:00,0,3,9,6,0,4300,25252,29552
2016-03-13 10:00:00-04:00,0,3,10,6,0,4532,26475,31007
2016-03-13 11:00:00-04:00,0,3,11,6,0,4141,24299,28440
2016-03-13 12:00:00-04:00,0,3,12,6,0,3555,21586,25141
2016-03-13 13:00:00-04:00,0,3,13,6,0,25,35,60
2016-03-13 14:00:00-04:00,0,3,14,6,0,3353,19302,22655
2016-03-13 15:00:00-04:00,0,3,15,6,0,2648,13410,16058
2016-03-13 16:00:00-04:00,0,3,16,6,0,1572,6400,7972
2016-03-13 17:00:00-04:00,0,3,17,6,0,896,4519,5415
2016-03-13 18:00:00-04:00,0,3,18,6,0,792,5653,6445
2016-03-13 19:00:00-04:00,0,3,19,6,0,915,8162,9077
2016-03-13 20:00:00-04:00,0,3,20,6,0,1279,11713,12992
2016-03-13 21:00:00-04:00,0,3,21,6,0,1644,16063,17707
2016-03-13 22:00:00-04:00,0,3,22,6,0,1946,18845,20791
2016-03-13 23:00:00-04:00,0,3,23,6,0,2082,20877,22959
2016-03-14 00:00:00-04:00,0,3,0,0,0,2146,20314,22460
2016-03-14 01:00:00-04:00,0.01,3,1,0,0,2460,21332,23792
2016-03-14 02:00:00-04:00,0,3,2,0,0,2571,20121,22692
2016-03-14 03:00:00-04:00,0,3,3,0,0,2531,19313,21844
2016-03-14 04:00:00-04:00,0,3,4,0,0,2706,19775,22481
2016-03-14 05:00:00-04:00,0.01,3,5,0,0,2840,20032,22872
2016-03-14 06:00:00-04:00,0,3,6,0,0,2695,18609,21304
2016-03-14 07:00:00-04:00,0,3,7,0,0,2709,17402,20111
2016-03-14 08:00:00-04:00,0.06,3,8,0,0,2422,15985,18407
2016-03-14 09:00:00-04:00,0.05,3,9,0,0,2151,13143,15294
2016-03-14 10:00:00-04:00,0,3,10,0,0,1660,9926,11586
2016-03-14 11:00:00-04:00,0,3,11,0,0,1287,6675,7962
2016-03-14 12:00:00-04:00,0,3,12,0,0,777,4022,4799
2016-03-14 13:00:00-04:00,0.03,3,13,0,0,527,2733,3260
2016-03-14 14:00:00-04:00,0.01,3,14,0,0,398,1809,2207
2016-03-14 15:00:00-04:00,0.01,3,15,0,0,476,2270,2746
2016-03-14 16:00:00-04:00,0,3,16,0,0,410,4133,4543
2016-03-14 17:00:00-04:00,0,3,17,0,0,741,10443,11184
2016-03-14 18:00:00-04:00,0,3,18,0,0,1762,18238,20000
2016-03-14 19:00:00-04:00,0,3,19,0,0,2965,22537,25502
2016-03-14 20:00:00-04:00,0.01,3,20,0,0,2812,21063,23875
2016-03-14 21:00:00-04:00,0,3,21,0,0,2243,18107,20350
2016-03-14 22:00:00-04:00,0,3,22,0,0,1968,17301,19269
2016-03-14 23:00:00-04:00,0,3,23,0,0,1962,17999,19961
2016-03-15 00:00:00-04:00,0,3,0,1,0,2143,20616,22759
2016-03-15 01:00:00-04:00,0,3,1,1,0,2370,21651,24021
2016-03-15 02:00:00-04:00,0,3,2,1,0,2680,21622,24302
2016-03-15 03:00:00-04:00,0,3,3,1,0,2760,18995,21755
2016-03-15 04:00:00-04:00,0,3,4,1,0,3255,22369,25624
2016-03-15 05:00:00-04:00,0,3,5,1,0,3385,26497,29882
2016-03-15 06:00:00-04:00,0,3,6,1,0,3037,25510,28547
2016-03-15 07:00:00-04:00,0,3,7,1,0,2767,24439,27206
2016-03-15 08:00:00-04:00,0,3,8,1,0,2356,22110,24466
2016-03-15 09:00:00-04:00,0,3,9,1,0,1893,19079,20972
2016-03-15 10:00:00-04:00,0,3,10,1,0,1542,13726,15268
2016-03-15 11:00:00-04:00,0,3,11,1,0,1074,8386,9460
2016-03-15 12:00:00-04:00,0,3,12,1,0,650,4814,5464
2016-03-15 13:00:00-04:00,0,3,13,1,0,369,2686,3055
2016-03-15 14:00:00-04:00,0,3,14,1,0,303,1714,2017
2016-03-15 15:00:00-04:00,0,3,15,1,0,322,2032,2354
2016-03-15 16:00:00-04:00,0,3,16,1,0,354,3882,4236
2016-03-15 17:00:00-04:00,0,3,17,1,0,669,10838,11507
2016-03-15 18:00:00-04:00,0,3,18,1,0,1742,19570,21312
2016-03-15 19:00:00-04:00,0,3,19,1,0,2701,23279,25980
2016-03-15 20:00:00-04:00,0,3,20,1,0,2544,21353,23897
2016-03-15 21:00:00-04:00,0,3,21,1,0,2143,18151,20294
2016-03-15 22:00:00-04:00,0,3,22,1,0,1767,17739,19506
2016-03-15 23:00:00-04:00,0,3,23,1,0,1834,18491,20325
2016-03-16 00:00:00-04:00,0,3,0,2,0,1879,18083,19962
2016-03-16 01:00:00-04:00,0,3,1,2,0,2106,20022,22128
2016-03-16 02:00:00-04:00,0,3,2,2,0,2303,19401,21704
2016-03-16 03:00:00-04:00,0,3,3,2,0,2508,16926,19434
2016-03-16 04:00:00-04:00,0,3,4,2,0,2782,20504,23286
2016-03-16 05:00:00-04:00,0,3,5,2,0,2967,24861,27828
2016-03-16 06:00:00-04:00,0,3,6,2,0,2828,24769,27597
2016-03-16 07:00:00-04:00,0,3,7,2,0,2552,23867,26419
2016-03-16 08:00:00-04:00,0,3,8,2,0,2391,23484,25875
2016-03-16 09:00:00-04:00,0,3,9,2,0,1995,22030,24025
2016-03-16 10:00:00-04:00,0,3,10,2,0,1724,16433,18157
2016-03-16 11:00:00-04:00,0,3,11,2,0,1267,9872,11139
2016-03-16 12:00:00-04:00,0,3,12,2,0,818,5804,6622
2016-03-16 13:00:00-04:00,0,3,13,2,0,552,3817,4369
2016-03-16 14:00:00-04:00,0,3,14,2,0,402,2494,2896
2016-03-16 15:00:00-04:00,0,3,15,2,0,400,2496,2896
2016-03-16 16:00:00-04:00,0,3,16,2,0,372,4062,4434
2016-03-16 17:00:00-04:00,0,3,17,2,0,710,10747,11457
2016-03-16 18:00:00-04:00,0.01,3,18,2,0,1758,19482,21240
2016-03-16 19:00:00-04:00,0.01,3,19,2,0,2572,22317,24889
2016-03-16 20:00:00-04:00,0,3,20,2,0,2410,20235,22645
2016-03-16 21:00:00-04:00,0,3,21,2,0,2013,18010,20023
2016-03-16 22:00:00-04:00,0,3,22,2,0,1921,18119,20040
2016-03-16 23:00:00-04:00,0,3,23,2,0,1928,18484,20412
2016-03-17 00:00:00-04:00,0,3,0,3,0,1947,18162,20109
2016-03-17 01:00:00-04:00,0,3,1,3,0,2154,19471,21625
2016-03-17 02:00:00-04:00,0,3,2,3,0,2238,19525,21763
2016-03-17 03:00:00-04:00,0,3,3,3,0,2404,16912,19316
2016-03-17 04:00:00-04:00,0,3,4,3,0,3234,21572,24806
2016-03-17 05:00:00-04:00,0,3,5,3,0,4188,28324,32512
2016-03-17 06:00:00-04:00,0,3,6,3,0,3388,25464,28852
2016-03-17 07:00:00-04:00,0,3,7,3,0,3044,25372,28416
2016-03-17 08:00:00-04:00,0,3,8,3,0,2786,25744,28530
2016-03-17 09:00:00-04:00,0,3,9,3,0,2423,23046,25469
2016-03-17 10:00:00-04:00,0,3,10,3,0,1961,18619,20580
2016-03-17 11:00:00-04:00,0,3,11,3,0,1552,11215,12767
2016-03-17 12:00:00-04:00,0,3,12,3,0,981,6455,7436
2016-03-17 13:00:00-04:00,0,3,13,3,0,615,3936,4551
2016-03-17 14:00:00-04:00,0,3,14,3,0,383,2651,3034
2016-03-17 15:00:00-04:00,0,3,15,3,0,375,2572,2947
2016-03-17 16:00:00-04:00,0,3,16,3,0,362,4157,4519
2016-03-17 17:00:00-04:00,0.04,3,17,3,0,765,10614,11379
2016-03-17 18:00:00-04:00,0,3,18,3,0,1860,18815,20675
2016-03-17 19:00:00-04:00,0,3,19,3,0,2793,21143,23936
2016-03-17 20:00:00-04:00,0,3,20,3,0,2476,19275,21751
2016-03-17 21:00:00-04:00,0,3,21,3,0,2169,16711,18880
2016-03-17 22:00:00-04:00,0,3,22,3,0,1998,16454,18452
2016-03-17 23:00:00-04:00,0,3,23,3,0,2005,16605,18610
2016-03-18 00:00:00-04:00,0,3,0,4,0,2022,17728,19750
2016-03-18 01:00:00-04:00,0,3,1,4,0,2455,19502,21957
2016-03-18 02:00:00-04:00,0,3,2,4,0,2449,17863,20312
2016-03-18 03:00:00-04:00,0,3,3,4,0,2628,15579,18207
2016-03-18 04:00:00-04:00,0,3,4,4,0,3877,21178,25055
2016-03-18 05:00:00-04:00,0,3,5,4,0,3543,24799,28342
2016-03-18 06:00:00-04:00,0,3,6,4,0,3527,27197,30724
2016-03-18 07:00:00-04:00,0,3,7,4,0,3161,27518,30679
2016-03-18 08:00:00-04:00,0,3,8,4,0,3205,27602,30807
2016-03-18 09:00:00-04:00,0,3,9,4,0,2993,26293,29286
2016-03-18 10:00:00-04:00,0,3,10,4,0,2603,23842,26445
2016-03-18 11:00:00-04:00,0,3,11,4,0,2087,18445,20532
2016-03-18 12:00:00-04:00,0,3,12,4,0,1504,12272,13776
2016-03-18 13:00:00-04:00,0,3,13,4,0,1114,8071,9185
2016-03-18 14:00:00-04:00,0,3,14,4,0,723,5348,6071
2016-03-18 15:00:00-04:00,0,3,15,4,0,602,4455,5057
2016-03-18 16:00:00-04:00,0,3,16,4,0,450,4774,5224
2016-03-18 17:00:00-04:00,0,3,17,4,0,839,10808,11647
2016-03-18 18:00:00-04:00,0,3,18,4,0,1883,19074,20957
2016-03-18 19:00:00-04:00,0,3,19,4,0,2706,22352,25058
2016-03-18 20:00:00-04:00,0,3,20,4,0,2480,20744,23224
2016-03-18 21:00:00-04:00,0,3,21,4,0,2222,18808,21030
2016-03-18 22:00:00-04:00,0,3,22,4,0,2043,18889,20932
2016-03-18 23:00:00-04:00,0,3,23,4,0,1999,19649,21648
2016-03-19 00:00:00-04:00,0,3,0,5,0,1819,19426,21245
2016-03-19 01:00:00-04:00,0,3,1,5,0,2316,22102,24418
2016-03-19 02:00:00-04:00,0,3,2,5,0,2588,19739,22327
2016-03-19 03:00:00-04:00,0,3,3,5,0,2940,17109,20049
2016-03-19 04:00:00-04:00,0,3,4,5,0,3486,21090,24576
2016-03-19 05:00:00-04:00,0,3,5,5,0,3834,25506,29340
2016-03-19 06:00:00-04:00,0,3,6,5,0,4043,27704,31747
2016-03-19 07:00:00-04:00,0,3,7,5,0,4025,25350,29375
2016-03-19 08:00:00-04:00,0,3,8,5,0,3885,24547,28432
2016-03-19 09:00:00-04:00,0,3,9,5,0,4023,25218,29241
2016-03-19 10:00:00-04:00,0,3,10,5,0,4088,25236,29324
2016-03-19 11:00:00-04:00,0,3,11,5,0,3845,23495,27340
2016-03-19 12:00:00-04:00,0,3,12,5,0,3144,19196,22340
2016-03-19 13:00:00-04:00,0,3,13,5,0,2526,15680,18206
2016-03-19 14:00:00-04:00,0,3,14,5,0,2014,11297,13311
2016-03-19 15:00:00-04:00,0,3,15,5,0,1547,7382,8929
2016-03-19 16:00:00-04:00,0,3,16,5,0,764,3637,4401
2016-03-19 17:00:00-04:00,0,3,17,5,0,629,4945,5574
2016-03-19 18:00:00-04:00,0,3,18,5,0,871,7174,8045
2016-03-19 19:00:00-04:00,0,3,19,5,0,1268,10889,12157
2016-03-19 20:00:00-04:00,0,3,20,5,0,1764,14812,16576
2016-03-19 21:00:00-04:00,0,3,21,5,0,2049,18544,20593
2016-03-19 22:00:00-04:00,0,3,22,5,0,2178,20703,22881
2016-03-19 23:00:00-04:00,0,3,23,5,0,2383,21969,24352
2016-03-20 00:00:00-04:00,0,3,0,6,0,2428,22733,25161
2016-03-20 01:00:00-04:00,0,3,1,6,0,2645,22590,25235
2016-03-20 02:00:00-04:00,0,3,2,6,0,2936,22082,25018
2016-03-20 03:00:00-04:00,0,3,3,6,0,3095,20281,23376
2016-03-20 04:00:00-04:00,0,3,4,6,0,3381,23044,26425
2016-03-20 05:00:00-04:00,0,3,5,6,0,3675,25900,29575
2016-03-20 06:00:00-04:00,0,3,6,6,0,4079,27549,31628
2016-03-20 07:00:00-04:00,0,3,7,6,0,4121,23372,27493
2016-03-20 08:00:00-04:00,0,3,8,6,0,4096,23238,27334
2016-03-20 09:00:00-04:00,0,3,9,6,0,4261,24581,28842
2016-03-20 10:00:00-04:00,0,3,10,6,0,4660,27092,31752
2016-03-20 11:00:00-04:00,0,3,11,6,0,4356,25099,29455
2016-03-20 12:00:00-04:00,0,3,12,6,0,3940,22379,26319
2016-03-20 13:00:00-04:00,0,3,13,6,0,3211,19028,22239
2016-03-20 14:00:00-04:00,0,3,14,6,0,2655,14539,17194
2016-03-20 15:00:00-04:00,0,3,15,6,0,1998,9086,11084
2016-03-20 16:00:00-04:00,0,3,16,6,0,1052,4186,5238
2016-03-20 17:00:00-04:00,0,3,17,6,0,772,5992,6764
2016-03-20 18:00:00-04:00,0,3,18,6,0,729,6406,7135
2016-03-20 19:00:00-04:00,0,3,19,6,0,1017,8560,9577
2016-03-20 20:00:00-04:00,0,3,20,6,0,1409,12544,13953
2016-03-20 21:00:00-04:00,0,3,21,6,0,1895,17289,19184
2016-03-20 22:00:00-04:00,0.02,3,22,6,0,2220,20225,22445
2016-03-20 23:00:00-04:00,0.02,3,23,6,0,2367,22265,24632
2016-03-21 00:00:00-04:00,0.02,3,0,0,0,2368,21449,23817
2016-03-21 01:00:00-04:00,0.03,3,1,0,0,2500,20703,23203
2016-03-21 02:00:00-04:00,0.01,3,2,0,0,2617,19460,22077
2016-03-21 03:00:00-04:00,0.02,3,3,0,0,2666,19618,22284
2016-03-21 04:00:00-04:00,0.02,3,4,0,0,2914,21702,24616
2016-03-21 05:00:00-04:00,0,3,5,0,0,2937,21126,24063
2016-03-21 06:00:00-04:00,0,3,6,0,0,2829,18779,21608
2016-03-21 07:00:00-04:00,0,3,7,0,0,2732,17225,19957
2016-03-21 08:00:00-04:00,0,3,8,0,0,2451,17368,19819
2016-03-21 09:00:00-04:00,0,3,9,0,0,2188,14167,16355
2016-03-21 10:00:00-04:00,0,3,10,0,0,1793,10449,12242
2016-03-21 11:00:00-04:00,0,3,11,0,0,1263,7013,8276
2016-03-21 12:00:00-04:00,0,3,12,0,0,754,3929,4683
2016-03-21 13:00:00-04:00,0,3,13,0,0,474,2473,2947
2016-03-21 14:00:00-04:00,0,3,14,0,0,397,1832,2229
2016-03-21 15:00:00-04:00,0,3,15,0,0,421,2330,2751
2016-03-21 16:00:00-04:00,0,3,16,0,0,405,4087,4492
2016-03-21 17:00:00-04:00,0,3,17,0,0,720,10576,11296
2016-03-21 18:00:00-04:00,0,3,18,0,0,1758,17010,18768
2016-03-21 19:00:00-04:00,0,3,19,0,0,2617,20192,22809
2016-03-21 20:00:00-04:00,0,3,20,0,0,2449,18650,21099
2016-03-21 21:00:00-04:00,0,3,21,0,0,1977,16049,18026
2016-03-21 22:00:00-04:00,0,3,22,0,0,1770,16158,17928
2016-03-21 23:00:00-04:00,0,3,23,0,0,1753,16541,18294
2016-03-22 00:00:00-04:00,0,3,0,1,0,1761,16354,18115
2016-03-22 01:00:00-04:00,0,3,1,1,0,1928,17334,19262
2016-03-22 02:00:00-04:00,0,3,2,1,0,2136,17317,19453
2016-03-22 03:00:00-04:00,0,3,3,1,0,2253,16676,18929
2016-03-22 04:00:00-04:00,0,3,4,1,0,2776,19913,22689
2016-03-22 05:00:00-04:00,0,3,5,1,0,2925,23583,26508
2016-03-22 06:00:00-04:00,0,3,6,1,0,2890,22447,25337
2016-03-22 07:00:00-04:00,0,3,7,1,0,2576,21710,24286
2016-03-22 08:00:00-04:00,0,3,8,1,0,2241,21168,23409
2016-03-22 09:00:00-04:00,0,3,9,1,0,1941,17989,19930
2016-03-22 10:00:00-04:00,0,3,10,1,0,1551,12991,14542
2016-03-22 11:00:00-04:00,0,3,11,1,0,1212,8775,9987
2016-03-22 12:00:00-04:00,0,3,12,1,0,792,4578,5370
2016-03-22 13:00:00-04:00,0,3,13,1,0,430,2777,3207
2016-03-22 14:00:00-04:00,0,3,14,1,0,339,1949,2288
2016-03-22 15:00:00-04:00,0,3,15,1,0,334,2073,2407
2016-03-22 16:00:00-04:00,0,3,16,1,0,362,3721,4083
2016-03-22 17:00:00-04:00,0,3,17,1,0,741,10357,11098
2016-03-22 18:00:00-04:00,0,3,18,1,0,1732,17874,19606
2016-03-22 19:00:00-04:00,0,3,19,1,0,2865,22415,25280
2016-03-22 20:00:00-04:00,0,3,20,1,0,2717,20554,23271
2016-03-22 21:00:00-04:00,0,3,21,1,0,1958,17897,19855
2016-03-22 22:00:00-04:00,0,3,22,1,0,1805,17119,18924
2016-03-22 23:00:00-04:00,0,3,23,1,0,1812,17563,19375
2016-03-23 00:00:00-04:00,0,3,0,2,0,1752,17272,19024
2016-03-23 01:00:00-04:00,0,3,1,2,0,2062,18136,20198
2016-03-23 02:00:00-04:00,0,3,2,2,0,2159,17665,19824
2016-03-23 03:00:00-04:00,0,3,3,2,0,2338,15881,18219
2016-03-23 04:00:00-04:00,0,3,4,2,0,2668,19165,21833
2016-03-23 05:00:00-04:00,0,3,5,2,0,3008,23497,26505
2016-03-23 06:00:00-04:00,0,3,6,2,0,2972,23712,26684
2016-03-23 07:00:00-04:00,0,3,7,2,0,2720,23478,26198
2016-03-23 08:00:00-04:00,0,3,8,2,0,2535,23919,26454
2016-03-23 09:00:00-04:00,0,3,9,2,0,2162,20694,22856
2016-03-23 10:00:00-04:00,0,3,10,2,0,1818,15680,17498
2016-03-23 11:00:00-04:00,0,3,11,2,0,1310,9674,10984
2016-03-23 12:00:00-04:00,0,3,12,2,0,845,5865,6710
2016-03-23 13:00:00-04:00,0,3,13,2,0,493,3545,4038
2016-03-23 14:00:00-04:00,0,3,14,2,0,358,2435,2793
2016-03-23 15:00:00-04:00,0,3,15,2,0,383,2492,2875
2016-03-23 16:00:00-04:00,0,3,16,2,0,350,3889,4239
2016-03-23 17:00:00-04:00,0,3,17,2,0,720,10019,10739
2016-03-23 18:00:00-04:00,0,3,18,2,0,1722,17381,19103
2016-03-23 19:00:00-04:00,0,3,19,2,0,2639,21570,24209
2016-03-23 20:00:00-04:00,0,3,20,2,0,2388,20087,22475
2016-03-23 21:00:00-04:00,0,3,21,2,0,1995,17951,19946
2016-03-23 22:00:00-04:00,0,3,22,2,0,1871,17557,19428
2016-03-23 23:00:00-04:00,0,3,23,2,0,1719,18134,19853
2016-03-24 00:00:00-04:00,0,3,0,3,0,1907,18371,20278
2016-03-24 01:00:00-04:00,0,3,1,3,0,2082,18563,20645
2016-03-24 02:00:00-04:00,0,3,2,3,0,2232,17891,20123
2016-03-24 03:00:00-04:00,0,3,3,3,0,2417,16157,18574
2016-03-24 04:00:00-04:00,0,3,4,3,0,2752,19546,22298
2016-03-24 05:00:00-04:00,0,3,5,3,0,3210,23972,27182
2016-03-24 06:00:00-04:00,0,3,6,3,0,2979,25219,28198
2016-03-24 07:00:00-04:00,0,3,7,3,0,2932,24304,27236
2016-03-24 08:00:00-04:00,0,3,8,3,0,2729,24886,27615
2016-03-24 09:00:00-04:00,0,3,9,3,0,2480,23218,25698
2016-03-24 10:00:00-04:00,0,3,10,3,0,2117,19013,21130
2016-03-24 11:00:00-04:00,0,3,11,3,0,1667,12335,14002
2016-03-24 12:00:00-04:00,0,3,12,3,0,1167,7505,8672
2016-03-24 13:00:00-04:00,0,3,13,3,0,787,4815,5602
2016-03-24 14:00:00-04:00,0,3,14,3,0,546,3208,3754
2016-03-24 15:00:00-04:00,0,3,15,3,0,460,2847,3307
2016-03-24 16:00:00-04:00,0,3,16,3,0,354,3928,4282
2016-03-24 17:00:00-04:00,0,3,17,3,0,720,10244,10964
2016-03-24 18:00:00-04:00,0,3,18,3,0,1711,17785,19496
2016-03-24 19:00:00-04:00,0,3,19,3,0,2588,21919,24507
2016-03-24 20:00:00-04:00,0,3,20,3,0,2487,20479,22966
2016-03-24 21:00:00-04:00,0,3,21,3,0,2158,18523,20681
2016-03-24 22:00:00-04:00,0,3,22,3,0,2027,18697,20724
2016-03-24 23:00:00-04:00,0,3,23,3,0,1925,19331,21256
2016-03-25 00:00:00-04:00,0,3,0,4,0,1914,19128,21042
2016-03-25 01:00:00-04:00,0,3,1,4,0,2200,20120,22320
2016-03-25 02:00:00-04:00,0,3,2,4,0,2576,18838,21414
2016-03-25 03:00:00-04:00,0,3,3,4,0,2796,16023,18819
2016-03-25 04:00:00-04:00,0,3,4,4,0,3392,19940,23332
2016-03-25 05:00:00-04:00,0,3,5,4,0,3903,25355,29258
2016-03-25 06:00:00-04:00,0,3,6,4,0,3667,26510,30177
2016-03-25 07:00:00-04:00,0,3,7,4,0,3356,25948,29304
2016-03-25 08:00:00-04:00,0,3,8,4,0,3376,26266,29642
2016-03-25 09:00:00-04:00,0,3,9,4,0,2960,24765,27725
2016-03-25 10:00:00-04:00,0,3,10,4,0,2717,22526,25243
2016-03-25 11:00:00-04:00,0,3,11,4,0,2138,18953,21091
2016-03-25 12:00:00-04:00,0.04,3,12,4,0,1573,12555,14128
2016-03-25 13:00:00-04:00,0.07,3,13,4,0,1151,8564,9715
2016-03-25 14:00:00-04:00,0,3,14,4,0,797,5646,6443
2016-03-25 15:00:00-04:00,0,3,15,4,0,636,4538,5174
2016-03-25 16:00:00-04:00,0,3,16,4,0,401,3870,4271
2016-03-25 17:00:00-04:00,0,3,17,4,0,593,6978,7571
2016-03-25 18:00:00-04:00,0,3,18,4,0,1095,10310,11405
2016-03-25 19:00:00-04:00,0,3,19,4,0,1865,15613,17478
2016-03-25 20:00:00-04:00,0,3,20,4,0,2148,17631,19779
2016-03-25 21:00:00-04:00,0,3,21,4,0,1810,17176,18986
2016-03-25 22:00:00-04:00,0,3,22,4,0,1862,18380,20242
2016-03-25 23:00:00-04:00,0,3,23,4,0,1897,21242,23139
2016-03-26 00:00:00-04:00,0,3,0,5,0,1729,19007,20736
2016-03-26 01:00:00-04:00,0,3,1,5,0,2078,20150,22228
2016-03-26 02:00:00-04:00,0,3,2,5,0,2415,19966,22381
2016-03-26 03:00:00-04:00,0,3,3,5,0,2673,17984,20657
2016-03-26 04:00:00-04:00,0,3,4,5,0,3137,20939,24076
2016-03-26 05:00:00-04:00,0,3,5,5,0,3448,23791,27239
2016-03-26 06:00:00-04:00,0,3,6,5,0,3667,24521,28188
2016-03-26 07:00:00-04:00,0,3,7,5,0,3505,21948,25453
2016-03-26 08:00:00-04:00,0,3,8,5,0,3543,22044,25587
2016-03-26 09:00:00-04:00,0,3,9,5,0,3776,23643,27419
2016-03-26 10:00:00-04:00,0,3,10,5,0,3946,24302,28248
2016-03-26 11:00:00-04:00,0,3,11,5,0,3965,23426,27391
2016-03-26 12:00:00-04:00,0,3,12,5,0,3451,19858,23309
2016-03-26 13:00:00-04:00,0,3,13,5,0,2847,16210,19057
2016-03-26 14:00:00-04:00,0,3,14,5,0,2154,12248,14402
2016-03-26 15:00:00-04:00,0,3,15,5,0,1699,7689,9388
2016-03-26 16:00:00-04:00,0,3,16,5,0,752,3539,4291
2016-03-26 17:00:00-04:00,0,3,17,5,0,600,4424,5024
2016-03-26 18:00:00-04:00,0,3,18,5,0,739,5995,6734
2016-03-26 19:00:00-04:00,0,3,19,5,0,1089,9028,10117
2016-03-26 20:00:00-04:00,0,3,20,5,0,1524,12916,14440
2016-03-26 21:00:00-04:00,0,3,21,5,0,1720,16092,17812
2016-03-26 22:00:00-04:00,0,3,22,5,0,2057,18338,20395
2016-03-26 23:00:00-04:00,0,3,23,5,0,2227,19582,21809
2016-03-27 00:00:00-04:00,0,3,0,6,0,2245,19933,22178
2016-03-27 01:00:00-04:00,0,3,1,6,0,2573,18991,21564
2016-03-27 02:00:00-04:00,0,3,2,6,0,2733,19701,22434
2016-03-27 03:00:00-04:00,0,3,3,6,0,3007,18915,21922
2016-03-27 04:00:00-04:00,0,3,4,6,0,3414,21327,24741
2016-03-27 05:00:00-04:00,0,3,5,6,0,3620,23540,27160
2016-03-27 06:00:00-04:00,0,3,6,6,0,3898,24580,28478
2016-03-27 07:00:00-04:00,0,3,7,6,0,4079,21412,25491
2016-03-27 08:00:00-04:00,0,3,8,6,0,4035,21081,25116
2016-03-27 09:00:00-04:00,0,3,9,6,0,3963,22098,26061
2016-03-27 10:00:00-04:00,0,3,10,6,0,4222,22976,27198
2016-03-27 11:00:00-04:00,0,3,11,6,0,3809,20730,24539
2016-03-27 12:00:00-04:00,0,3,12,6,0,3430,17880,21310
2016-03-27 13:00:00-04:00,0,3,13,6,0,2952,14945,17897
2016-03-27 14:00:00-04:00,0,3,14,6,0,2353,11588,13941
2016-03-27 15:00:00-04:00,0,3,15,6,0,1832,7693,9525
2016-03-27 16:00:00-04:00,0,3,16,6,0,855,3308,4163
2016-03-27 17:00:00-04:00,0,3,17,6,0,604,3468,4072
2016-03-27 18:00:00-04:00,0,3,18,6,0,666,4877,5543
2016-03-27 19:00:00-04:00,0,3,19,6,0,890,7478,8368
2016-03-27 20:00:00-04:00,0,3,20,6,0,1321,11177,12498
2016-03-27 21:00:00-04:00,0,3,21,6,0,1831,16589,18420
2016-03-27 22:00:00-04:00,0,3,22,6,0,2091,17453,19544
2016-03-27 23:00:00-04:00,0,3,23,6,0,2146,18383,20529
2016-03-28 00:00:00-04:00,0,3,0,0,0,2172,18375,20547
2016-03-28 01:00:00-04:00,0,3,1,0,0,2385,18319,20704
2016-03-28 02:00:00-04:00,0,3,2,0,0,2595,17583,20178
2016-03-28 03:00:00-04:00,0,3,3,0,0,2843,17879,20722
2016-03-28 04:00:00-04:00,0.03,3,4,0,0,2747,18432,21179
2016-03-28 05:00:00-04:00,0.02,3,5,0,0,2903,19410,22313
2016-03-28 06:00:00-04:00,0.02,3,6,0,0,2894,18624,21518
2016-03-28 07:00:00-04:00,0.12,3,7,0,0,2779,18004,20783
2016-03-28 08:00:00-04:00,0.05,3,8,0,0,2679,16461,19140
2016-03-28 09:00:00-04:00,0.08,3,9,0,0,2374,15131,17505
2016-03-28 10:00:00-04:00,0.16,3,10,0,0,2086,11790,13876
2016-03-28 11:00:00-04:00,0.03,3,11,0,0,1426,7249,8675
2016-03-28 12:00:00-04:00,0,3,12,0,0,845,4359,5204
2016-03-28 13:00:00-04:00,0,3,13,0,0,593,2699,3292
2016-03-28 14:00:00-04:00,0,3,14,0,0,427,2028,2455
2016-03-28 15:00:00-04:00,0,3,15,0,0,437,2311,2748
2016-03-28 16:00:00-04:00,0,3,16,0,0,402,4054,4456
2016-03-28 17:00:00-04:00,0,3,17,0,0,712,10533,11245
2016-03-28 18:00:00-04:00,0,3,18,0,0,1877,18012,19889
2016-03-28 19:00:00-04:00,0,3,19,0,0,2767,21362,24129
2016-03-28 20:00:00-04:00,0,3,20,0,0,2703,20854,23557
2016-03-28 21:00:00-04:00,0,3,21,0,0,2165,19096,21261
2016-03-28 22:00:00-04:00,0,3,22,0,0,1792,16886,18678
2016-03-28 23:00:00-04:00,0,3,23,0,0,1688,16445,18133
2016-03-29 00:00:00-04:00,0,3,0,1,0,1684,16416,18100
2016-03-29 01:00:00-04:00,0,3,1,1,0,1912,17056,18968
2016-03-29 02:00:00-04:00,0,3,2,1,0,1980,16304,18284
2016-03-29 03:00:00-04:00,0,3,3,1,0,2167,15679,17846
2016-03-29 04:00:00-04:00,0,3,4,1,0,2481,18851,21332
2016-03-29 05:00:00-04:00,0,3,5,1,0,2851,22147,24998
2016-03-29 06:00:00-04:00,0,3,6,1,0,2637,21820,24457
2016-03-29 07:00:00-04:00,0,3,7,1,0,2461,20525,22986
2016-03-29 08:00:00-04:00,0,3,8,1,0,2085,18996,21081
2016-03-29 09:00:00-04:00,0,3,9,1,0,1937,17247,19184
2016-03-29 10:00:00-04:00,0,3,10,1,0,1606,13705,15311
2016-03-29 11:00:00-04:00,0,3,11,1,0,1205,9381,10586
2016-03-29 12:00:00-04:00,0,3,12,1,0,705,5649,6354
2016-03-29 13:00:00-04:00,0,3,13,1,0,441,2977,3418
2016-03-29 14:00:00-04:00,0,3,14,1,0,298,1930,2228
2016-03-29 15:00:00-04:00,0,3,15,1,0,293,1987,2280
2016-03-29 16:00:00-04:00,0,3,16,1,0,328,3727,4055
2016-03-29 17:00:00-04:00,0,3,17,1,0,699,9966,10665
2016-03-29 18:00:00-04:00,0,3,18,1,0,1729,16729,18458
2016-03-29 19:00:00-04:00,0,3,19,1,0,2521,20993,23514
2016-03-29 20:00:00-04:00,0,3,20,1,0,2482,19864,22346
2016-03-29 21:00:00-04:00,0,3,21,1,0,2074,17603,19677
2016-03-29 22:00:00-04:00,0,3,22,1,0,1840,17539,19379
2016-03-29 23:00:00-04:00,0,3,23,1,0,1800,18162,19962
2016-03-30 00:00:00-04:00,0,3,0,2,0,1734,17638,19372
2016-03-30 01:00:00-04:00,0,3,1,2,0,1931,18665,20596
2016-03-30 02:00:00-04:00,0,3,2,2,0,2241,18087,20328
2016-03-30 03:00:00-04:00,0,3,3,2,0,2389,16375,18764
2016-03-30 04:00:00-04:00,0,3,4,2,0,2633,20263,22896
2016-03-30 05:00:00-04:00,0,3,5,2,0,3232,25558,28790
2016-03-30 06:00:00-04:00,0,3,6,2,0,3162,25772,28934
2016-03-30 07:00:00-04:00,0,3,7,2,0,2891,25529,28420
2016-03-30 08:00:00-04:00,0,3,8,2,0,2707,25062,27769
2016-03-30 09:00:00-04:00,0,3,9,2,0,2397,22327,24724
2016-03-30 10:00:00-04:00,0,3,10,2,0,2056,16577,18633
2016-03-30 11:00:00-04:00,0,3,11,2,0,1455,10131,11586
2016-03-30 12:00:00-04:00,0,3,12,2,0,900,5779,6679
2016-03-30 13:00:00-04:00,0,3,13,2,0,544,3543,4087
2016-03-30 14:00:00-04:00,0,3,14,2,0,399,2357,2756
2016-03-30 15:00:00-04:00,0,3,15,2,0,387,2340,2727
2016-03-30 16:00:00-04:00,0,3,16,2,0,360,3750,4110
2016-03-30 17:00:00-04:00,0,3,17,2,0,703,10103,10806
2016-03-30 18:00:00-04:00,0,3,18,2,0,1683,17226,18909
2016-03-30 19:00:00-04:00,0,3,19,2,0,2477,21590,24067
2016-03-30 20:00:00-04:00,0,3,20,2,0,2380,20168,22548
2016-03-30 21:00:00-04:00,0,3,21,2,0,2105,18137,20242
2016-03-30 22:00:00-04:00,0,3,22,2,0,1892,17561,19453
2016-03-30 23:00:00-04:00,0,3,23,2,0,1810,18079,19889
2016-03-31 00:00:00-04:00,0,3,0,3,0,1840,18287,20127
2016-03-31 01:00:00-04:00,0,3,1,3,0,2016,18280,20296
2016-03-31 02:00:00-04:00,0,3,2,3,0,2177,18018,20195
2016-03-31 03:00:00-04:00,0,3,3,3,0,2555,16404,18959
2016-03-31 04:00:00-04:00,0,3,4,3,0,2945,20030,22975
2016-03-31 05:00:00-04:00,0,3,5,3,0,3336,24451,27787
2016-03-31 06:00:00-04:00,0,3,6,3,0,3247,25551,28798
2016-03-31 07:00:00-04:00,0,3,7,3,0,3075,25686,28761
2016-03-31 08:00:00-04:00,0,3,8,3,0,2774,25287,28061
2016-03-31 09:00:00-04:00,0,3,9,3,0,2627,23475,26102
2016-03-31 10:00:00-04:00,0,3,10,3,0,2364,19236,21600
2016-03-31 11:00:00-04:00,0,3,11,3,0,1561,11690,13251
2016-03-31 12:00:00-04:00,0,3,12,3,0,947,6615,7562
2016-03-31 13:00:00-04:00,0,3,13,3,0,605,4257,4862
2016-03-31 14:00:00-04:00,0,3,14,3,0,437,2769,3206
2016-03-31 15:00:00-04:00,0,3,15,3,0,413,2609,3022
2016-03-31 16:00:00-04:00,0,3,16,3,0,360,3942,4302
2016-03-31 17:00:00-04:00,0,3,17,3,0,783,10142,10925
2016-03-31 18:00:00-04:00,0,3,18,3,0,1859,17395,19254
2016-03-31 19:00:00-04:00,0,3,19,3,0,2687,21018,23705
2016-03-31 20:00:00-04:00,0,3,20,3,0,2452,19776,22228
2016-03-31 21:00:00-04:00,0,3,21,3,0,2040,17731,19771
2016-03-31 22:00:00-04:00,0,3,22,3,0,1837,17280,19117
2016-03-31 23:00:00-04:00,0,3,23,3,0,1986,18245,20231
2016-04-01 00:00:00-04:00,0,4,0,4,0,1913,18623,20536
2016-04-01 01:00:00-04:00,0,4,1,4,0,2190,19771,21961
2016-04-01 02:00:00-04:00,0,4,2,4,0,2363,18352,20715
2016-04-01 03:00:00-04:00,0,4,3,4,0,2668,15905,18573
2016-04-01 04:00:00-04:00,0,4,4,4,0,3051,19646,22697
2016-04-01 05:00:00-04:00,0,4,5,4,0,3314,24722,28036
2016-04-01 06:00:00-04:00,0,4,6,4,0,3150,25508,28658
2016-04-01 07:00:00-04:00,0,4,7,4,0,3072,25498,28570
2016-04-01 08:00:00-04:00,0,4,8,4,0,2978,26045,29023
2016-04-01 09:00:00-04:00,0,4,9,4,0,2904,24901,27805
2016-04-01 10:00:00-04:00,0,4,10,4,0,2582,21615,24197
2016-04-01 11:00:00-04:00,0,4,11,4,0,1918,15843,17761
2016-04-01 12:00:00-04:00,0,4,12,4,0,1302,10348,11650
2016-04-01 13:00:00-04:00,0,4,13,4,0,935,6594,7529
2016-04-01 14:00:00-04:00,0,4,14,4,0,641,4682,5323
2016-04-01 15:00:00-04:00,0,4,15,4,0,528,3751,4279
2016-04-01 16:00:00-04:00,0,4,16,4,0,418,4256,4674
2016-04-01 17:00:00-04:00,0,4,17,4,0,821,10081,10902
2016-04-01 18:00:00-04:00,0,4,18,4,0,1820,17360,19180
2016-04-01 19:00:00-04:00,0.01,4,19,4,0,2682,21563,24245
2016-04-01 20:00:00-04:00,0,4,20,4,0,2602,20114,22716
2016-04-01 21:00:00-04:00,0,4,21,4,0,2221,17708,19929
2016-04-01 22:00:00-04:00,0,4,22,4,0,2084,17786,19870
2016-04-01 23:00:00-04:00,0,4,23,4,0,1988,18998,20986
2016-04-02 00:00:00-04:00,0,4,0,5,0,1796,17813,19609
2016-04-02 01:00:00-04:00,0,4,1,5,0,2317,19308,21625
2016-04-02 02:00:00-04:00,0,4,2,5,0,2698,18652,21350
2016-04-02 03:00:00-04:00,0,4,3,5,0,3122,16494,19616
2016-04-02 04:00:00-04:00,0,4,4,5,0,3506,20772,24278
2016-04-02 05:00:00-04:00,0,4,5,5,0,4426,26843,31269
2016-04-02 06:00:00-04:00,0,4,6,5,0,4216,26723,30939
2016-04-02 07:00:00-04:00,0,4,7,5,0,3791,23842,27633
2016-04-02 08:00:00-04:00,0.01,4,8,5,0,3609,22867,26476
2016-04-02 09:00:00-04:00,0.05,4,9,5,0,3644,24330,27974
2016-04-02 10:00:00-04:00,0.06,4,10,5,0,3939,25003,28942
2016-04-02 11:00:00-04:00,0.01,4,11,5,0,3710,23231,26941
2016-04-02 12:00:00-04:00,0,4,12,5,0,3248,20676,23924
2016-04-02 13:00:00-04:00,0,4,13,5,0,2746,17377,20123
2016-04-02 14:00:00-04:00,0,4,14,5,0,2237,13111,15348
2016-04-02 15:00:00-04:00,0,4,15,5,0,1664,7950,9614
2016-04-02 16:00:00-04:00,0,4,16,5,0,786,3692,4478
2016-04-02 17:00:00-04:00,0,4,17,5,0,726,5112,5838
2016-04-02 18:00:00-04:00,0,4,18,5,0,901,7575,8476
2016-04-02 19:00:00-04:00,0,4,19,5,0,1415,11440,12855
2016-04-02 20:00:00-04:00,0,4,20,5,0,2000,18012,20012
2016-04-02 21:00:00-04:00,0,4,21,5,0,2368,21002,23370
2016-04-02 22:00:00-04:00,0,4,22,5,0,2354,20991,23345
2016-04-02 23:00:00-04:00,0,4,23,5,0,2477,21707,24184
2016-04-03 00:00:00-04:00,0,4,0,6,0,2520,21992,24512
2016-04-03 01:00:00-04:00,0.08,4,1,6,0,2719,20557,23276
2016-04-03 02:00:00-04:00,0,4,2,6,0,2852,20471,23323
2016-04-03 03:00:00-04:00,0.01,4,3,6,0,3018,18759,21777
2016-04-03 04:00:00-04:00,0,4,4,6,0,3383,21855,25238
2016-04-03 05:00:00-04:00,0.02,4,5,6,0,3746,24998,28744
2016-04-03 06:00:00-04:00,0,4,6,6,0,4119,25581,29700
2016-04-03 07:00:00-04:00,0,4,7,6,0,4131,23721,27852
2016-04-03 08:00:00-04:00,0,4,8,6,0,4047,22545,26592
2016-04-03 09:00:00-04:00,0,4,9,6,0,4304,25115,29419
2016-04-03 10:00:00-04:00,0,4,10,6,0,4626,27394,32020
2016-04-03 11:00:00-04:00,0,4,11,6,0,4521,25819,30340
2016-04-03 12:00:00-04:00,0,4,12,6,0,4225,22670,26895
2016-04-03 13:00:00-04:00,0,4,13,6,0,3323,18863,22186
2016-04-03 14:00:00-04:00,0,4,14,6,0,2584,14325,16909
2016-04-03 15:00:00-04:00,0,4,15,6,0,1957,9055,11012
2016-04-03 16:00:00-04:00,0,4,16,6,0,938,3791,4729
2016-04-03 17:00:00-04:00,0,4,17,6,0,681,3960,4641
2016-04-03 18:00:00-04:00,0,4,18,6,0,764,5366,6130
2016-04-03 19:00:00-04:00,0,4,19,6,0,992,8166,9158
2016-04-03 20:00:00-04:00,0,4,20,6,0,1429,13063,14492
2016-04-03 21:00:00-04:00,0,4,21,6,0,1854,18190,20044
2016-04-03 22:00:00-04:00,0,4,22,6,0,2129,21508,23637
2016-04-03 23:00:00-04:00,0,4,23,6,0,2402,23360,25762
2016-04-04 00:00:00-04:00,0,4,0,0,0,2334,23123,25457
2016-04-04 01:00:00-04:00,0,4,1,0,0,2595,22519,25114
2016-04-04 02:00:00-04:00,0,4,2,0,0,2831,20871,23702
2016-04-04 03:00:00-04:00,0,4,3,0,0,2822,19645,22467
2016-04-04 04:00:00-04:00,0,4,4,0,0,2851,20065,22916
2016-04-04 05:00:00-04:00,0,4,5,0,0,3047,20647,23694
2016-04-04 06:00:00-04:00,0,4,6,0,0,2914,18844,21758
2016-04-04 07:00:00-04:00,0,4,7,0,0,2679,17483,20162
2016-04-04 08:00:00-04:00,0.02,4,8,0,0,2275,15619,17894
2016-04-04 09:00:00-04:00,0.01,4,9,0,0,2163,14106,16269
2016-04-04 10:00:00-04:00,0.04,4,10,0,0,1790,11242,13032
2016-04-04 11:00:00-04:00,0.02,4,11,0,0,1265,7563,8828
2016-04-04 12:00:00-04:00,0.03,4,12,0,0,815,4240,5055
2016-04-04 13:00:00-04:00,0.03,4,13,0,0,513,2596,3109
2016-04-04 14:00:00-04:00,0.14,4,14,0,0,417,1850,2267
2016-04-04 15:00:00-04:00,0.06,4,15,0,0,431,2157,2588
2016-04-04 16:00:00-04:00,0.07,4,16,0,0,439,3996,4435
2016-04-04 17:00:00-04:00,0.08,4,17,0,0,823,10717,11540
2016-04-04 18:00:00-04:00,0,4,18,0,0,1929,18689,20618
2016-04-04 19:00:00-04:00,0,4,19,0,0,2822,21694,24516
2016-04-04 20:00:00-04:00,0,4,20,0,0,2696,20747,23443
2016-04-04 21:00:00-04:00,0,4,21,0,0,2102,17054,19156
2016-04-04 22:00:00-04:00,0,4,22,0,0,1962,17569,19531
2016-04-04 23:00:00-04:00,0,4,23,0,0,1944,18085,20029
2016-04-05 00:00:00-04:00,0,4,0,1,0,1959,17876,19835
2016-04-05 01:00:00-04:00,0,4,1,1,0,2502,21547,24049
2016-04-05 02:00:00-04:00,0,4,2,1,0,2662,19971,22633
2016-04-05 03:00:00-04:00,0,4,3,1,0,2960,18452,21412
2016-04-05 04:00:00-04:00,0,4,4,1,0,3436,23079,26515
2016-04-05 05:00:00-04:00,0,4,5,1,0,3284,25036,28320
2016-04-05 06:00:00-04:00,0,4,6,1,0,2930,24428,27358
2016-04-05 07:00:00-04:00,0,4,7,1,0,2687,23357,26044
2016-04-05 08:00:00-04:00,0,4,8,1,0,2340,21147,23487
2016-04-05 09:00:00-04:00,0,4,9,1,0,2029,18090,20119
2016-04-05 10:00:00-04:00,0,4,10,1,0,1693,15007,16700
2016-04-05 11:00:00-04:00,0,4,11,1,0,1209,9490,10699
2016-04-05 12:00:00-04:00,0,4,12,1,0,781,5072,5853
2016-04-05 13:00:00-04:00,0,4,13,1,0,429,2904,3333
2016-04-05 14:00:00-04:00,0,4,14,1,0,312,1967,2279
2016-04-05 15:00:00-04:00,0,4,15,1,0,343,2044,2387
2016-04-05 16:00:00-04:00,0,4,16,1,0,356,3992,4348
2016-04-05 17:00:00-04:00,0,4,17,1,0,774,11220,11994
2016-04-05 18:00:00-04:00,0,4,18,1,0,1944,20409,22353
2016-04-05 19:00:00-04:00,0,4,19,1,0,3012,23957,26969
2016-04-05 20:00:00-04:00,0,4,20,1,0,2743,21255,23998
2016-04-05 21:00:00-04:00,0,4,21,1,0,2196,18494,20690
2016-04-05 22:00:00-04:00,0,4,22,1,0,2035,18625,20660
2016-04-05 23:00:00-04:00,0,4,23,1,0,1958,19489,21447
2016-04-06 00:00:00-04:00,0,4,0,2,0,1802,18461,20263
2016-04-06 01:00:00-04:00,0,4,1,2,0,2158,19985,22143
2016-04-06 02:00:00-04:00,0,4,2,2,0,2378,19714,22092
2016-04-06 03:00:00-04:00,0,4,3,2,0,2531,17440,19971
2016-04-06 04:00:00-04:00,0,4,4,2,0,2999,21247,24246
2016-04-06 05:00:00-04:00,0,4,5,2,0,3553,26037,29590
2016-04-06 06:00:00-04:00,0,4,6,2,0,3404,26466,29870
2016-04-06 07:00:00-04:00,0,4,7,2,0,3226,25985,29211
2016-04-06 08:00:00-04:00,0,4,8,2,0,2838,25586,28424
2016-04-06 09:00:00-04:00,0,4,9,2,0,2496,23147,25643
2016-04-06 10:00:00-04:00,0,4,10,2,0,2022,16835,18857
2016-04-06 11:00:00-04:00,0,4,11,2,0,1325,9901,11226
2016-04-06 12:00:00-04:00,0,4,12,2,0,823,5619,6442
2016-04-06 13:00:00-04:00,0,4,13,2,0,526,3453,3979
2016-04-06 14:00:00-04:00,0,4,14,2,0,355,2354,2709
2016-04-06 15:00:00-04:00,0,4,15,2,0,344,2406,2750
2016-04-06 16:00:00-04:00,0,4,16,2,0,357,4045,4402
2016-04-06 17:00:00-04:00,0,4,17,2,0,754,11005,11759
2016-04-06 18:00:00-04:00,0,4,18,2,0,1792,20142,21934
2016-04-06 19:00:00-04:00,0,4,19,2,0,2485,23119,25604
2016-04-06 20:00:00-04:00,0,4,20,2,0,2475,20852,23327
2016-04-06 21:00:00-04:00,0,4,21,2,0,1989,18261,20250
2016-04-06 22:00:00-04:00,0,4,22,2,0,1794,18505,20299
2016-04-06 23:00:00-04:00,0,4,23,2,0,1880,19064,20944
2016-04-07 00:00:00-04:00,0,4,0,3,0,1827,18695,20522
2016-04-07 01:00:00-04:00,0,4,1,3,0,2301,20393,22694
2016-04-07 02:00:00-04:00,0,4,2,3,0,2500,20164,22664
2016-04-07 03:00:00-04:00,0,4,3,3,0,2758,16997,19755
2016-04-07 04:00:00-04:00,0,4,4,3,0,3047,20990,24037
2016-04-07 05:00:00-04:00,0,4,5,3,0,3373,26276,29649
2016-04-07 06:00:00-04:00,0,4,6,3,0,3231,26324,29555
2016-04-07 07:00:00-04:00,0,4,7,3,0,3105,26022,29127
2016-04-07 08:00:00-04:00,0,4,8,3,0,2661,25056,27717
2016-04-07 09:00:00-04:00,0,4,9,3,0,2491,23225,25716
2016-04-07 10:00:00-04:00,0,4,10,3,0,2063,18082,20145
2016-04-07 11:00:00-04:00,0,4,11,3,0,1414,10914,12328
2016-04-07 12:00:00-04:00,0,4,12,3,0,959,6354,7313
2016-04-07 13:00:00-04:00,0.1,4,13,3,0,589,3750,4339
2016-04-07 14:00:00-04:00,0.05,4,14,3,0,403,2554,2957
2016-04-07 15:00:00-04:00,0,4,15,3,0,414,2513,2927
2016-04-07 16:00:00-04:00,0,4,16,3,0,370,4205,4575
2016-04-07 17:00:00-04:00,0,4,17,3,0,762,10994,11756
2016-04-07 18:00:00-04:00,0,4,18,3,0,1799,19820,21619
2016-04-07 19:00:00-04:00,0,4,19,3,0,2598,23202,25800
2016-04-07 20:00:00-04:00,0,4,20,3,0,2466,21027,23493
2016-04-07 21:00:00-04:00,0,4,21,3,0,1971,18416,20387
2016-04-07 22:00:00-04:00,0,4,22,3,0,1930,18720,20650
2016-04-07 23:00:00-04:00,0,4,23,3,0,2061,21246,23307
2016-04-08 00:00:00-04:00,0,4,0,4,0,2408,21011,23419
2016-04-08 01:00:00-04:00,0,4,1,4,0,2336,20587,22923
2016-04-08 02:00:00-04:00,0,4,2,4,0,2508,18578,21086
2016-04-08 03:00:00-04:00,0,4,3,4,0,2655,15787,18442
2016-04-08 04:00:00-04:00,0,4,4,4,0,2973,20121,23094
2016-04-08 05:00:00-04:00,0,4,5,4,0,3298,25407,28705
2016-04-08 06:00:00-04:00,0,4,6,4,0,3255,26330,29585
2016-04-08 07:00:00-04:00,0,4,7,4,0,3096,25946,29042
2016-04-08 08:00:00-04:00,0,4,8,4,0,2872,25846,28718
2016-04-08 09:00:00-04:00,0,4,9,4,0,2815,24729,27544
2016-04-08 10:00:00-04:00,0,4,10,4,0,2502,21622,24124
2016-04-08 11:00:00-04:00,0,4,11,4,0,1843,15865,17708
2016-04-08 12:00:00-04:00,0,4,12,4,0,1295,9833,11128
2016-04-08 13:00:00-04:00,0,4,13,4,0,890,6140,7030
2016-04-08 14:00:00-04:00,0,4,14,4,0,603,4216,4819
2016-04-08 15:00:00-04:00,0,4,15,4,0,564,3779,4343
2016-04-08 16:00:00-04:00,0,4,16,4,0,438,4464,4902
2016-04-08 17:00:00-04:00,0,4,17,4,0,812,10730,11542
2016-04-08 18:00:00-04:00,0,4,18,4,0,1867,19410,21277
2016-04-08 19:00:00-04:00,0,4,19,4,0,2714,22736,25450
2016-04-08 20:00:00-04:00,0,4,20,4,0,2618,21658,24276
2016-04-08 21:00:00-04:00,0,4,21,4,0,2353,19456,21809
2016-04-08 22:00:00-04:00,0,4,22,4,0,2102,19413,21515
2016-04-08 23:00:00-04:00,0,4,23,4,0,2017,20505,22522
2016-04-09 00:00:00-04:00,0,4,0,5,0,1934,20208,22142
2016-04-09 01:00:00-04:00,0,4,1,5,0,2423,22086,24509
2016-04-09 02:00:00-04:00,0,4,2,5,0,2918,20715,23633
2016-04-09 03:00:00-04:00,0,4,3,5,0,3148,17558,20706
2016-04-09 04:00:00-04:00,0,4,4,5,0,3548,21630,25178
2016-04-09 05:00:00-04:00,0,4,5,5,0,4217,26872,31089
2016-04-09 06:00:00-04:00,0,4,6,5,0,4163,28663,32826
2016-04-09 07:00:00-04:00,0,4,7,5,0,4018,26913,30931
2016-04-09 08:00:00-04:00,0,4,8,5,0,4109,25286,29395
2016-04-09 09:00:00-04:00,0,4,9,5,0,4089,26493,30582
2016-04-09 10:00:00-04:00,0,4,10,5,0,4135,25774,29909
2016-04-09 11:00:00-04:00,0,4,11,5,0,3941,23640,27581
2016-04-09 12:00:00-04:00,0,4,12,5,0,3333,20350,23683
2016-04-09 13:00:00-04:00,0.03,4,13,5,0,2774,16670,19444
2016-04-09 14:00:00-04:00,0.02,4,14,5,0,2276,12402,14678
2016-04-09 15:00:00-04:00,0.02,4,15,5,0,1603,7673,9276
2016-04-09 16:00:00-04:00,0,4,16,5,0,786,3757,4543
2016-04-09 17:00:00-04:00,0,4,17,5,0,724,4921,5645
2016-04-09 18:00:00-04:00,0,4,18,5,0,899,7469,8368
2016-04-09 19:00:00-04:00,0,4,19,5,0,1387,11463,12850
2016-04-09 20:00:00-04:00,0,4,20,5,0,1882,15993,17875
2016-04-09 21:00:00-04:00,0,4,21,5,0,2135,19048,21183
2016-04-09 22:00:00-04:00,0,4,22,5,0,2351,22074,24425
2016-04-09 23:00:00-04:00,0,4,23,5,0,2951,26733,29684
2016-04-10 00:00:00-04:00,0,4,0,6,0,3036,27238,30274
2016-04-10 01:00:00-04:00,0,4,1,6,0,3310,24610,27920
2016-04-10 02:00:00-04:00,0,4,2,6,0,3482,23660,27142
2016-04-10 03:00:00-04:00,0,4,3,6,0,3477,19862,23339
2016-04-10 04:00:00-04:00,0,4,4,6,0,3483,22596,26079
2016-04-10 05:00:00-04:00,0,4,5,6,0,3833,24777,28610
2016-04-10 06:00:00-04:00,0,4,6,6,0,3927,25660,29587
2016-04-10 07:00:00-04:00,0,4,7,6,0,3945,22207,26152
2016-04-10 08:00:00-04:00,0,4,8,6,0,4013,21994,26007
2016-04-10 09:00:00-04:00,0,4,9,6,0,4466,25185,29651
2016-04-10 10:00:00-04:00,0,4,10,6,0,4640,26998,31638
2016-04-10 11:00:00-04:00,0,4,11,6,0,4396,25171,29567
2016-04-10 12:00:00-04:00,0,4,12,6,0,3906,22273,26179
2016-04-10 13:00:00-04:00,0,4,13,6,0,3226,18581,21807
2016-04-10 14:00:00-04:00,0,4,14,6,0,2644,13999,16643
2016-04-10 15:00:00-04:00,0,4,15,6,0,2024,8708,10732
2016-04-10 16:00:00-04:00,0,4,16,6,0,949,3925,4874
2016-04-10 17:00:00-04:00,0,4,17,6,0,770,4155,4925
2016-04-10 18:00:00-04:00,0,4,18,6,0,795,5912,6707
2016-04-10 19:00:00-04:00,0,4,19,6,0,939,8962,9901
2016-04-10 20:00:00-04:00,0,4,20,6,0,1412,13520,14932
2016-04-10 21:00:00-04:00,0,4,21,6,0,1770,18149,19919
2016-04-10 22:00:00-04:00,0,4,22,6,0,2129,20650,22779
2016-04-10 23:00:00-04:00,0,4,23,6,0,2211,21654,23865
2016-04-11 00:00:00-04:00,0,4,0,0,0,2230,21687,23917
2016-04-11 01:00:00-04:00,0,4,1,0,0,2419,21187,23606
2016-04-11 02:00:00-04:00,0,4,2,0,0,2706,20211,22917
2016-04-11 03:00:00-04:00,0,4,3,0,0,2792,19091,21883
2016-04-11 04:00:00-04:00,0,4,4,0,0,2942,20662,23604
2016-04-11 05:00:00-04:00,0,4,5,0,0,3186,22097,25283
2016-04-11 06:00:00-04:00,0,4,6,0,0,2883,20661,23544
2016-04-11 07:00:00-04:00,0,4,7,0,0,2779,17849,20628
2016-04-11 08:00:00-04:00,0,4,8,0,0,2689,16552,19241
2016-04-11 09:00:00-04:00,0,4,9,0,0,2306,14950,17256
2016-04-11 10:00:00-04:00,0,4,10,0,0,1921,11071,12992
2016-04-11 11:00:00-04:00,0,4,11,0,0,1368,6656,8024
2016-04-11 12:00:00-04:00,0,4,12,0,0,895,4275,5170
2016-04-11 13:00:00-04:00,0,4,13,0,0,551,2601,3152
2016-04-11 14:00:00-04:00,0,4,14,0,0,470,1854,2324
2016-04-11 15:00:00-04:00,0,4,15,0,0,473,2468,2941
2016-04-11 16:00:00-04:00,0,4,16,0,0,446,4198,4644
2016-04-11 17:00:00-04:00,0,4,17,0,0,822,10774,11596
2016-04-11 18:00:00-04:00,0,4,18,0,0,1855,18630,20485
2016-04-11 19:00:00-04:00,0.01,4,19,0,0,2659,21260,23919
2016-04-11 20:00:00-04:00,0,4,20,0,0,2392,19409,21801
2016-04-11 21:00:00-04:00,0,4,21,0,0,2018,16521,18539
2016-04-11 22:00:00-04:00,0,4,22,0,0,1750,16157,17907
2016-04-11 23:00:00-04:00,0,4,23,0,0,1651,16297,17948
2016-04-12 00:00:00-04:00,0,4,0,1,0,1746,16408,18154
2016-04-12 01:00:00-04:00,0,4,1,1,0,1961,18333,20294
2016-04-12 02:00:00-04:00,0,4,2,1,0,2177,18505,20682
2016-04-12 03:00:00-04:00,0,4,3,1,0,2258,17089,19347
2016-04-12 04:00:00-04:00,0,4,4,1,0,2684,21380,24064
2016-04-12 05:00:00-04:00,0.01,4,5,1,0,3203,26508,29711
2016-04-12 06:00:00-04:00,0,4,6,1,0,2785,23172,25957
2016-04-12 07:00:00-04:00,0.02,4,7,1,0,2373,21490,23863
2016-04-12 08:00:00-04:00,0.09,4,8,1,0,2181,20770,22951
2016-04-12 09:00:00-04:00,0.07,4,9,1,0,1943,17903,19846
2016-04-12 10:00:00-04:00,0.03,4,10,1,0,1555,12873,14428
2016-04-12 11:00:00-04:00,0,4,11,1,0,1152,7867,9019
2016-04-12 12:00:00-04:00,0,4,12,1,0,773,4509,5282
2016-04-12 13:00:00-04:00,0,4,13,1,0,473,2877,3350
2016-04-12 14:00:00-04:00,0,4,14,1,0,345,1952,2297
2016-04-12 15:00:00-04:00,0,4,15,1,0,320,2093,2413
2016-04-12 16:00:00-04:00,0,4,16,1,0,375,4449,4824
2016-04-12 17:00:00-04:00,0,4,17,1,0,745,11202,11947
2016-04-12 18:00:00-04:00,0,4,18,1,0,1842,20885,22727
2016-04-12 19:00:00-04:00,0,4,19,1,0,2795,23540,26335
2016-04-12 20:00:00-04:00,0,4,20,1,0,2593,21310,23903
2016-04-12 21:00:00-04:00,0,4,21,1,0,2153,18618,20771
2016-04-12 22:00:00-04:00,0,4,22,1,0,1949,18800,20749
2016-04-12 23:00:00-04:00,0,4,23,1,0,1929,18793,20722
2016-04-13 00:00:00-04:00,0,4,0,2,0,1806,17961,19767
2016-04-13 01:00:00-04:00,0,4,1,2,0,1953,18398,20351
2016-04-13 02:00:00-04:00,0,4,2,2,0,2177,18528,20705
2016-04-13 03:00:00-04:00,0,4,3,2,0,2298,16818,19116
2016-04-13 04:00:00-04:00,0,4,4,2,0,2659,21045,23704
2016-04-13 05:00:00-04:00,0,4,5,2,0,2994,25913,28907
2016-04-13 06:00:00-04:00,0,4,6,2,0,2945,25100,28045
2016-04-13 07:00:00-04:00,0,4,7,2,0,2900,25495,28395
2016-04-13 08:00:00-04:00,0,4,8,2,0,2624,24618,27242
2016-04-13 09:00:00-04:00,0,4,9,2,0,2391,22356,24747
2016-04-13 10:00:00-04:00,0,4,10,2,0,1998,17153,19151
2016-04-13 11:00:00-04:00,0,4,11,2,0,1406,9897,11303
2016-04-13 12:00:00-04:00,0,4,12,2,0,905,5707,6612
2016-04-13 13:00:00-04:00,0,4,13,2,0,546,3702,4248
2016-04-13 14:00:00-04:00,0,4,14,2,0,374,2392,2766
2016-04-13 15:00:00-04:00,0,4,15,2,0,363,2359,2722
2016-04-13 16:00:00-04:00,0,4,16,2,0,363,4018,4381
2016-04-13 17:00:00-04:00,0,4,17,2,0,789,10829,11618
2016-04-13 18:00:00-04:00,0,4,18,2,0,1730,19446,21176
2016-04-13 19:00:00-04:00,0,4,19,2,0,2586,22861,25447
2016-04-13 20:00:00-04:00,0,4,20,2,0,2435,20541,22976
2016-04-13 21:00:00-04:00,0,4,21,2,0,1980,18079,20059
2016-04-13 22:00:00-04:00,0,4,22,2,0,1794,18289,20083
2016-04-13 23:00:00-04:00,0,4,23,2,0,1856,18596,20452
2016-04-14 00:00:00-04:00,0,4,0,3,0,1765,18244,20009
2016-04-14 01:00:00-04:00,0,4,1,3,0,2058,19723,21781
2016-04-14 02:00:00-04:00,0,4,2,3,0,2214,19122,21336
2016-04-14 03:00:00-04:00,0,4,3,3,0,2515,16561,19076
2016-04-14 04:00:00-04:00,0,4,4,3,0,2775,20018,22793
2016-04-14 05:00:00-04:00,0,4,5,3,0,3199,24901,28100
2016-04-14 06:00:00-04:00,0,4,6,3,0,3267,25637,28904
2016-04-14 07:00:00-04:00,0,4,7,3,0,3108,26067,29175
2016-04-14 08:00:00-04:00,0,4,8,3,0,2742,25556,28298
2016-04-14 09:00:00-04:00,0,4,9,3,0,2577,23771,26348
2016-04-14 10:00:00-04:00,0,4,10,3,0,2195,18438,20633
2016-04-14 11:00:00-04:00,0,4,11,3,0,1563,11234,12797
2016-04-14 12:00:00-04:00,0,4,12,3,0,1194,7275,8469
2016-04-14 13:00:00-04:00,0,4,13,3,0,667,4283,4950
2016-04-14 14:00:00-04:00,0,4,14,3,0,474,2767,3241
2016-04-14 15:00:00-04:00,0,4,15,3,0,420,2722,3142
2016-04-14 16:00:00-04:00,0,4,16,3,0,410,4364,4774
2016-04-14 17:00:00-04:00,0,4,17,3,0,813,11001,11814
2016-04-14 18:00:00-04:00,0,4,18,3,0,1851,19631,21482
2016-04-14 19:00:00-04:00,0,4,19,3,0,2547,22584,25131
2016-04-14 20:00:00-04:00,0,4,20,3,0,2337,20916,23253
2016-04-14 21:00:00-04:00,0,4,21,3,0,2058,18611,20669
2016-04-14 22:00:00-04:00,0,4,22,3,0,1882,19021,20903
2016-04-14 23:00:00-04:00,0,4,23,3,0,1872,19182,21054
2016-04-15 00:00:00-04:00,0,4,0,4,0,1838,19535,21373
2016-04-15 01:00:00-04:00,0,4,1,4,0,2222,20616,22838
2016-04-15 02:00:00-04:00,0,4,2,4,0,2395,19488,21883
2016-04-15 03:00:00-04:00,0,4,3,4,0,2562,16746,19308
2016-04-15 04:00:00-04:00,0,4,4,4,0,3006,21254,24260
2016-04-15 05:00:00-04:00,0,4,5,4,0,3275,25201,28476
2016-04-15 06:00:00-04:00,0,4,6,4,0,3456,25673,29129
2016-04-15 07:00:00-04:00,0,4,7,4,0,3430,27085,30515
2016-04-15 08:00:00-04:00,0,4,8,4,0,3059,26969,30028
2016-04-15 09:00:00-04:00,0,4,9,4,0,2921,25746,28667
2016-04-15 10:00:00-04:00,0,4,10,4,0,2616,22266,24882
2016-04-15 11:00:00-04:00,0,4,11,4,0,2021,15930,17951
2016-04-15 12:00:00-04:00,0,4,12,4,0,1352,9508,10860
2016-04-15 13:00:00-04:00,0,4,13,4,0,847,6643,7490
2016-04-15 14:00:00-04:00,0,4,14,4,0,610,4299,4909
2016-04-15 15:00:00-04:00,0,4,15,4,0,534,3677,4211
2016-04-15 16:00:00-04:00,0,4,16,4,0,426,4411,4837
2016-04-15 17:00:00-04:00,0,4,17,4,0,840,11011,11851
2016-04-15 18:00:00-04:00,0,4,18,4,0,1879,19464,21343
2016-04-15 19:00:00-04:00,0,4,19,4,0,2591,22746,25337
2016-04-15 20:00:00-04:00,0,4,20,4,0,2447,20684,23131
2016-04-15 21:00:00-04:00,0,4,21,4,0,2054,18241,20295
2016-04-15 22:00:00-04:00,0,4,22,4,0,1969,18784,20753
2016-04-15 23:00:00-04:00,0,4,23,4,0,1797,19424,21221
2016-04-16 00:00:00-04:00,0,4,0,5,0,1799,19092,20891
2016-04-16 01:00:00-04:00,0,4,1,5,0,2240,21047,23287
2016-04-16 02:00:00-04:00,0,4,2,5,0,2489,19193,21682
2016-04-16 03:00:00-04:00,0,4,3,5,0,2893,16199,19092
2016-04-16 04:00:00-04:00,0,4,4,5,0,3339,20474,23813
2016-04-16 05:00:00-04:00,0,4,5,5,0,3859,26565,30424
2016-04-16 06:00:00-04:00,0,4,6,5,0,4037,28571,32608
2016-04-16 07:00:00-04:00,0,4,7,5,0,4295,27319,31614
2016-04-16 08:00:00-04:00,0,4,8,5,0,4075,26246,30321
2016-04-16 09:00:00-04:00,0,4,9,5,0,4380,27853,32233
2016-04-16 10:00:00-04:00,0,4,10,5,0,4445,25925,30370
2016-04-16 11:00:00-04:00,0,4,11,5,0,4033,23588,27621
2016-04-16 12:00:00-04:00,0,4,12,5,0,3467,19947,23414
2016-04-16 13:00:00-04:00,0,4,13,5,0,2832,15896,18728
2016-04-16 14:00:00-04:00,0,4,14,5,0,2249,11974,14223
2016-04-16 15:00:00-04:00,0,4,15,5,0,1655,7869,9524
2016-04-16 16:00:00-04:00,0,4,16,5,0,807,3850,4657
2016-04-16 17:00:00-04:00,0,4,17,5,0,712,5119,5831
2016-04-16 18:00:00-04:00,0,4,18,5,0,947,7644,8591
2016-04-16 19:00:00-04:00,0,4,19,5,0,1391,13090,14481
2016-04-16 20:00:00-04:00,0,4,20,5,0,1843,17475,19318
2016-04-16 21:00:00-04:00,0,4,21,5,0,2058,19046,21104
2016-04-16 22:00:00-04:00,0,4,22,5,0,2321,21266,23587
2016-04-16 23:00:00-04:00,0,4,23,5,0,2484,22396,24880
2016-04-17 00:00:00-04:00,0,4,0,6,0,2420,22412,24832
2016-04-17 01:00:00-04:00,0,4,1,6,0,2678,21256,23934
2016-04-17 02:00:00-04:00,0,4,2,6,0,2947,21081,24028
2016-04-17 03:00:00-04:00,0,4,3,6,0,3296,18953,22249
2016-04-17 04:00:00-04:00,0,4,4,6,0,3468,22081,25549
2016-04-17 05:00:00-04:00,0,4,5,6,0,3994,26241,30235
2016-04-17 06:00:00-04:00,0,4,6,6,0,4283,27843,32126
2016-04-17 07:00:00-04:00,0,4,7,6,0,4469,25211,29680
2016-04-17 08:00:00-04:00,0,4,8,6,0,4346,24794,29140
2016-04-17 09:00:00-04:00,0,4,9,6,0,4523,26616,31139
2016-04-17 10:00:00-04:00,0,4,10,6,0,4626,27281,31907
2016-04-17 11:00:00-04:00,0,4,11,6,0,4289,24667,28956
2016-04-17 12:00:00-04:00,0,4,12,6,0,3888,21904,25792
2016-04-17 13:00:00-04:00,0,4,13,6,0,3308,18224,21532
2016-04-17 14:00:00-04:00,0,4,14,6,0,2693,13721,16414
2016-04-17 15:00:00-04:00,0,4,15,6,0,1930,8757,10687
2016-04-17 16:00:00-04:00,0,4,16,6,0,877,3946,4823
2016-04-17 17:00:00-04:00,0,4,17,6,0,705,4674,5379
2016-04-17 18:00:00-04:00,0,4,18,6,0,727,6876,7603
2016-04-17 19:00:00-04:00,0,4,19,6,0,944,9792,10736
2016-04-17 20:00:00-04:00,0,4,20,6,0,1420,14040,15460
2016-04-17 21:00:00-04:00,0,4,21,6,0,1816,17952,19768
2016-04-17 22:00:00-04:00,0,4,22,6,0,2031,20584,22615
2016-04-17 23:00:00-04:00,0,4,23,6,0,2221,21432,23653
2016-04-18 00:00:00-04:00,0,4,0,0,0,2239,21446,23685
2016-04-18 01:00:00-04:00,0,4,1,0,0,2532,21547,24079
2016-04-18 02:00:00-04:00,0,4,2,0,0,2780,20511,23291
2016-04-18 03:00:00-04:00,0,4,3,0,0,2836,19187,22023
2016-04-18 04:00:00-04:00,0,4,4,0,0,2840,20083,22923
2016-04-18 05:00:00-04:00,0,4,5,0,0,3002,21336,24338
2016-04-18 06:00:00-04:00,0,4,6,0,0,3083,20132,23215
2016-04-18 07:00:00-04:00,0,4,7,0,0,2996,19072,22068
2016-04-18 08:00:00-04:00,0,4,8,0,0,2623,17662,20285
2016-04-18 09:00:00-04:00,0,4,9,0,0,2466,15634,18100
2016-04-18 10:00:00-04:00,0,4,10,0,0,2015,11578,13593
2016-04-18 11:00:00-04:00,0,4,11,0,0,1448,7577,9025
2016-04-18 12:00:00-04:00,0,4,12,0,0,934,4428,5362
2016-04-18 13:00:00-04:00,0,4,13,0,0,580,2741,3321
2016-04-18 14:00:00-04:00,0,4,14,0,0,404,1958,2362
2016-04-18 15:00:00-04:00,0,4,15,0,0,541,2623,3164
2016-04-18 16:00:00-04:00,0,4,16,0,0,493,4259,4752
2016-04-18 17:00:00-04:00,0,4,17,0,0,842,10647,11489
2016-04-18 18:00:00-04:00,0,4,18,0,0,1746,17700,19446
2016-04-18 19:00:00-04:00,0,4,19,0,0,2440,19625,22065
2016-04-18 20:00:00-04:00,0,4,20,0,0,2280,18309,20589
2016-04-18 21:00:00-04:00,0,4,21,0,0,1884,15896,17780
2016-04-18 22:00:00-04:00,0,4,22,0,0,1725,16004,17729
2016-04-18 23:00:00-04:00,0,4,23,0,0,1724,16670,18394
2016-04-19 00:00:00-04:00,0,4,0,1,0,1681,16935,18616
2016-04-19 01:00:00-04:00,0,4,1,1,0,2036,19137,21173
2016-04-19 02:00:00-04:00,0,4,2,1,0,2116,18980,21096
2016-04-19 03:00:00-04:00,0,4,3,1,0,2378,17802,20180
2016-04-19 04:00:00-04:00,0,4,4,1,0,2705,21058,23763
2016-04-19 05:00:00-04:00,0,4,5,1,0,2752,23924,26676
2016-04-19 06:00:00-04:00,0,4,6,1,0,2622,23284,25906
2016-04-19 07:00:00-04:00,0,4,7,1,0,2434,22734,25168
2016-04-19 08:00:00-04:00,0,4,8,1,0,2123,20986,23109
2016-04-19 09:00:00-04:00,0,4,9,1,0,1875,18708,20583
2016-04-19 10:00:00-04:00,0,4,10,1,0,1500,13579,15079
2016-04-19 11:00:00-04:00,0,4,11,1,0,1095,8029,9124
2016-04-19 12:00:00-04:00,0,4,12,1,0,729,4651,5380
2016-04-19 13:00:00-04:00,0,4,13,1,0,473,2872,3345
2016-04-19 14:00:00-04:00,0,4,14,1,0,318,2008,2326
2016-04-19 15:00:00-04:00,0,4,15,1,0,352,2215,2567
2016-04-19 16:00:00-04:00,0,4,16,1,0,385,4042,4427
2016-04-19 17:00:00-04:00,0,4,17,1,0,800,10650,11450
2016-04-19 18:00:00-04:00,0,4,18,1,0,1772,18753,20525
2016-04-19 19:00:00-04:00,0,4,19,1,0,2405,21336,23741
2016-04-19 20:00:00-04:00,0,4,20,1,0,2206,19368,21574
2016-04-19 21:00:00-04:00,0,4,21,1,0,1848,17629,19477
2016-04-19 22:00:00-04:00,0,4,22,1,0,1820,17293,19113
2016-04-19 23:00:00-04:00,0,4,23,1,0,1744,17541,19285
2016-04-20 00:00:00-04:00,0,4,0,2,0,1698,17560,19258
2016-04-20 01:00:00-04:00,0,4,1,2,0,1959,19607,21566
2016-04-20 02:00:00-04:00,0,4,2,2,0,2148,18899,21047
2016-04-20 03:00:00-04:00,0,4,3,2,0,2364,16711,19075
2016-04-20 04:00:00-04:00,0,4,4,2,0,2633,20712,23345
2016-04-20 05:00:00-04:00,0,4,5,2,0,2971,25177,28148
2016-04-20 06:00:00-04:00,0,4,6,2,0,2770,24480,27250
2016-04-20 07:00:00-04:00,0,4,7,2,0,2737,24797,27534
2016-04-20 08:00:00-04:00,0,4,8,2,0,2484,24085,26569
2016-04-20 09:00:00-04:00,0,4,9,2,0,2255,22644,24899
2016-04-20 10:00:00-04:00,0,4,10,2,0,1928,16745,18673
2016-04-20 11:00:00-04:00,0,4,11,2,0,1323,10131,11454
2016-04-20 12:00:00-04:00,0,4,12,2,0,837,5952,6789
2016-04-20 13:00:00-04:00,0,4,13,2,0,475,3677,4152
2016-04-20 14:00:00-04:00,0,4,14,2,0,356,2390,2746
2016-04-20 15:00:00-04:00,0,4,15,2,0,356,2344,2700
2016-04-20 16:00:00-04:00,0,4,16,2,0,375,4124,4499
2016-04-20 17:00:00-04:00,0,4,17,2,0,733,10707,11440
2016-04-20 18:00:00-04:00,0,4,18,2,0,1729,19323,21052
2016-04-20 19:00:00-04:00,0,4,19,2,0,2347,21826,24173
2016-04-20 20:00:00-04:00,0,4,20,2,0,2290,20350,22640
2016-04-20 21:00:00-04:00,0,4,21,2,0,2045,18209,20254
2016-04-20 22:00:00-04:00,0,4,22,2,0,1786,17946,19732
2016-04-20 23:00:00-04:00,0,4,23,2,0,1819,18608,20427
2016-04-21 00:00:00-04:00,0,4,0,3,0,1809,18145,19954
2016-04-21 01:00:00-04:00,0,4,1,3,0,2076,20044,22120
2016-04-21 02:00:00-04:00,0,4,2,3,0,2375,19527,21902
2016-04-21 03:00:00-04:00,0,4,3,3,0,2515,16570,19085
2016-04-21 04:00:00-04:00,0,4,4,3,0,2767,20804,23571
2016-04-21 05:00:00-04:00,0,4,5,3,0,3267,25113,28380
2016-04-21 06:00:00-04:00,0,4,6,3,0,3133,25624,28757
2016-04-21 07:00:00-04:00,0,4,7,3,0,2967,25606,28573
2016-04-21 08:00:00-04:00,0,4,8,3,0,2724,25344,28068
2016-04-21 09:00:00-04:00,0,4,9,3,0,2738,23820,26558
2016-04-21 10:00:00-04:00,0,4,10,3,0,2355,19423,21778
2016-04-21 11:00:00-04:00,0,4,11,3,0,1627,11440,13067
2016-04-21 12:00:00-04:00,0,4,12,3,0,1012,6797,7809
2016-04-21 13:00:00-04:00,0,4,13,3,0,631,4127,4758
2016-04-21 14:00:00-04:00,0,4,14,3,0,435,2738,3173
2016-04-21 15:00:00-04:00,0,4,15,3,0,437,2704,3141
2016-04-21 16:00:00-04:00,0,4,16,3,0,417,4424,4841
2016-04-21 17:00:00-04:00,0,4,17,3,0,834,11197,12031
2016-04-21 18:00:00-04:00,0,4,18,3,0,1908,19866,21774
2016-04-21 19:00:00-04:00,0,4,19,3,0,2663,21811,24474
2016-04-21 20:00:00-04:00,0,4,20,3,0,2372,20014,22386
2016-04-21 21:00:00-04:00,0,4,21,3,0,1968,17775,19743
2016-04-21 22:00:00-04:00,0,4,22,3,0,1804,17675,19479
2016-04-21 23:00:00-04:00,0,4,23,3,0,1867,18090,19957
2016-04-22 00:00:00-04:00,0,4,0,4,0,1826,18101,19927
2016-04-22 01:00:00-04:00,0,4,1,4,0,2152,19520,21672
2016-04-22 02:00:00-04:00,0,4,2,4,0,2344,18461,20805
2016-04-22 03:00:00-04:00,0,4,3,4,0,2499,15092,17591
2016-04-22 04:00:00-04:00,0,4,4,4,0,2937,17942,20879
2016-04-22 05:00:00-04:00,0,4,5,4,0,3174,22807,25981
2016-04-22 06:00:00-04:00,0,4,6,4,0,3141,23571,26712
2016-04-22 07:00:00-04:00,0,4,7,4,0,3006,25223,28229
2016-04-22 08:00:00-04:00,0,4,8,4,0,2888,25048,27936
2016-04-22 09:00:00-04:00,0,4,9,4,0,2823,24436,27259
2016-04-22 10:00:00-04:00,0,4,10,4,0,2569,21548,24117
2016-04-22 11:00:00-04:00,0,4,11,4,0,2003,15551,17554
2016-04-22 12:00:00-04:00,0,4,12,4,0,1420,10096,11516
2016-04-22 13:00:00-04:00,0,4,13,4,0,927,6670,7597
2016-04-22 14:00:00-04:00,0,4,14,4,0,702,4423,5125
2016-04-22 15:00:00-04:00,0,4,15,4,0,528,3764,4292
2016-04-22 16:00:00-04:00,0,4,16,4,0,464,4480,4944
2016-04-22 17:00:00-04:00,0,4,17,4,0,814,10854,11668
2016-04-22 18:00:00-04:00,0,4,18,4,0,1742,18020,19762
2016-04-22 19:00:00-04:00,0,4,19,4,0,2461,20357,22818
2016-04-22 20:00:00-04:00,0,4,20,4,0,2334,18644,20978
2016-04-22 21:00:00-04:00,0,4,21,4,0,2012,16885,18897
2016-04-22 22:00:00-04:00,0,4,22,4,0,1911,17209,19120
2016-04-22 23:00:00-04:00,0,4,23,4,0,1802,17901,19703
2016-04-23 00:00:00-04:00,0,4,0,5,0,1830,17548,19378
2016-04-23 01:00:00-04:00,0.02,4,1,5,0,2302,19764,22066
2016-04-23 02:00:00-04:00,0.02,4,2,5,0,2672,17645,20317
2016-04-23 03:00:00-04:00,0.05,4,3,5,0,2914,14898,17812
2016-04-23 04:00:00-04:00,0.05,4,4,5,0,3354,18354,21708
2016-04-23 05:00:00-04:00,0,4,5,5,0,3742,22220,25962
2016-04-23 06:00:00-04:00,0,4,6,5,0,3466,22796,26262
2016-04-23 07:00:00-04:00,0,4,7,5,0,3498,21260,24758
2016-04-23 08:00:00-04:00,0,4,8,5,0,3519,21797,25316
2016-04-23 09:00:00-04:00,0,4,9,5,0,3494,23546,27040
2016-04-23 10:00:00-04:00,0,4,10,5,0,3862,23636,27498
2016-04-23 11:00:00-04:00,0,4,11,5,0,3832,22311,26143
2016-04-23 12:00:00-04:00,0,4,12,5,0,3434,18497,21931
2016-04-23 13:00:00-04:00,0,4,13,5,0,2687,14528,17215
2016-04-23 14:00:00-04:00,0,4,14,5,0,2167,11092,13259
2016-04-23 15:00:00-04:00,0,4,15,5,0,1453,6528,7981
2016-04-23 16:00:00-04:00,0,4,16,5,0,777,3297,4074
2016-04-23 17:00:00-04:00,0,4,17,5,0,683,4543,5226
2016-04-23 18:00:00-04:00,0,4,18,5,0,802,6438,7240
2016-04-23 19:00:00-04:00,0,4,19,5,0,1240,10652,11892
2016-04-23 20:00:00-04:00,0,4,20,5,0,1654,13529,15183
2016-04-23 21:00:00-04:00,0,4,21,5,0,1866,17151,19017
2016-04-23 22:00:00-04:00,0,4,22,5,0,2024,18139,20163
2016-04-23 23:00:00-04:00,0,4,23,5,0,2170,19033,21203
2016-04-24 00:00:00-04:00,0,4,0,6,0,2200,18627,20827
2016-04-24 01:00:00-04:00,0,4,1,6,0,2416,17875,20291
2016-04-24 02:00:00-04:00,0,4,2,6,0,2697,17830,20527
2016-04-24 03:00:00-04:00,0,4,3,6,0,2903,17130,20033
2016-04-24 04:00:00-04:00,0,4,4,6,0,3191,20091,23282
2016-04-24 05:00:00-04:00,0,4,5,6,0,3515,21952,25467
2016-04-24 06:00:00-04:00,0,4,6,6,0,3682,22434,26116
2016-04-24 07:00:00-04:00,0,4,7,6,0,3768,20445,24213
2016-04-24 08:00:00-04:00,0,4,8,6,0,3884,20869,24753
2016-04-24 09:00:00-04:00,0,4,9,6,0,4328,23838,28166
2016-04-24 10:00:00-04:00,0,4,10,6,0,4638,24998,29636
2016-04-24 11:00:00-04:00,0,4,11,6,0,4218,23071,27289
2016-04-24 12:00:00-04:00,0,4,12,6,0,3772,20893,24665
2016-04-24 13:00:00-04:00,0,4,13,6,0,3124,17195,20319
2016-04-24 14:00:00-04:00,0,4,14,6,0,2596,13188,15784
2016-04-24 15:00:00-04:00,0,4,15,6,0,1880,8249,10129
2016-04-24 16:00:00-04:00,0,4,16,6,0,910,3580,4490
2016-04-24 17:00:00-04:00,0,4,17,6,0,665,4042,4707
2016-04-24 18:00:00-04:00,0,4,18,6,0,690,5847,6537
2016-04-24 19:00:00-04:00,0,4,19,6,0,851,7667,8518
2016-04-24 20:00:00-04:00,0,4,20,6,0,1204,11063,12267
2016-04-24 21:00:00-04:00,0,4,21,6,0,1574,14835,16409
2016-04-24 22:00:00-04:00,0,4,22,6,0,1819,16975,18794
2016-04-24 23:00:00-04:00,0,4,23,6,0,1996,18398,20394
2016-04-25 00:00:00-04:00,0,4,0,0,0,1988,18257,20245
2016-04-25 01:00:00-04:00,0,4,1,0,0,2188,18924,21112
2016-04-25 02:00:00-04:00,0,4,2,0,0,2488,18029,20517
2016-04-25 03:00:00-04:00,0,4,3,0,0,2593,17541,20134
2016-04-25 04:00:00-04:00,0,4,4,0,0,2623,19373,21996
2016-04-25 05:00:00-04:00,0,4,5,0,0,2954,20151,23105
2016-04-25 06:00:00-04:00,0,4,6,0,0,3007,19382,22389
2016-04-25 07:00:00-04:00,0,4,7,0,0,2879,18594,21473
2016-04-25 08:00:00-04:00,0,4,8,0,0,2385,15897,18282
2016-04-25 09:00:00-04:00,0,4,9,0,0,2377,14928,17305
2016-04-25 10:00:00-04:00,0,4,10,0,0,1917,11396,13313
2016-04-25 11:00:00-04:00,0,4,11,0,0,1337,6700,8037
2016-04-25 12:00:00-04:00,0,4,12,0,0,878,4125,5003
2016-04-25 13:00:00-04:00,0,4,13,0,0,545,2538,3083
2016-04-25 14:00:00-04:00,0,4,14,0,0,395,1843,2238
2016-04-25 15:00:00-04:00,0,4,15,0,0,518,2318,2836
2016-04-25 16:00:00-04:00,0,4,16,0,0,419,4148,4567
2016-04-25 17:00:00-04:00,0,4,17,0,0,761,10013,10774
2016-04-25 18:00:00-04:00,0,4,18,0,0,1418,16473,17891
2016-04-25 19:00:00-04:00,0,4,19,0,0,2184,19233,21417
2016-04-25 20:00:00-04:00,0,4,20,0,0,2070,17649,19719
2016-04-25 21:00:00-04:00,0,4,21,0,0,1817,15299,17116
2016-04-25 22:00:00-04:00,0,4,22,0,0,1594,15468,17062
2016-04-25 23:00:00-04:00,0,4,23,0,0,1579,16310,17889
2016-04-26 00:00:00-04:00,0,4,0,1,0,1569,16357,17926
2016-04-26 01:00:00-04:00,0,4,1,1,0,1678,17701,19379
2016-04-26 02:00:00-04:00,0,4,2,1,0,1945,17950,19895
2016-04-26 03:00:00-04:00,0.06,4,3,1,0,2101,16245,18346
2016-04-26 04:00:00-04:00,0.13,4,4,1,0,2337,19408,21745
2016-04-26 05:00:00-04:00,0,4,5,1,0,2657,22390,25047
2016-04-26 06:00:00-04:00,0,4,6,1,0,2485,21416,23901
2016-04-26 07:00:00-04:00,0,4,7,1,0,2324,20640,22964
2016-04-26 08:00:00-04:00,0,4,8,1,0,1916,19462,21378
2016-04-26 09:00:00-04:00,0,4,9,1,0,1797,17121,18918
2016-04-26 10:00:00-04:00,0,4,10,1,0,1533,12315,13848
2016-04-26 11:00:00-04:00,0,4,11,1,0,1211,8012,9223
2016-04-26 12:00:00-04:00,0,4,12,1,0,824,4824,5648
2016-04-26 13:00:00-04:00,0,4,13,1,0,496,2834,3330
2016-04-26 14:00:00-04:00,0,4,14,1,0,377,2059,2436
2016-04-26 15:00:00-04:00,0.01,4,15,1,0,357,2095,2452
2016-04-26 16:00:00-04:00,0.08,4,16,1,0,354,3965,4319
2016-04-26 17:00:00-04:00,0.02,4,17,1,0,710,10171,10881
2016-04-26 18:00:00-04:00,0,4,18,1,0,1430,17351,18781
2016-04-26 19:00:00-04:00,0,4,19,1,0,2248,20254,22502
2016-04-26 20:00:00-04:00,0,4,20,1,0,2210,19077,21287
2016-04-26 21:00:00-04:00,0,4,21,1,0,1816,16779,18595
2016-04-26 22:00:00-04:00,0,4,22,1,0,1784,17346,19130
2016-04-26 23:00:00-04:00,0,4,23,1,0,1729,17175,18904
2016-04-27 00:00:00-04:00,0,4,0,2,0,1703,17247,18950
2016-04-27 01:00:00-04:00,0,4,1,2,0,1817,18258,20075
2016-04-27 02:00:00-04:00,0,4,2,2,0,2274,20486,22760
2016-04-27 03:00:00-04:00,0,4,3,2,0,3123,18113,21236
2016-04-27 04:00:00-04:00,0,4,4,2,0,2816,19434,22250
2016-04-27 05:00:00-04:00,0,4,5,2,0,2926,24065,26991
2016-04-27 06:00:00-04:00,0,4,6,2,0,2845,24718,27563
2016-04-27 07:00:00-04:00,0,4,7,2,0,2839,25199,28038
2016-04-27 08:00:00-04:00,0,4,8,2,0,2571,24372,26943
2016-04-27 09:00:00-04:00,0,4,9,2,0,2277,21987,24264
2016-04-27 10:00:00-04:00,0,4,10,2,0,1791,15590,17381
2016-04-27 11:00:00-04:00,0,4,11,2,0,1183,9831,11014
2016-04-27 12:00:00-04:00,0,4,12,2,0,758,5416,6174
2016-04-27 13:00:00-04:00,0,4,13,2,0,457,3308,3765
2016-04-27 14:00:00-04:00,0,4,14,2,0,299,2137,2436
2016-04-27 15:00:00-04:00,0,4,15,2,0,348,2226,2574
2016-04-27 16:00:00-04:00,0,4,16,2,0,375,3887,4262
2016-04-27 17:00:00-04:00,0,4,17,2,0,699,10480,11179
2016-04-27 18:00:00-04:00,0,4,18,2,0,1454,18091,19545
2016-04-27 19:00:00-04:00,0,4,19,2,0,2220,20905,23125
2016-04-27 20:00:00-04:00,0,4,20,2,0,2292,20043,22335
2016-04-27 21:00:00-04:00,0,4,21,2,0,1891,17336,19227
2016-04-27 22:00:00-04:00,0,4,22,2,0,1977,17776,19753
2016-04-27 23:00:00-04:00,0,4,23,2,0,1887,18192,20079
2016-04-28 00:00:00-04:00,0,4,0,3,0,1737,17525,19262
2016-04-28 01:00:00-04:00,0,4,1,3,0,1833,18524,20357
2016-04-28 02:00:00-04:00,0,4,2,3,0,2124,17829,19953
2016-04-28 03:00:00-04:00,0,4,3,3,0,2334,15846,18180
2016-04-28 04:00:00-04:00,0,4,4,3,0,2672,19455,22127
2016-04-28 05:00:00-04:00,0,4,5,3,0,3020,23872,26892
2016-04-28 06:00:00-04:00,0,4,6,3,0,3047,24688,27735
2016-04-28 07:00:00-04:00,0,4,7,3,0,2806,23926,26732
2016-04-28 08:00:00-04:00,0,4,8,3,0,2540,23959,26499
2016-04-28 09:00:00-04:00,0,4,9,3,0,2512,22071,24583
2016-04-28 10:00:00-04:00,0,4,10,3,0,2142,17629,19771
2016-04-28 11:00:00-04:00,0,4,11,3,0,1411,11117,12528
2016-04-28 12:00:00-04:00,0,4,12,3,0,886,6633,7519
2016-04-28 13:00:00-04:00,0,4,13,3,0,623,4136,4759
2016-04-28 14:00:00-04:00,0,4,14,3,0,440,2739,3179
2016-04-28 15:00:00-04:00,0,4,15,3,0,403,2644,3047
2016-04-28 16:00:00-04:00,0,4,16,3,0,390,4250,4640
2016-04-28 17:00:00-04:00,0,4,17,3,0,710,10706,11416
2016-04-28 18:00:00-04:00,0,4,18,3,0,1436,18356,19792
2016-04-28 19:00:00-04:00,0,4,19,3,0,2301,21285,23586
2016-04-28 20:00:00-04:00,0,4,20,3,0,2250,19936,22186
2016-04-28 21:00:00-04:00,0,4,21,3,0,1853,17716,19569
2016-04-28 22:00:00-04:00,0,4,22,3,0,1770,17528,19298
2016-04-28 23:00:00-04:00,0,4,23,3,0,1770,18404,20174
2016-04-29 00:00:00-04:00,0,4,0,4,0,1800,18537,20337
2016-04-29 01:00:00-04:00,0,4,1,4,0,2098,19909,22007
2016-04-29 02:00:00-04:00,0,4,2,4,0,2321,19046,21367
2016-04-29 03:00:00-04:00,0,4,3,4,0,2600,16642,19242
2016-04-29 04:00:00-04:00,0,4,4,4,0,3052,21027,24079
2016-04-29 05:00:00-04:00,0,4,5,4,0,3585,26987,30572
2016-04-29 06:00:00-04:00,0,4,6,4,0,3287,26694,29981
2016-04-29 07:00:00-04:00,0,4,7,4,0,2844,25581,28425
2016-04-29 08:00:00-04:00,0,4,8,4,0,2716,25968,28684
2016-04-29 09:00:00-04:00,0,4,9,4,0,2673,25122,27795
2016-04-29 10:00:00-04:00,0,4,10,4,0,2366,20714,23080
2016-04-29 11:00:00-04:00,0,4,11,4,0,1747,14620,16367
2016-04-29 12:00:00-04:00,0,4,12,4,0,1349,9268,10617
2016-04-29 13:00:00-04:00,0,4,13,4,0,896,6073,6969
2016-04-29 14:00:00-04:00,0,4,14,4,0,651,4224,4875
2016-04-29 15:00:00-04:00,0,4,15,4,0,519,3524,4043
2016-04-29 16:00:00-04:00,0,4,16,4,0,420,4253,4673
2016-04-29 17:00:00-04:00,0,4,17,4,0,767,10100,10867
2016-04-29 18:00:00-04:00,0,4,18,4,0,1377,17052,18429
2016-04-29 19:00:00-04:00,0,4,19,4,0,2271,20464,22735
2016-04-29 20:00:00-04:00,0,4,20,4,0,2378,19829,22207
2016-04-29 21:00:00-04:00,0,4,21,4,0,2045,17636,19681
2016-04-29 22:00:00-04:00,0.01,4,22,4,0,1965,17835,19800
2016-04-29 23:00:00-04:00,0.01,4,23,4,0,1903,18649,20552
2016-04-30 00:00:00-04:00,0,4,0,5,0,1834,18246,20080
2016-04-30 01:00:00-04:00,0,4,1,5,0,2131,20432,22563
2016-04-30 02:00:00-04:00,0,4,2,5,0,2636,19286,21922
2016-04-30 03:00:00-04:00,0,4,3,5,0,2900,17201,20101
2016-04-30 04:00:00-04:00,0,4,4,5,0,3438,21867,25305
2016-04-30 05:00:00-04:00,0,4,5,5,0,4033,26983,31016
2016-04-30 06:00:00-04:00,0,4,6,5,0,4382,29771,34153
2016-04-30 07:00:00-04:00,0,4,7,5,0,3869,24340,28209
2016-04-30 08:00:00-04:00,0,4,8,5,0,3683,24108,27791
2016-04-30 09:00:00-04:00,0,4,9,5,0,4357,27051,31408
2016-04-30 10:00:00-04:00,0,4,10,5,0,4013,23748,27761
2016-04-30 11:00:00-04:00,0,4,11,5,0,3389,21381,24770
2016-04-30 12:00:00-04:00,0,4,12,5,0,2935,17959,20894
2016-04-30 13:00:00-04:00,0,4,13,5,0,2498,14665,17163
2016-04-30 14:00:00-04:00,0,4,14,5,0,1949,10997,12946
2016-04-30 15:00:00-04:00,0,4,15,5,0,1371,6988,8359
2016-04-30 16:00:00-04:00,0,4,16,5,0,749,3436,4185
2016-04-30 17:00:00-04:00,0,4,17,5,0,606,4766,5372
2016-04-30 18:00:00-04:00,0,4,18,5,0,793,6849,7642
2016-04-30 19:00:00-04:00,0,4,19,5,0,1243,10447,11690
2016-04-30 20:00:00-04:00,0,4,20,5,0,1629,14667,16296
2016-04-30 21:00:00-04:00,0,4,21,5,0,1892,17657,19549
2016-04-30 22:00:00-04:00,0,4,22,5,0,2102,19268,21370
2016-04-30 23:00:00-04:00,0,4,23,5,0,2290,20654,22944
2016-05-01 00:00:00-04:00,0,5,0,6,0,2356,21117,23473
2016-05-01 01:00:00-04:00,0,5,1,6,0,2520,20113,22633
2016-05-01 02:00:00-04:00,0,5,2,6,0,2790,20680,23470
2016-05-01 03:00:00-04:00,0,5,3,6,0,3088,18975,22063
2016-05-01 04:00:00-04:00,0,5,4,6,0,3143,21265,24408
2016-05-01 05:00:00-04:00,0,5,5,6,0,3717,24028,27745
2016-05-01 06:00:00-04:00,0,5,6,6,0,3976,26117,30093
2016-05-01 07:00:00-04:00,0,5,7,6,0,4031,23247,27278
2016-05-01 08:00:00-04:00,0.01,5,8,6,0,4019,23345,27364
2016-05-01 09:00:00-04:00,0.04,5,9,6,0,4337,25490,29827
2016-05-01 10:00:00-04:00,0.03,5,10,6,0,4482,26424,30906
2016-05-01 11:00:00-04:00,0.01,5,11,6,0,4056,24466,28522
2016-05-01 12:00:00-04:00,0.02,5,12,6,0,3504,21239,24743
2016-05-01 13:00:00-04:00,0.01,5,13,6,0,3021,18000,21021
2016-05-01 14:00:00-04:00,0,5,14,6,0,2403,13638,16041
2016-05-01 15:00:00-04:00,0,5,15,6,0,1801,8466,10267
2016-05-01 16:00:00-04:00,0.0001,5,16,6,0,849,3628,4477
2016-05-01 17:00:00-04:00,0.01,5,17,6,0,662,4086,4748
2016-05-01 18:00:00-04:00,0.02,5,18,6,0,636,5725,6361
2016-05-01 19:00:00-04:00,0,5,19,6,0,843,8726,9569
2016-05-01 20:00:00-04:00,0,5,20,6,0,1282,13021,14303
2016-05-01 21:00:00-04:00,0.01,5,21,6,0,1685,17584,19269
2016-05-01 22:00:00-04:00,0,5,22,6,0,1966,20930,22896
2016-05-01 23:00:00-04:00,0,5,23,6,0,2200,22550,24750
2016-05-02 00:00:00-04:00,0,5,0,0,0,2228,21664,23892
2016-05-02 01:00:00-04:00,0,5,1,0,0,2525,21007,23532
2016-05-02 02:00:00-04:00,0,5,2,0,0,2623,19754,22377
2016-05-02 03:00:00-04:00,0,5,3,0,0,2889,19996,22885
2016-05-02 04:00:00-04:00,0,5,4,0,0,2956,20867,23823
2016-05-02 05:00:00-04:00,0,5,5,0,0,3002,21624,24626
2016-05-02 06:00:00-04:00,0,5,6,0,0,2765,18843,21608
2016-05-02 07:00:00-04:00,0,5,7,0,0,2494,17107,19601
2016-05-02 08:00:00-04:00,0,5,8,0,0,2044,14907,16951
2016-05-02 09:00:00-04:00,0,5,9,0,0,1976,13093,15069
2016-05-02 10:00:00-04:00,0,5,10,0,0,1566,11180,12746
2016-05-02 11:00:00-04:00,0,5,11,0,0,1119,7435,8554
2016-05-02 12:00:00-04:00,0,5,12,0,0,718,4184,4902
2016-05-02 13:00:00-04:00,0,5,13,0,0,436,2480,2916
2016-05-02 14:00:00-04:00,0,5,14,0,0,367,1742,2109
2016-05-02 15:00:00-04:00,0,5,15,0,0,439,2268,2707
2016-05-02 16:00:00-04:00,0,5,16,0,0,436,3942,4378
2016-05-02 17:00:00-04:00,0,5,17,0,0,885,10478,11363
2016-05-02 18:00:00-04:00,0,5,18,0,0,1835,18215,20050
2016-05-02 19:00:00-04:00,0,5,19,0,0,2696,21234,23930
2016-05-02 20:00:00-04:00,0,5,20,0,0,2517,19373,21890
2016-05-02 21:00:00-04:00,0,5,21,0,0,2034,16782,18816
2016-05-02 22:00:00-04:00,0,5,22,0,0,1875,17051,18926
2016-05-02 23:00:00-04:00,0,5,23,0,0,1791,16997,18788
2016-05-03 00:00:00-04:00,0.03,5,0,1,0,1715,17267,18982
2016-05-03 01:00:00-04:00,0.06,5,1,1,0,1937,18483,20420
2016-05-03 02:00:00-04:00,0.1,5,2,1,0,2096,18787,20883
2016-05-03 03:00:00-04:00,0.1,5,3,1,0,2242,17596,19838
2016-05-03 04:00:00-04:00,0.11,5,4,1,0,2550,20955,23505
2016-05-03 05:00:00-04:00,0.16,5,5,1,0,2768,24405,27173
2016-05-03 06:00:00-04:00,0.15,5,6,1,0,2536,22508,25044
2016-05-03 07:00:00-04:00,0.02,5,7,1,0,2172,21425,23597
2016-05-03 08:00:00-04:00,0.01,5,8,1,0,2062,20567,22629
2016-05-03 09:00:00-04:00,0.02,5,9,1,0,1852,18471,20323
2016-05-03 10:00:00-04:00,0.02,5,10,1,0,1517,14930,16447
2016-05-03 11:00:00-04:00,0.01,5,11,1,0,1339,9936,11275
2016-05-03 12:00:00-04:00,0,5,12,1,0,812,5595,6407
2016-05-03 13:00:00-04:00,0,5,13,1,0,459,3552,4011
2016-05-03 14:00:00-04:00,0,5,14,1,0,324,2252,2576
2016-05-03 15:00:00-04:00,0,5,15,1,0,274,2388,2662
2016-05-03 16:00:00-04:00,0,5,16,1,0,401,4411,4812
2016-05-03 17:00:00-04:00,0,5,17,1,0,883,12215,13098
2016-05-03 18:00:00-04:00,0,5,18,1,0,1944,20378,22322
2016-05-03 19:00:00-04:00,0,5,19,1,0,2721,23692,26413
2016-05-03 20:00:00-04:00,0,5,20,1,0,2672,21623,24295
2016-05-03 21:00:00-04:00,0,5,21,1,0,2240,19993,22233
2016-05-03 22:00:00-04:00,0,5,22,1,0,2051,18904,20955
2016-05-03 23:00:00-04:00,0,5,23,1,0,1796,18666,20462
2016-05-04 00:00:00-04:00,0,5,0,2,0,1768,18493,20261
2016-05-04 01:00:00-04:00,0,5,1,2,0,2084,20298,22382
2016-05-04 02:00:00-04:00,0,5,2,2,0,2324,19708,22032
2016-05-04 03:00:00-04:00,0,5,3,2,0,2465,17454,19919
2016-05-04 04:00:00-04:00,0.0001,5,4,2,0,2763,21887,24650
2016-05-04 05:00:00-04:00,0.01,5,5,2,0,3042,26425,29467
2016-05-04 06:00:00-04:00,0,5,6,2,0,2895,25331,28226
2016-05-04 07:00:00-04:00,0,5,7,2,0,2581,24474,27055
2016-05-04 08:00:00-04:00,0,5,8,2,0,2391,24472,26863
2016-05-04 09:00:00-04:00,0,5,9,2,0,2279,21977,24256
2016-05-04 10:00:00-04:00,0,5,10,2,0,1757,16359,18116
2016-05-04 11:00:00-04:00,0,5,11,2,0,1225,9927,11152
2016-05-04 12:00:00-04:00,0,5,12,2,0,734,5921,6655
2016-05-04 13:00:00-04:00,0,5,13,2,0,464,3492,3956
2016-05-04 14:00:00-04:00,0,5,14,2,0,342,2424,2766
2016-05-04 15:00:00-04:00,0.01,5,15,2,0,341,2349,2690
2016-05-04 16:00:00-04:00,0.01,5,16,2,0,333,3851,4184
2016-05-04 17:00:00-04:00,0,5,17,2,0,817,11537,12354
2016-05-04 18:00:00-04:00,0,5,18,2,0,1787,20367,22154
2016-05-04 19:00:00-04:00,0,5,19,2,0,2600,23095,25695
2016-05-04 20:00:00-04:00,0,5,20,2,0,2479,21098,23577
2016-05-04 21:00:00-04:00,0,5,21,2,0,1980,19074,21054
2016-05-04 22:00:00-04:00,0,5,22,2,0,1893,19758,21651
2016-05-04 23:00:00-04:00,0,5,23,2,0,1923,20076,21999
2016-05-05 00:00:00-04:00,0,5,0,3,0,1909,19975,21884
2016-05-05 01:00:00-04:00,0,5,1,3,0,2343,22187,24530
2016-05-05 02:00:00-04:00,0,5,2,3,0,2574,20233,22807
2016-05-05 03:00:00-04:00,0,5,3,3,0,2732,16833,19565
2016-05-05 04:00:00-04:00,0,5,4,3,0,3185,20891,24076
2016-05-05 05:00:00-04:00,0,5,5,3,0,3441,24943,28384
2016-05-05 06:00:00-04:00,0,5,6,3,0,3186,26044,29230
2016-05-05 07:00:00-04:00,0,5,7,3,0,2901,25570,28471
2016-05-05 08:00:00-04:00,0,5,8,3,0,2470,25458,27928
2016-05-05 09:00:00-04:00,0,5,9,3,0,2470,23956,26426
2016-05-05 10:00:00-04:00,0,5,10,3,0,2042,18245,20287
2016-05-05 11:00:00-04:00,0,5,11,3,0,1419,11668,13087
2016-05-05 12:00:00-04:00,0,5,12,3,0,956,7037,7993
2016-05-05 13:00:00-04:00,0,5,13,3,0,571,4130,4701
2016-05-05 14:00:00-04:00,0,5,14,3,0,421,2711,3132
2016-05-05 15:00:00-04:00,0,5,15,3,0,389,2480,2869
2016-05-05 16:00:00-04:00,0,5,16,3,0,378,4240,4618
2016-05-05 17:00:00-04:00,0,5,17,3,0,849,11633,12482
2016-05-05 18:00:00-04:00,0,5,18,3,0,1859,20177,22036
2016-05-05 19:00:00-04:00,0,5,19,3,0,2641,23177,25818
2016-05-05 20:00:00-04:00,0,5,20,3,0,2508,21292,23800
2016-05-05 21:00:00-04:00,0,5,21,3,0,2090,19566,21656
2016-05-05 22:00:00-04:00,0,5,22,3,0,2065,19322,21387
2016-05-05 23:00:00-04:00,0,5,23,3,0,1989,20014,22003
2016-05-06 00:00:00-04:00,0,5,0,4,0,1919,19741,21660
2016-05-06 01:00:00-04:00,0,5,1,4,0,2263,21214,23477
2016-05-06 02:00:00-04:00,0.06,5,2,4,0,2566,19848,22414
2016-05-06 03:00:00-04:00,0.1,5,3,4,0,2840,16649,19489
2016-05-06 04:00:00-04:00,0.06,5,4,4,0,3221,21280,24501
2016-05-06 05:00:00-04:00,0.02,5,5,4,0,3699,26113,29812
2016-05-06 06:00:00-04:00,0.09,5,6,4,0,3465,27504,30969
2016-05-06 07:00:00-04:00,0.05,5,7,4,0,3133,27183,30316
2016-05-06 08:00:00-04:00,0.08,5,8,4,0,3139,27741,30880
2016-05-06 09:00:00-04:00,0.03,5,9,4,0,3226,25975,29201
2016-05-06 10:00:00-04:00,0.07,5,10,4,0,2953,23674,26627
2016-05-06 11:00:00-04:00,0.02,5,11,4,0,2356,19351,21707
2016-05-06 12:00:00-04:00,0,5,12,4,0,1682,13167,14849
2016-05-06 13:00:00-04:00,0,5,13,4,0,1254,8852,10106
2016-05-06 14:00:00-04:00,0,5,14,4,0,943,6108,7051
2016-05-06 15:00:00-04:00,0,5,15,4,0,694,4564,5258
2016-05-06 16:00:00-04:00,0,5,16,4,0,544,5031,5575
2016-05-06 17:00:00-04:00,0,5,17,4,0,935,12159,13094
2016-05-06 18:00:00-04:00,0,5,18,4,0,1915,20281,22196
2016-05-06 19:00:00-04:00,0,5,19,4,0,2863,23474,26337
2016-05-06 20:00:00-04:00,0,5,20,4,0,2588,21181,23769
2016-05-06 21:00:00-04:00,0,5,21,4,0,2563,20538,23101
2016-05-06 22:00:00-04:00,0,5,22,4,0,2149,19335,21484
2016-05-06 23:00:00-04:00,0,5,23,4,0,2103,19412,21515
2016-05-07 00:00:00-04:00,0,5,0,5,0,1981,18235,20216
2016-05-07 01:00:00-04:00,0,5,1,5,0,2325,19867,22192
2016-05-07 02:00:00-04:00,0,5,2,5,0,2740,18791,21531
2016-05-07 03:00:00-04:00,0,5,3,5,0,3192,16241,19433
2016-05-07 04:00:00-04:00,0,5,4,5,0,3658,21082,24740
2016-05-07 05:00:00-04:00,0,5,5,5,0,4167,26287,30454
2016-05-07 06:00:00-04:00,0,5,6,5,0,4358,28059,32417
2016-05-07 07:00:00-04:00,0,5,7,5,0,3914,24543,28457
2016-05-07 08:00:00-04:00,0,5,8,5,0,3588,23365,26953
2016-05-07 09:00:00-04:00,0,5,9,5,0,3755,24068,27823
2016-05-07 10:00:00-04:00,0,5,10,5,0,3793,23057,26850
2016-05-07 11:00:00-04:00,0,5,11,5,0,3582,21543,25125
2016-05-07 12:00:00-04:00,0,5,12,5,0,3144,18191,21335
2016-05-07 13:00:00-04:00,0,5,13,5,0,2417,14587,17004
2016-05-07 14:00:00-04:00,0,5,14,5,0,1816,11164,12980
2016-05-07 15:00:00-04:00,0,5,15,5,0,1435,7018,8453
2016-05-07 16:00:00-04:00,0,5,16,5,0,760,3543,4303
2016-05-07 17:00:00-04:00,0,5,17,5,0,778,4991,5769
2016-05-07 18:00:00-04:00,0,5,18,5,0,1068,7666,8734
2016-05-07 19:00:00-04:00,0,5,19,5,0,1574,11520,13094
2016-05-07 20:00:00-04:00,0,5,20,5,0,1988,16902,18890
2016-05-07 21:00:00-04:00,0,5,21,5,0,2289,20096,22385
2016-05-07 22:00:00-04:00,0,5,22,5,0,2547,21668,24215
2016-05-07 23:00:00-04:00,0,5,23,5,0,2667,22975,25642
2016-05-08 00:00:00-04:00,0,5,0,6,0,2743,23560,26303
2016-05-08 01:00:00-04:00,0,5,1,6,0,2947,22458,25405
2016-05-08 02:00:00-04:00,0,5,2,6,0,3305,22151,25456
2016-05-08 03:00:00-04:00,0,5,3,6,0,3399,19928,23327
2016-05-08 04:00:00-04:00,0,5,4,6,0,3602,21996,25598
2016-05-08 05:00:00-04:00,0,5,5,6,0,3870,23270,27140
2016-05-08 06:00:00-04:00,0,5,6,6,0,4326,25523,29849
2016-05-08 07:00:00-04:00,0.07,5,7,6,0,3976,22232,26208
2016-05-08 08:00:00-04:00,0.07,5,8,6,0,4174,21813,25987
2016-05-08 09:00:00-04:00,0.01,5,9,6,0,4408,23818,28226
2016-05-08 10:00:00-04:00,0,5,10,6,0,4632,24686,29318
2016-05-08 11:00:00-04:00,0,5,11,6,0,4177,22619,26796
2016-05-08 12:00:00-04:00,0,5,12,6,0,3833,19435,23268
2016-05-08 13:00:00-04:00,0,5,13,6,0,3367,16304,19671
2016-05-08 14:00:00-04:00,0,5,14,6,0,2531,12241,14772
2016-05-08 15:00:00-04:00,0,5,15,6,0,1947,7901,9848
2016-05-08 16:00:00-04:00,0,5,16,6,0,962,3692,4654
2016-05-08 17:00:00-04:00,0,5,17,6,0,652,3867,4519
2016-05-08 18:00:00-04:00,0,5,18,6,0,746,6567,7313
2016-05-08 19:00:00-04:00,0,5,19,6,0,994,9066,10060
2016-05-08 20:00:00-04:00,0,5,20,6,0,1372,12787,14159
2016-05-08 21:00:00-04:00,0,5,21,6,0,1897,18436,20333
2016-05-08 22:00:00-04:00,0,5,22,6,0,2234,20400,22634
2016-05-08 23:00:00-04:00,0,5,23,6,0,2374,20786,23160
2016-05-09 00:00:00-04:00,0,5,0,0,0,2473,20364,22837
2016-05-09 01:00:00-04:00,0,5,1,0,0,2778,20746,23524
2016-05-09 02:00:00-04:00,0,5,2,0,0,3048,19222,22270
2016-05-09 03:00:00-04:00,0,5,3,0,0,2984,18573,21557
2016-05-09 04:00:00-04:00,0,5,4,0,0,3026,19454,22480
2016-05-09 05:00:00-04:00,0,5,5,0,0,3145,20155,23300
2016-05-09 06:00:00-04:00,0,5,6,0,0,3143,19166,22309
2016-05-09 07:00:00-04:00,0,5,7,0,0,2905,18530,21435
2016-05-09 08:00:00-04:00,0,5,8,0,0,2708,16693,19401
2016-05-09 09:00:00-04:00,0,5,9,0,0,2573,14801,17374
2016-05-09 10:00:00-04:00,0,5,10,0,0,2115,11412,13527
2016-05-09 11:00:00-04:00,0,5,11,0,0,1466,7219,8685
2016-05-09 12:00:00-04:00,0,5,12,0,0,934,4230,5164
2016-05-09 13:00:00-04:00,0,5,13,0,0,588,2651,3239
2016-05-09 14:00:00-04:00,0,5,14,0,0,432,2002,2434
2016-05-09 15:00:00-04:00,0,5,15,0,0,510,2295,2805
2016-05-09 16:00:00-04:00,0,5,16,0,0,496,4451,4947
2016-05-09 17:00:00-04:00,0,5,17,0,0,834,10762,11596
2016-05-09 18:00:00-04:00,0,5,18,0,0,1761,17475,19236
2016-05-09 19:00:00-04:00,0,5,19,0,0,2428,19453,21881
2016-05-09 20:00:00-04:00,0,5,20,0,0,2229,17755,19984
2016-05-09 21:00:00-04:00,0,5,21,0,0,1922,15749,17671
2016-05-09 22:00:00-04:00,0,5,22,0,0,1644,16431,18075
2016-05-09 23:00:00-04:00,0,5,23,0,0,1651,16585,18236
2016-05-10 00:00:00-04:00,0,5,0,1,0,1657,16968,18625
2016-05-10 01:00:00-04:00,0,5,1,1,0,2013,18880,20893
2016-05-10 02:00:00-04:00,0,5,2,1,0,2168,19206,21374
2016-05-10 03:00:00-04:00,0,5,3,1,0,2281,17230,19511
2016-05-10 04:00:00-04:00,0,5,4,1,0,2570,20463,23033
2016-05-10 05:00:00-04:00,0,5,5,1,0,2748,23738,26486
2016-05-10 06:00:00-04:00,0,5,6,1,0,2485,21900,24385
2016-05-10 07:00:00-04:00,0,5,7,1,0,2202,21006,23208
2016-05-10 08:00:00-04:00,0,5,8,1,0,1970,21140,23110
2016-05-10 09:00:00-04:00,0,5,9,1,0,1792,18523,20315
2016-05-10 10:00:00-04:00,0,5,10,1,0,1500,13177,14677
2016-05-10 11:00:00-04:00,0,5,11,1,0,1131,8354,9485
2016-05-10 12:00:00-04:00,0,5,12,1,0,738,4932,5670
2016-05-10 13:00:00-04:00,0,5,13,1,0,492,3116,3608
2016-05-10 14:00:00-04:00,0,5,14,1,0,314,1940,2254
2016-05-10 15:00:00-04:00,0,5,15,1,0,297,2042,2339
2016-05-10 16:00:00-04:00,0,5,16,1,0,375,3982,4357
2016-05-10 17:00:00-04:00,0,5,17,1,0,788,10631,11419
2016-05-10 18:00:00-04:00,0,5,18,1,0,1719,18747,20466
2016-05-10 19:00:00-04:00,0,5,19,1,0,2373,21202,23575
2016-05-10 20:00:00-04:00,0,5,20,1,0,2214,19089,21303
2016-05-10 21:00:00-04:00,0,5,21,1,0,1784,17216,19000
2016-05-10 22:00:00-04:00,0,5,22,1,0,1775,17211,18986
2016-05-10 23:00:00-04:00,0,5,23,1,0,1695,17970,19665
2016-05-11 00:00:00-04:00,0,5,0,2,0,1710,18305,20015
2016-05-11 01:00:00-04:00,0,5,1,2,0,2064,20660,22724
2016-05-11 02:00:00-04:00,0,5,2,2,0,2202,19884,22086
2016-05-11 03:00:00-04:00,0,5,3,2,0,2509,17173,19682
2016-05-11 04:00:00-04:00,0,5,4,2,0,2759,20559,23318
2016-05-11 05:00:00-04:00,0,5,5,2,0,2955,25164,28119
2016-05-11 06:00:00-04:00,0,5,6,2,0,2730,23520,26250
2016-05-11 07:00:00-04:00,0,5,7,2,0,2470,23649,26119
2016-05-11 08:00:00-04:00,0,5,8,2,0,2288,23720,26008
2016-05-11 09:00:00-04:00,0,5,9,2,0,2053,21069,23122
2016-05-11 10:00:00-04:00,0,5,10,2,0,1699,16179,17878
2016-05-11 11:00:00-04:00,0,5,11,2,0,1221,9951,11172
2016-05-11 12:00:00-04:00,0,5,12,2,0,840,5780,6620
2016-05-11 13:00:00-04:00,0,5,13,2,0,443,3604,4047
2016-05-11 14:00:00-04:00,0,5,14,2,0,326,2417,2743
2016-05-11 15:00:00-04:00,0,5,15,2,0,347,2342,2689
2016-05-11 16:00:00-04:00,0,5,16,2,0,392,4060,4452
2016-05-11 17:00:00-04:00,0,5,17,2,0,774,10490,11264
2016-05-11 18:00:00-04:00,0,5,18,2,0,1710,19020,20730
2016-05-11 19:00:00-04:00,0,5,19,2,0,2358,21253,23611
2016-05-11 20:00:00-04:00,0,5,20,2,0,2193,19768,21961
2016-05-11 21:00:00-04:00,0,5,21,2,0,1889,17658,19547
2016-05-11 22:00:00-04:00,0,5,22,2,0,1723,17715,19438
2016-05-11 23:00:00-04:00,0,5,23,2,0,1826,18693,20519
2016-05-12 00:00:00-04:00,0,5,0,3,0,1820,18445,20265
2016-05-12 01:00:00-04:00,0,5,1,3,0,2136,19744,21880
2016-05-12 02:00:00-04:00,0,5,2,3,0,2241,18933,21174
2016-05-12 03:00:00-04:00,0,5,3,3,0,2271,16049,18320
2016-05-12 04:00:00-04:00,0,5,4,3,0,2723,19453,22176
2016-05-12 05:00:00-04:00,0,5,5,3,0,3033,23487,26520
2016-05-12 06:00:00-04:00,0,5,6,3,0,2943,23962,26905
2016-05-12 07:00:00-04:00,0,5,7,3,0,2620,24247,26867
2016-05-12 08:00:00-04:00,0,5,8,3,0,2336,24681,27017
2016-05-12 09:00:00-04:00,0,5,9,3,0,2334,23301,25635
2016-05-12 10:00:00-04:00,0,5,10,3,0,2090,18451,20541
2016-05-12 11:00:00-04:00,0,5,11,3,0,1539,12054,13593
2016-05-12 12:00:00-04:00,0,5,12,3,0,999,7369,8368
2016-05-12 13:00:00-04:00,0,5,13,3,0,657,4581,5238
2016-05-12 14:00:00-04:00,0,5,14,3,0,430,2882,3312
2016-05-12 15:00:00-04:00,0,5,15,3,0,447,2724,3171
2016-05-12 16:00:00-04:00,0,5,16,3,0,412,4273,4685
2016-05-12 17:00:00-04:00,0,5,17,3,0,794,10896,11690
2016-05-12 18:00:00-04:00,0,5,18,3,0,1740,19287,21027
2016-05-12 19:00:00-04:00,0,5,19,3,0,2380,21637,24017
2016-05-12 20:00:00-04:00,0,5,20,3,0,2323,19630,21953
2016-05-12 21:00:00-04:00,0,5,21,3,0,1937,17974,19911
2016-05-12 22:00:00-04:00,0,5,22,3,0,1919,18036,19955
2016-05-12 23:00:00-04:00,0,5,23,3,0,1906,18610,20516
2016-05-13 00:00:00-04:00,0,5,0,4,0,1818,19000,20818
2016-05-13 01:00:00-04:00,0,5,1,4,0,2182,20159,22341
2016-05-13 02:00:00-04:00,0,5,2,4,0,2360,18698,21058
2016-05-13 03:00:00-04:00,0,5,3,4,0,2611,15145,17756
2016-05-13 04:00:00-04:00,0,5,4,4,0,2888,19030,21918
2016-05-13 05:00:00-04:00,0,5,5,4,0,3240,24658,27898
2016-05-13 06:00:00-04:00,0,5,6,4,0,3429,26162,29591
2016-05-13 07:00:00-04:00,0,5,7,4,0,3551,26145,29696
2016-05-13 08:00:00-04:00,0,5,8,4,0,3141,25923,29064
2016-05-13 09:00:00-04:00,0,5,9,4,0,3057,23942,26999
2016-05-13 10:00:00-04:00,0,5,10,4,0,2667,21273,23940
2016-05-13 11:00:00-04:00,0,5,11,4,0,1971,16364,18335
2016-05-13 12:00:00-04:00,0,5,12,4,0,1341,10491,11832
2016-05-13 13:00:00-04:00,0,5,13,4,0,925,6945,7870
2016-05-13 14:00:00-04:00,0.01,5,14,4,0,594,4593,5187
2016-05-13 15:00:00-04:00,0.05,5,15,4,0,529,3980,4509
2016-05-13 16:00:00-04:00,0.1,5,16,4,0,494,4750,5244
2016-05-13 17:00:00-04:00,0.07,5,17,4,0,866,10556,11422
2016-05-13 18:00:00-04:00,0.02,5,18,4,0,1810,18299,20109
2016-05-13 19:00:00-04:00,0,5,19,4,0,2602,21355,23957
2016-05-13 20:00:00-04:00,0,5,20,4,0,2392,19559,21951
2016-05-13 21:00:00-04:00,0,5,21,4,0,2017,18096,20113
2016-05-13 22:00:00-04:00,0,5,22,4,0,1961,18331,20292
2016-05-13 23:00:00-04:00,0,5,23,4,0,1840,18381,20221
2016-05-14 00:00:00-04:00,0,5,0,5,0,1797,17584,19381
2016-05-14 01:00:00-04:00,0,5,1,5,0,2477,20039,22516
2016-05-14 02:00:00-04:00,0,5,2,5,0,3074,17355,20429
2016-05-14 03:00:00-04:00,0,5,3,5,0,3534,14040,17574
2016-05-14 04:00:00-04:00,0,5,4,5,0,3950,17215,21165
2016-05-14 05:00:00-04:00,0,5,5,5,0,3991,21215,25206
2016-05-14 06:00:00-04:00,0,5,6,5,0,3747,23752,27499
2016-05-14 07:00:00-04:00,0,5,7,5,0,3244,22979,26223
2016-05-14 08:00:00-04:00,0,5,8,5,0,3408,22791,26199
2016-05-14 09:00:00-04:00,0,5,9,5,0,3422,23977,27399
2016-05-14 10:00:00-04:00,0,5,10,5,0,3699,24415,28114
2016-05-14 11:00:00-04:00,0,5,11,5,0,3461,22070,25531
2016-05-14 12:00:00-04:00,0,5,12,5,0,2974,19079,22053
2016-05-14 13:00:00-04:00,0,5,13,5,0,2538,15689,18227
2016-05-14 14:00:00-04:00,0,5,14,5,0,2097,11715,13812
2016-05-14 15:00:00-04:00,0,5,15,5,0,1515,7548,9063
2016-05-14 16:00:00-04:00,0,5,16,5,0,857,4025,4882
2016-05-14 17:00:00-04:00,0,5,17,5,0,657,4942,5599
2016-05-14 18:00:00-04:00,0,5,18,5,0,994,7363,8357
2016-05-14 19:00:00-04:00,0,5,19,5,0,1497,12230,13727
2016-05-14 20:00:00-04:00,0,5,20,5,0,1885,16645,18530
2016-05-14 21:00:00-04:00,0,5,21,5,0,2271,19626,21897
2016-05-14 22:00:00-04:00,0,5,22,5,0,2572,20943,23515
2016-05-14 23:00:00-04:00,0,5,23,5,0,2718,22447,25165
2016-05-15 00:00:00-04:00,0,5,0,6,0,2704,22717,25421
2016-05-15 01:00:00-04:00,0,5,1,6,0,2954,21425,24379
2016-05-15 02:00:00-04:00,0,5,2,6,0,3113,20711,23824
2016-05-15 03:00:00-04:00,0,5,3,6,0,3226,18085,21311
2016-05-15 04:00:00-04:00,0,5,4,6,0,3526,20916,24442
2016-05-15 05:00:00-04:00,0,5,5,6,0,4580,26382,30962
2016-05-15 06:00:00-04:00,0,5,6,6,0,4221,24458,28679
2016-05-15 07:00:00-04:00,0,5,7,6,0,4034,22866,26900
2016-05-15 08:00:00-04:00,0,5,8,6,0,4041,21835,25876
2016-05-15 09:00:00-04:00,0,5,9,6,0,4340,24932,29272
2016-05-15 10:00:00-04:00,0,5,10,6,0,4623,26660,31283
2016-05-15 11:00:00-04:00,0,5,11,6,0,4217,24925,29142
2016-05-15 12:00:00-04:00,0,5,12,6,0,3857,21312,25169
2016-05-15 13:00:00-04:00,0,5,13,6,0,3101,18409,21510
2016-05-15 14:00:00-04:00,0,5,14,6,0,2470,13990,16460
2016-05-15 15:00:00-04:00,0,5,15,6,0,1814,9001,10815
2016-05-15 16:00:00-04:00,0,5,16,6,0,892,4195,5087
2016-05-15 17:00:00-04:00,0,5,17,6,0,649,4280,4929
2016-05-15 18:00:00-04:00,0,5,18,6,0,681,5863,6544
2016-05-15 19:00:00-04:00,0,5,19,6,0,994,9480,10474
2016-05-15 20:00:00-04:00,0,5,20,6,0,1404,14245,15649
2016-05-15 21:00:00-04:00,0,5,21,6,0,1839,18462,20301
2016-05-15 22:00:00-04:00,0,5,22,6,0,2334,22780,25114
2016-05-15 23:00:00-04:00,0,5,23,6,0,2410,23478,25888
2016-05-16 00:00:00-04:00,0,5,0,0,0,2468,23379,25847
2016-05-16 01:00:00-04:00,0,5,1,0,0,2872,23849,26721
2016-05-16 02:00:00-04:00,0,5,2,0,0,2797,21348,24145
2016-05-16 03:00:00-04:00,0,5,3,0,0,2913,19351,22264
2016-05-16 04:00:00-04:00,0,5,4,0,0,2947,20099,23046
2016-05-16 05:00:00-04:00,0,5,5,0,0,3098,21123,24221
2016-05-16 06:00:00-04:00,0,5,6,0,0,3279,21103,24382
2016-05-16 07:00:00-04:00,0,5,7,0,0,2915,19232,22147
2016-05-16 08:00:00-04:00,0,5,8,0,0,2789,18540,21329
2016-05-16 09:00:00-04:00,0,5,9,0,0,2657,16971,19628
2016-05-16 10:00:00-04:00,0,5,10,0,0,2154,12866,15020
2016-05-16 11:00:00-04:00,0,5,11,0,0,1469,8355,9824
2016-05-16 12:00:00-04:00,0,5,12,0,0,904,4717,5621
2016-05-16 13:00:00-04:00,0,5,13,0,0,617,2899,3516
2016-05-16 14:00:00-04:00,0,5,14,0,0,451,2047,2498
2016-05-16 15:00:00-04:00,0,5,15,0,0,527,2509,3036
2016-05-16 16:00:00-04:00,0,5,16,0,0,526,4487,5013
2016-05-16 17:00:00-04:00,0,5,17,0,0,950,11154,12104
2016-05-16 18:00:00-04:00,0,5,18,0,0,1807,18744,20551
2016-05-16 19:00:00-04:00,0,5,19,0,0,2610,21074,23684
2016-05-16 20:00:00-04:00,0,5,20,0,0,2494,19886,22380
2016-05-16 21:00:00-04:00,0,5,21,0,0,1856,17769,19625
2016-05-16 22:00:00-04:00,0,5,22,0,0,1756,17305,19061
2016-05-16 23:00:00-04:00,0,5,23,0,0,1696,18381,20077
2016-05-17 00:00:00-04:00,0,5,0,1,0,1671,18119,19790
2016-05-17 01:00:00-04:00,0,5,1,1,0,1881,19942,21823
2016-05-17 02:00:00-04:00,0,5,2,1,0,2062,19687,21749
2016-05-17 03:00:00-04:00,0,5,3,1,0,2348,17341,19689
2016-05-17 04:00:00-04:00,0,5,4,1,0,2497,21137,23634
2016-05-17 05:00:00-04:00,0,5,5,1,0,2815,24350,27165
2016-05-17 06:00:00-04:00,0,5,6,1,0,2609,24216,26825
2016-05-17 07:00:00-04:00,0,5,7,1,0,2263,23969,26232
2016-05-17 08:00:00-04:00,0,5,8,1,0,2046,23518,25564
2016-05-17 09:00:00-04:00,0,5,9,1,0,1765,21227,22992
2016-05-17 10:00:00-04:00,0,5,10,1,0,1653,15996,17649
2016-05-17 11:00:00-04:00,0,5,11,1,0,1189,10848,12037
2016-05-17 12:00:00-04:00,0,5,12,1,0,781,5835,6616
2016-05-17 13:00:00-04:00,0,5,13,1,0,490,3598,4088
2016-05-17 14:00:00-04:00,0,5,14,1,0,337,2241,2578
2016-05-17 15:00:00-04:00,0,5,15,1,0,325,2232,2557
2016-05-17 16:00:00-04:00,0,5,16,1,0,421,4205,4626
2016-05-17 17:00:00-04:00,0,5,17,1,0,771,10770,11541
2016-05-17 18:00:00-04:00,0,5,18,1,0,1792,19415,21207
2016-05-17 19:00:00-04:00,0,5,19,1,0,2464,22053,24517
2016-05-17 20:00:00-04:00,0,5,20,1,0,2228,20471,22699
2016-05-17 21:00:00-04:00,0,5,21,1,0,1878,18630,20508
2016-05-17 22:00:00-04:00,0,5,22,1,0,1838,18800,20638
2016-05-17 23:00:00-04:00,0,5,23,1,0,1917,19571,21488
2016-05-18 00:00:00-04:00,0,5,0,2,0,1785,19107,20892
2016-05-18 01:00:00-04:00,0,5,1,2,0,2155,21142,23297
2016-05-18 02:00:00-04:00,0,5,2,2,0,2329,19498,21827
2016-05-18 03:00:00-04:00,0,5,3,2,0,2495,15909,18404
2016-05-18 04:00:00-04:00,0,5,4,2,0,2933,20565,23498
2016-05-18 05:00:00-04:00,0,5,5,2,0,3199,24689,27888
2016-05-18 06:00:00-04:00,0,5,6,2,0,2931,25801,28732
2016-05-18 07:00:00-04:00,0,5,7,2,0,2607,25192,27799
2016-05-18 08:00:00-04:00,0,5,8,2,0,2510,25205,27715
2016-05-18 09:00:00-04:00,0,5,9,2,0,2294,23278,25572
2016-05-18 10:00:00-04:00,0,5,10,2,0,2040,18573,20613
2016-05-18 11:00:00-04:00,0,5,11,2,0,1339,11758,13097
2016-05-18 12:00:00-04:00,0,5,12,2,0,841,6639,7480
2016-05-18 13:00:00-04:00,0,5,13,2,0,534,4172,4706
2016-05-18 14:00:00-04:00,0,5,14,2,0,374,2738,3112
2016-05-18 15:00:00-04:00,0,5,15,2,0,351,2668,3019
2016-05-18 16:00:00-04:00,0,5,16,2,0,413,4245,4658
2016-05-18 17:00:00-04:00,0,5,17,2,0,803,11064,11867
2016-05-18 18:00:00-04:00,0,5,18,2,0,1762,20014,21776
2016-05-18 19:00:00-04:00,0,5,19,2,0,2528,21874,24402
2016-05-18 20:00:00-04:00,0,5,20,2,0,2313,19982,22295
2016-05-18 21:00:00-04:00,0,5,21,2,0,1949,17780,19729
2016-05-18 22:00:00-04:00,0,5,22,2,0,1807,17754,19561
2016-05-18 23:00:00-04:00,0,5,23,2,0,1966,18243,20209
2016-05-19 00:00:00-04:00,0,5,0,3,0,1900,17754,19654
2016-05-19 01:00:00-04:00,0,5,1,3,0,2136,17978,20114
2016-05-19 02:00:00-04:00,0,5,2,3,0,2280,15368,17648
2016-05-19 03:00:00-04:00,0,5,3,3,0,2513,12704,15217
2016-05-19 04:00:00-04:00,0,5,4,3,0,3160,17486,20646
2016-05-19 05:00:00-04:00,0,5,5,3,0,3428,22448,25876
2016-05-19 06:00:00-04:00,0,5,6,3,0,3113,24045,27158
2016-05-19 07:00:00-04:00,0,5,7,3,0,2886,24804,27690
2016-05-19 08:00:00-04:00,0,5,8,3,0,2881,25975,28856
2016-05-19 09:00:00-04:00,0,5,9,3,0,2655,24230,26885
2016-05-19 10:00:00-04:00,0,5,10,3,0,2167,19661,21828
2016-05-19 11:00:00-04:00,0,5,11,3,0,1497,12903,14400
2016-05-19 12:00:00-04:00,0,5,12,3,0,1005,7775,8780
2016-05-19 13:00:00-04:00,0,5,13,3,0,620,4953,5573
2016-05-19 14:00:00-04:00,0,5,14,3,0,450,3363,3813
2016-05-19 15:00:00-04:00,0,5,15,3,0,425,2996,3421
2016-05-19 16:00:00-04:00,0,5,16,3,0,416,4622,5038
2016-05-19 17:00:00-04:00,0,5,17,3,0,843,11566,12409
2016-05-19 18:00:00-04:00,0,5,18,3,0,1805,19688,21493
2016-05-19 19:00:00-04:00,0,5,19,3,0,2539,21765,24304
2016-05-19 20:00:00-04:00,0,5,20,3,0,2365,20440,22805
2016-05-19 21:00:00-04:00,0,5,21,3,0,1889,18428,20317
2016-05-19 22:00:00-04:00,0,5,22,3,0,1889,18339,20228
2016-05-19 23:00:00-04:00,0,5,23,3,0,1873,19150,21023
2016-05-20 00:00:00-04:00,0,5,0,4,0,1940,19691,21631
2016-05-20 01:00:00-04:00,0,5,1,4,0,2277,20669,22946
2016-05-20 02:00:00-04:00,0,5,2,4,0,2517,18097,20614
2016-05-20 03:00:00-04:00,0,5,3,4,0,2549,14527,17076
2016-05-20 04:00:00-04:00,0,5,4,4,0,3005,18823,21828
2016-05-20 05:00:00-04:00,0,5,5,4,0,3458,23737,27195
2016-05-20 06:00:00-04:00,0,5,6,4,0,3324,25521,28845
2016-05-20 07:00:00-04:00,0,5,7,4,0,3146,26229,29375
2016-05-20 08:00:00-04:00,0,5,8,4,0,3151,26170,29321
2016-05-20 09:00:00-04:00,0,5,9,4,0,2963,24722,27685
2016-05-20 10:00:00-04:00,0,5,10,4,0,2647,21861,24508
2016-05-20 11:00:00-04:00,0,5,11,4,0,2043,16668,18711
2016-05-20 12:00:00-04:00,0,5,12,4,0,1491,11029,12520
2016-05-20 13:00:00-04:00,0,5,13,4,0,934,7443,8377
2016-05-20 14:00:00-04:00,0,5,14,4,0,714,4934,5648
2016-05-20 15:00:00-04:00,0,5,15,4,0,594,4127,4721
2016-05-20 16:00:00-04:00,0,5,16,4,0,518,4871,5389
2016-05-20 17:00:00-04:00,0,5,17,4,0,820,10709,11529
2016-05-20 18:00:00-04:00,0,5,18,4,0,1795,18272,20067
2016-05-20 19:00:00-04:00,0,5,19,4,0,2504,21125,23629
2016-05-20 20:00:00-04:00,0,5,20,4,0,2405,19926,22331
2016-05-20 21:00:00-04:00,0,5,21,4,0,1986,17925,19911
2016-05-20 22:00:00-04:00,0,5,22,4,0,1812,18021,19833
2016-05-20 23:00:00-04:00,0,5,23,4,0,1856,18549,20405
2016-05-21 00:00:00-04:00,0,5,0,5,0,1717,17972,19689
2016-05-21 01:00:00-04:00,0,5,1,5,0,2271,19625,21896
2016-05-21 02:00:00-04:00,0,5,2,5,0,2576,17438,20014
2016-05-21 03:00:00-04:00,0,5,3,5,0,2893,15150,18043
2016-05-21 04:00:00-04:00,0,5,4,5,0,3157,19280,22437
2016-05-21 05:00:00-04:00,0,5,5,5,0,3862,24784,28646
2016-05-21 06:00:00-04:00,0,5,6,5,0,3995,27248,31243
2016-05-21 07:00:00-04:00,0,5,7,5,0,3713,25259,28972
2016-05-21 08:00:00-04:00,0,5,8,5,0,3813,25037,28850
2016-05-21 09:00:00-04:00,0,5,9,5,0,3916,25286,29202
2016-05-21 10:00:00-04:00,0,5,10,5,0,4085,24033,28118
2016-05-21 11:00:00-04:00,0,5,11,5,0,3934,21876,25810
2016-05-21 12:00:00-04:00,0,5,12,5,0,3449,19511,22960
2016-05-21 13:00:00-04:00,0,5,13,5,0,2797,16553,19350
2016-05-21 14:00:00-04:00,0,5,14,5,0,2232,12251,14483
2016-05-21 15:00:00-04:00,0,5,15,5,0,1699,8229,9928
2016-05-21 16:00:00-04:00,0,5,16,5,0,1021,5230,6251
2016-05-21 17:00:00-04:00,0,5,17,5,0,878,6108,6986
2016-05-21 18:00:00-04:00,0,5,18,5,0,1012,7558,8570
2016-05-21 19:00:00-04:00,0.05,5,19,5,0,1400,11462,12862
2016-05-21 20:00:00-04:00,0,5,20,5,0,1774,16194,17968
2016-05-21 21:00:00-04:00,0,5,21,5,0,2108,18326,20434
2016-05-21 22:00:00-04:00,0.01,5,22,5,0,2365,20397,22762
2016-05-21 23:00:00-04:00,0.01,5,23,5,0,2597,21957,24554
2016-05-22 00:00:00-04:00,0,5,0,6,0,2663,21933,24596
2016-05-22 01:00:00-04:00,0,5,1,6,0,2867,22099,24966
2016-05-22 02:00:00-04:00,0,5,2,6,0,3098,20056,23154
2016-05-22 03:00:00-04:00,0,5,3,6,0,3273,18217,21490
2016-05-22 04:00:00-04:00,0.03,5,4,6,0,3380,20843,24223
2016-05-22 05:00:00-04:00,0.06,5,5,6,0,4191,26029,30220
2016-05-22 06:00:00-04:00,0.02,5,6,6,0,4875,27901,32776
2016-05-22 07:00:00-04:00,0,5,7,6,0,3766,21668,25434
2016-05-22 08:00:00-04:00,0,5,8,6,0,3987,22608,26595
2016-05-22 09:00:00-04:00,0,5,9,6,0,4129,24636,28765
2016-05-22 10:00:00-04:00,0,5,10,6,0,4263,24252,28515
2016-05-22 11:00:00-04:00,0,5,11,6,0,3883,21839,25722
2016-05-22 12:00:00-04:00,0,5,12,6,0,3446,19708,23154
2016-05-22 13:00:00-04:00,0,5,13,6,0,2802,16776,19578
2016-05-22 14:00:00-04:00,0,5,14,6,0,2310,12925,15235
2016-05-22 15:00:00-04:00,0,5,15,6,0,1736,8636,10372
2016-05-22 16:00:00-04:00,0,5,16,6,0,877,3911,4788
2016-05-22 17:00:00-04:00,0,5,17,6,0,640,4164,4804
2016-05-22 18:00:00-04:00,0,5,18,6,0,759,5616,6375
2016-05-22 19:00:00-04:00,0,5,19,6,0,965,8520,9485
2016-05-22 20:00:00-04:00,0,5,20,6,0,1354,12499,13853
2016-05-22 21:00:00-04:00,0,5,21,6,0,1771,16939,18710
2016-05-22 22:00:00-04:00,0,5,22,6,0,2046,18866,20912
2016-05-22 23:00:00-04:00,0,5,23,6,0,2253,20293,22546
2016-05-23 00:00:00-04:00,0,5,0,0,0,2276,20615,22891
2016-05-23 01:00:00-04:00,0,5,1,0,0,2464,20659,23123
2016-05-23 02:00:00-04:00,0,5,2,0,0,2752,19801,22553
2016-05-23 03:00:00-04:00,0,5,3,0,0,2788,18706,21494
2016-05-23 04:00:00-04:00,0,5,4,0,0,2723,19520,22243
2016-05-23 05:00:00-04:00,0,5,5,0,0,2879,20086,22965
2016-05-23 06:00:00-04:00,0,5,6,0,0,2841,18789,21630
2016-05-23 07:00:00-04:00,0,5,7,0,0,2465,17397,19862
2016-05-23 08:00:00-04:00,0,5,8,0,0,2382,16247,18629
2016-05-23 09:00:00-04:00,0,5,9,0,0,2268,15074,17342
2016-05-23 10:00:00-04:00,0,5,10,0,0,1893,11745,13638
2016-05-23 11:00:00-04:00,0,5,11,0,0,1314,7429,8743
2016-05-23 12:00:00-04:00,0,5,12,0,0,854,4287,5141
2016-05-23 13:00:00-04:00,0,5,13,0,0,580,2840,3420
2016-05-23 14:00:00-04:00,0,5,14,0,0,443,2047,2490
2016-05-23 15:00:00-04:00,0,5,15,0,0,529,2569,3098
2016-05-23 16:00:00-04:00,0,5,16,0,0,491,4372,4863
2016-05-23 17:00:00-04:00,0,5,17,0,0,848,10454,11302
2016-05-23 18:00:00-04:00,0,5,18,0,0,1716,17524,19240
2016-05-23 19:00:00-04:00,0,5,19,0,0,2374,19504,21878
2016-05-23 20:00:00-04:00,0,5,20,0,0,2140,17734,19874
2016-05-23 21:00:00-04:00,0,5,21,0,0,1798,15549,17347
2016-05-23 22:00:00-04:00,0,5,22,0,0,1580,15331,16911
2016-05-23 23:00:00-04:00,0,5,23,0,0,1620,16526,18146
2016-05-24 00:00:00-04:00,0,5,0,1,0,1670,16857,18527
2016-05-24 01:00:00-04:00,0,5,1,1,0,1875,18317,20192
2016-05-24 02:00:00-04:00,0.02,5,2,1,0,2087,18514,20601
2016-05-24 03:00:00-04:00,0.01,5,3,1,0,2228,16566,18794
2016-05-24 04:00:00-04:00,0.05,5,4,1,0,2597,21243,23840
2016-05-24 05:00:00-04:00,0.06,5,5,1,0,2832,23804,26636
2016-05-24 06:00:00-04:00,0.08,5,6,1,0,2462,22289,24751
2016-05-24 07:00:00-04:00,0.04,5,7,1,0,2049,20863,22912
2016-05-24 08:00:00-04:00,0.02,5,8,1,0,1939,21161,23100
2016-05-24 09:00:00-04:00,0,5,9,1,0,1712,18064,19776
2016-05-24 10:00:00-04:00,0,5,10,1,0,1530,13147,14677
2016-05-24 11:00:00-04:00,0,5,11,1,0,1128,8264,9392
2016-05-24 12:00:00-04:00,0,5,12,1,0,743,4604,5347
2016-05-24 13:00:00-04:00,0,5,13,1,0,477,2992,3469
2016-05-24 14:00:00-04:00,0,5,14,1,0,311,2015,2326
2016-05-24 15:00:00-04:00,0,5,15,1,0,367,2159,2526
2016-05-24 16:00:00-04:00,0,5,16,1,0,385,4207,4592
2016-05-24 17:00:00-04:00,0,5,17,1,0,876,11678,12554
2016-05-24 18:00:00-04:00,0,5,18,1,0,1860,20315,22175
2016-05-24 19:00:00-04:00,0,5,19,1,0,2580,22196,24776
2016-05-24 20:00:00-04:00,0,5,20,1,0,2362,20070,22432
2016-05-24 21:00:00-04:00,0,5,21,1,0,1878,17329,19207
2016-05-24 22:00:00-04:00,0,5,22,1,0,1667,16931,18598
2016-05-24 23:00:00-04:00,0,5,23,1,0,1648,17434,19082
2016-05-25 00:00:00-04:00,0,5,0,2,0,1578,17331,18909
2016-05-25 01:00:00-04:00,0,5,1,2,0,1919,19037,20956
2016-05-25 02:00:00-04:00,0,5,2,2,0,2123,18590,20713
2016-05-25 03:00:00-04:00,0,5,3,2,0,2429,16673,19102
2016-05-25 04:00:00-04:00,0,5,4,2,0,2655,20069,22724
2016-05-25 05:00:00-04:00,0,5,5,2,0,2868,23694,26562
2016-05-25 06:00:00-04:00,0,5,6,2,0,2642,23095,25737
2016-05-25 07:00:00-04:00,0,5,7,2,0,2301,22209,24510
2016-05-25 08:00:00-04:00,0,5,8,2,0,2210,23324,25534
2016-05-25 09:00:00-04:00,0,5,9,2,0,2064,21044,23108
2016-05-25 10:00:00-04:00,0,5,10,2,0,1889,16158,18047
2016-05-25 11:00:00-04:00,0,5,11,2,0,1346,10058,11404
2016-05-25 12:00:00-04:00,0,5,12,2,0,872,5963,6835
2016-05-25 13:00:00-04:00,0,5,13,2,0,527,3638,4165
2016-05-25 14:00:00-04:00,0,5,14,2,0,376,2455,2831
2016-05-25 15:00:00-04:00,0,5,15,2,0,436,2588,3024
2016-05-25 16:00:00-04:00,0,5,16,2,0,400,4138,4538
2016-05-25 17:00:00-04:00,0,5,17,2,0,830,10564,11394
2016-05-25 18:00:00-04:00,0,5,18,2,0,1682,18856,20538
2016-05-25 19:00:00-04:00,0,5,19,2,0,2413,21145,23558
2016-05-25 20:00:00-04:00,0,5,20,2,0,2171,19479,21650
2016-05-25 21:00:00-04:00,0,5,21,2,0,1887,17471,19358
2016-05-25 22:00:00-04:00,0,5,22,2,0,1752,17948,19700
2016-05-25 23:00:00-04:00,0,5,23,2,0,1778,18451,20229
2016-05-26 00:00:00-04:00,0,5,0,3,0,1732,18533,20265
2016-05-26 01:00:00-04:00,0,5,1,3,0,2113,20113,22226
2016-05-26 02:00:00-04:00,0,5,2,3,0,2464,18424,20888
2016-05-26 03:00:00-04:00,0,5,3,3,0,2593,15602,18195
2016-05-26 04:00:00-04:00,0,5,4,3,0,2812,19140,21952
2016-05-26 05:00:00-04:00,0,5,5,3,0,3190,23651,26841
2016-05-26 06:00:00-04:00,0,5,6,3,0,3100,24774,27874
2016-05-26 07:00:00-04:00,0,5,7,3,0,2691,24744,27435
2016-05-26 08:00:00-04:00,0,5,8,3,0,2693,25152,27845
2016-05-26 09:00:00-04:00,0,5,9,3,0,2584,23457,26041
2016-05-26 10:00:00-04:00,0,5,10,3,0,2317,19498,21815
2016-05-26 11:00:00-04:00,0,5,11,3,0,1695,13105,14800
2016-05-26 12:00:00-04:00,0,5,12,3,0,1143,7852,8995
2016-05-26 13:00:00-04:00,0,5,13,3,0,718,4808,5526
2016-05-26 14:00:00-04:00,0,5,14,3,0,515,3202,3717
2016-05-26 15:00:00-04:00,0,5,15,3,0,470,3037,3507
2016-05-26 16:00:00-04:00,0,5,16,3,0,470,4418,4888
2016-05-26 17:00:00-04:00,0,5,17,3,0,794,10669,11463
2016-05-26 18:00:00-04:00,0,5,18,3,0,1785,18389,20174
2016-05-26 19:00:00-04:00,0,5,19,3,0,2414,20480,22894
2016-05-26 20:00:00-04:00,0,5,20,3,0,2210,19060,21270
2016-05-26 21:00:00-04:00,0,5,21,3,0,1972,17635,19607
2016-05-26 22:00:00-04:00,0,5,22,3,0,1912,17664,19576
2016-05-26 23:00:00-04:00,0,5,23,3,0,1922,18585,20507
2016-05-27 00:00:00-04:00,0,5,0,4,0,1941,19235,21176
2016-05-27 01:00:00-04:00,0,5,1,4,0,2268,20045,22313
2016-05-27 02:00:00-04:00,0,5,2,4,0,2497,18023,20520
2016-05-27 03:00:00-04:00,0,5,3,4,0,2569,14976,17545
2016-05-27 04:00:00-04:00,0,5,4,4,0,2909,19327,22236
2016-05-27 05:00:00-04:00,0,5,5,4,0,3296,23649,26945
2016-05-27 06:00:00-04:00,0,5,6,4,0,3054,24372,27426
2016-05-27 07:00:00-04:00,0,5,7,4,0,2836,23366,26202
2016-05-27 08:00:00-04:00,0,5,8,4,0,2872,23721,26593
2016-05-27 09:00:00-04:00,0,5,9,4,0,2752,22529,25281
2016-05-27 10:00:00-04:00,0,5,10,4,0,2864,20460,23324
2016-05-27 11:00:00-04:00,0,5,11,4,0,2267,15359,17626
2016-05-27 12:00:00-04:00,0,5,12,4,0,1550,10237,11787
2016-05-27 13:00:00-04:00,0,5,13,4,0,967,6883,7850
2016-05-27 14:00:00-04:00,0,5,14,4,0,727,4723,5450
2016-05-27 15:00:00-04:00,0,5,15,4,0,601,4048,4649
2016-05-27 16:00:00-04:00,0,5,16,4,0,491,4423,4914
2016-05-27 17:00:00-04:00,0,5,17,4,0,886,9723,10609
2016-05-27 18:00:00-04:00,0,5,18,4,0,1718,16090,17808
2016-05-27 19:00:00-04:00,0,5,19,4,0,2327,18875,21202
2016-05-27 20:00:00-04:00,0,5,20,4,0,2322,18009,20331
2016-05-27 21:00:00-04:00,0,5,21,4,0,2019,15989,18008
2016-05-27 22:00:00-04:00,0,5,22,4,0,1946,16916,18862
2016-05-27 23:00:00-04:00,0,5,23,4,0,1793,18158,19951
2016-05-28 00:00:00-04:00,0,5,0,5,0,1817,18140,19957
2016-05-28 01:00:00-04:00,0,5,1,5,0,2232,19410,21642
2016-05-28 02:00:00-04:00,0,5,2,5,0,2650,17675,20325
2016-05-28 03:00:00-04:00,0,5,3,5,0,2876,15720,18596
2016-05-28 04:00:00-04:00,0,5,4,5,0,3178,18657,21835
2016-05-28 05:00:00-04:00,0,5,5,5,0,3474,20989,24463
2016-05-28 06:00:00-04:00,0,5,6,5,0,3524,21017,24541
2016-05-28 07:00:00-04:00,0,5,7,5,0,3079,17748,20827
2016-05-28 08:00:00-04:00,0,5,8,5,0,3252,18002,21254
2016-05-28 09:00:00-04:00,0,5,9,5,0,3347,19073,22420
2016-05-28 10:00:00-04:00,0,5,10,5,0,3664,19087,22751
2016-05-28 11:00:00-04:00,0,5,11,5,0,3355,16524,19879
2016-05-28 12:00:00-04:00,0,5,12,5,0,2911,13964,16875
2016-05-28 13:00:00-04:00,0,5,13,5,0,2353,11414,13767
2016-05-28 14:00:00-04:00,0,5,14,5,0,1926,8899,10825
2016-05-28 15:00:00-04:00,0,5,15,5,0,1495,6374,7869
2016-05-28 16:00:00-04:00,0,5,16,5,0,787,3428,4215
2016-05-28 17:00:00-04:00,0,5,17,5,0,676,4393,5069
2016-05-28 18:00:00-04:00,0,5,18,5,0,817,6047,6864
2016-05-28 19:00:00-04:00,0,5,19,5,0,1167,8546,9713
2016-05-28 20:00:00-04:00,0,5,20,5,0,1584,11838,13422
2016-05-28 21:00:00-04:00,0,5,21,5,0,1842,13787,15629
2016-05-28 22:00:00-04:00,0,5,22,5,0,2104,15554,17658
2016-05-28 23:00:00-04:00,0,5,23,5,0,2280,17151,19431
2016-05-29 00:00:00-04:00,0,5,0,6,0,2349,18587,20936
2016-05-29 01:00:00-04:00,0,5,1,6,0,2532,17475,20007
2016-05-29 02:00:00-04:00,0,5,2,6,0,2681,16565,19246
2016-05-29 03:00:00-04:00,0,5,3,6,0,2817,16265,19082
2016-05-29 04:00:00-04:00,0,5,4,6,0,3024,18143,21167
2016-05-29 05:00:00-04:00,0,5,5,6,0,3346,19317,22663
2016-05-29 06:00:00-04:00,0,5,6,6,0,3283,18526,21809
2016-05-29 07:00:00-04:00,0,5,7,6,0,3072,16024,19096
2016-05-29 08:00:00-04:00,0,5,8,6,0,3422,16197,19619
2016-05-29 09:00:00-04:00,0,5,9,6,0,3641,17469,21110
2016-05-29 10:00:00-04:00,0,5,10,6,0,3801,17300,21101
2016-05-29 11:00:00-04:00,0,5,11,6,0,3572,16001,19573
2016-05-29 12:00:00-04:00,0,5,12,6,0,3045,12673,15718
2016-05-29 13:00:00-04:00,0,5,13,6,0,2610,10926,13536
2016-05-29 14:00:00-04:00,0,5,14,6,0,2135,8663,10798
2016-05-29 15:00:00-04:00,0,5,15,6,0,1700,6237,7937
2016-05-29 16:00:00-04:00,0,5,16,6,0,839,2900,3739
2016-05-29 17:00:00-04:00,0,5,17,6,0,571,3196,3767
2016-05-29 18:00:00-04:00,0,5,18,6,0,640,4342,4982
2016-05-29 19:00:00-04:00,0,5,19,6,0,807,6192,6999
2016-05-29 20:00:00-04:00,0,5,20,6,0,1300,9200,10500
2016-05-29 21:00:00-04:00,0,5,21,6,0,1517,12471,13988
2016-05-29 22:00:00-04:00,0,5,22,6,0,1714,14215,15929
2016-05-29 23:00:00-04:00,0,5,23,6,0,1882,15640,17522
2016-05-30 00:00:00-04:00,0,5,0,0,1,1983,16614,18597
2016-05-30 01:00:00-04:00,0.47,5,1,0,1,2215,16889,19104
2016-05-30 02:00:00-04:00,0.3,5,2,0,1,2374,15663,18037
2016-05-30 03:00:00-04:00,0.19,5,3,0,1,2438,15525,17963
2016-05-30 04:00:00-04:00,0.23,5,4,0,1,2584,17054,19638
2016-05-30 05:00:00-04:00,0.21,5,5,0,1,2704,17271,19975
2016-05-30 06:00:00-04:00,0.13,5,6,0,1,2689,16001,18690
2016-05-30 07:00:00-04:00,0,5,7,0,1,2517,14982,17499
2016-05-30 08:00:00-04:00,0,5,8,0,1,2692,14594,17286
2016-05-30 09:00:00-04:00,0,5,9,0,1,2788,15478,18266
2016-05-30 10:00:00-04:00,0,5,10,0,1,2793,15464,18257
2016-05-30 11:00:00-04:00,0,5,11,0,1,2618,12906,15524
2016-05-30 12:00:00-04:00,0,5,12,0,1,2152,9965,12117
2016-05-30 13:00:00-04:00,0,5,13,0,1,1645,6668,8313
2016-05-30 14:00:00-04:00,0,5,14,0,1,1052,4672,5724
2016-05-30 15:00:00-04:00,0,5,15,0,1,809,3249,4058
2016-05-30 16:00:00-04:00,0,5,16,0,1,470,2324,2794
2016-05-30 17:00:00-04:00,0,5,17,0,1,508,3409,3917
2016-05-30 18:00:00-04:00,0,5,18,0,1,582,4210,4792
2016-05-30 19:00:00-04:00,0,5,19,0,1,625,5061,5686
2016-05-30 20:00:00-04:00,0,5,20,0,1,815,7222,8037
2016-05-30 21:00:00-04:00,0,5,21,0,1,1063,9612,10675
2016-05-30 22:00:00-04:00,0,5,22,0,1,1196,11728,12924
2016-05-30 23:00:00-04:00,0,5,23,0,1,1484,13847,15331
2016-05-31 00:00:00-04:00,0,5,0,1,0,1575,14930,16505
2016-05-31 01:00:00-04:00,0,5,1,1,0,1828,16184,18012
2016-05-31 02:00:00-04:00,0,5,2,1,0,2001,15974,17975
2016-05-31 03:00:00-04:00,0,5,3,1,0,2098,16053,18151
2016-05-31 04:00:00-04:00,0,5,4,1,0,2210,16735,18945
2016-05-31 05:00:00-04:00,0,5,5,1,0,2341,17393,19734
2016-05-31 06:00:00-04:00,0,5,6,1,0,2286,16165,18451
2016-05-31 07:00:00-04:00,0,5,7,1,0,2081,14772,16853
2016-05-31 08:00:00-04:00,0,5,8,1,0,2148,14339,16487
2016-05-31 09:00:00-04:00,0,5,9,1,0,1834,12529,14363
2016-05-31 10:00:00-04:00,0,5,10,1,0,1628,11240,12868
2016-05-31 11:00:00-04:00,0,5,11,1,0,1130,6721,7851
2016-05-31 12:00:00-04:00,0,5,12,1,0,748,3711,4459
2016-05-31 13:00:00-04:00,0,5,13,1,0,465,2412,2877
2016-05-31 14:00:00-04:00,0,5,14,1,0,304,1629,1933
2016-05-31 15:00:00-04:00,0,5,15,1,0,366,2173,2539
2016-05-31 16:00:00-04:00,0,5,16,1,0,392,3960,4352
2016-05-31 17:00:00-04:00,0,5,17,1,0,857,10228,11085
2016-05-31 18:00:00-04:00,0,5,18,1,0,1786,17581,19367
2016-05-31 19:00:00-04:00,0,5,19,1,0,2400,20199,22599
2016-05-31 20:00:00-04:00,0,5,20,1,0,2095,18358,20453
2016-05-31 21:00:00-04:00,0,5,21,1,0,2099,16613,18712
2016-05-31 22:00:00-04:00,0,5,22,1,0,1665,16173,17838
2016-05-31 23:00:00-04:00,0,5,23,1,0,1691,17227,18918
2016-06-01 00:00:00-04:00,0,6,0,2,0,1719,17336,19055
2016-06-01 01:00:00-04:00,0,6,1,2,0,2001,18915,20916
2016-06-01 02:00:00-04:00,0,6,2,2,0,2128,18587,20715
2016-06-01 03:00:00-04:00,0,6,3,2,0,2220,16019,18239
2016-06-01 04:00:00-04:00,0,6,4,2,0,2425,19323,21748
2016-06-01 05:00:00-04:00,0,6,5,2,0,2715,22928,25643
2016-06-01 06:00:00-04:00,0,6,6,2,0,2550,21243,23793
2016-06-01 07:00:00-04:00,0,6,7,2,0,2101,19879,21980
2016-06-01 08:00:00-04:00,0,6,8,2,0,2116,19671,21787
2016-06-01 09:00:00-04:00,0,6,9,2,0,1826,17476,19302
2016-06-01 10:00:00-04:00,0,6,10,2,0,1588,12462,14050
2016-06-01 11:00:00-04:00,0,6,11,2,0,1125,8182,9307
2016-06-01 12:00:00-04:00,0,6,12,2,0,790,5003,5793
2016-06-01 13:00:00-04:00,0,6,13,2,0,445,3070,3515
2016-06-01 14:00:00-04:00,0,6,14,2,0,295,2275,2570
2016-06-01 15:00:00-04:00,0,6,15,2,0,331,2229,2560
2016-06-01 16:00:00-04:00,0,6,16,2,0,385,3925,4310
2016-06-01 17:00:00-04:00,0,6,17,2,0,772,10825,11597
2016-06-01 18:00:00-04:00,0,6,18,2,0,1693,18287,19980
2016-06-01 19:00:00-04:00,0,6,19,2,0,2352,21062,23414
2016-06-01 20:00:00-04:00,0,6,20,2,0,2250,18975,21225
2016-06-01 21:00:00-04:00,0,6,21,2,0,1957,17367,19324
2016-06-01 22:00:00-04:00,0,6,22,2,0,1865,17383,19248
2016-06-01 23:00:00-04:00,0,6,23,2,0,1795,18031,19826
2016-06-02 00:00:00-04:00,0,6,0,3,0,1860,17998,19858
2016-06-02 01:00:00-04:00,0,6,1,3,0,2135,19125,21260
2016-06-02 02:00:00-04:00,0,6,2,3,0,2317,18053,20370
2016-06-02 03:00:00-04:00,0,6,3,3,0,2495,15069,17564
2016-06-02 04:00:00-04:00,0,6,4,3,0,2666,18513,21179
2016-06-02 05:00:00-04:00,0,6,5,3,0,2967,22689,25656
2016-06-02 06:00:00-04:00,0,6,6,3,0,2923,23190,26113
2016-06-02 07:00:00-04:00,0,6,7,3,0,2529,23098,25627
2016-06-02 08:00:00-04:00,0,6,8,3,0,2566,24106,26672
2016-06-02 09:00:00-04:00,0,6,9,3,0,2316,22554,24870
2016-06-02 10:00:00-04:00,0,6,10,3,0,2040,17765,19805
2016-06-02 11:00:00-04:00,0,6,11,3,0,1499,11265,12764
2016-06-02 12:00:00-04:00,0,6,12,3,0,943,6894,7837
2016-06-02 13:00:00-04:00,0,6,13,3,0,603,3986,4589
2016-06-02 14:00:00-04:00,0,6,14,3,0,376,2598,2974
2016-06-02 15:00:00-04:00,0,6,15,3,0,376,2477,2853
2016-06-02 16:00:00-04:00,0,6,16,3,0,388,3957,4345
2016-06-02 17:00:00-04:00,0,6,17,3,0,816,10619,11435
2016-06-02 18:00:00-04:00,0,6,18,3,0,1729,18657,20386
2016-06-02 19:00:00-04:00,0,6,19,3,0,2431,21502,23933
2016-06-02 20:00:00-04:00,0,6,20,3,0,2275,19681,21956
2016-06-02 21:00:00-04:00,0,6,21,3,0,1934,17649,19583
2016-06-02 22:00:00-04:00,0,6,22,3,0,1886,18113,19999
2016-06-02 23:00:00-04:00,0,6,23,3,0,1827,18633,20460
2016-06-03 00:00:00-04:00,0,6,0,4,0,1824,18401,20225
2016-06-03 01:00:00-04:00,0,6,1,4,0,2043,19740,21783
2016-06-03 02:00:00-04:00,0,6,2,4,0,2347,18403,20750
2016-06-03 03:00:00-04:00,0,6,3,4,0,2551,15541,18092
2016-06-03 04:00:00-04:00,0,6,4,4,0,2938,18998,21936
2016-06-03 05:00:00-04:00,0,6,5,4,0,3211,23438,26649
2016-06-03 06:00:00-04:00,0,6,6,4,0,3338,25390,28728
2016-06-03 07:00:00-04:00,0,6,7,4,0,3045,25347,28392
2016-06-03 08:00:00-04:00,0.01,6,8,4,0,2925,25830,28755
2016-06-03 09:00:00-04:00,0.01,6,9,4,0,2615,24169,26784
2016-06-03 10:00:00-04:00,0,6,10,4,0,2419,21634,24053
2016-06-03 11:00:00-04:00,0,6,11,4,0,1879,15692,17571
2016-06-03 12:00:00-04:00,0,6,12,4,0,1303,9651,10954
2016-06-03 13:00:00-04:00,0,6,13,4,0,954,6371,7325
2016-06-03 14:00:00-04:00,0,6,14,4,0,694,4248,4942
2016-06-03 15:00:00-04:00,0,6,15,4,0,553,3509,4062
2016-06-03 16:00:00-04:00,0,6,16,4,0,455,4228,4683
2016-06-03 17:00:00-04:00,0,6,17,4,0,868,10337,11205
2016-06-03 18:00:00-04:00,0,6,18,4,0,1876,19477,21353
2016-06-03 19:00:00-04:00,0,6,19,4,0,2676,23198,25874
2016-06-03 20:00:00-04:00,0,6,20,4,0,2620,20305,22925
2016-06-03 21:00:00-04:00,0,6,21,4,0,2063,17898,19961
2016-06-03 22:00:00-04:00,0,6,22,4,0,1891,17720,19611
2016-06-03 23:00:00-04:00,0,6,23,4,0,1906,18529,20435
2016-06-04 00:00:00-04:00,0,6,0,5,0,1888,18481,20369
2016-06-04 01:00:00-04:00,0,6,1,5,0,2376,20180,22556
2016-06-04 02:00:00-04:00,0,6,2,5,0,2674,18114,20788
2016-06-04 03:00:00-04:00,0,6,3,5,0,2801,15457,18258
2016-06-04 04:00:00-04:00,0,6,4,5,0,3160,19440,22600
2016-06-04 05:00:00-04:00,0,6,5,5,0,3606,23883,27489
2016-06-04 06:00:00-04:00,0,6,6,5,0,3603,24616,28219
2016-06-04 07:00:00-04:00,0,6,7,5,0,3398,21603,25001
2016-06-04 08:00:00-04:00,0,6,8,5,0,3542,21773,25315
2016-06-04 09:00:00-04:00,0,6,9,5,0,3590,22857,26447
2016-06-04 10:00:00-04:00,0,6,10,5,0,4015,24239,28254
2016-06-04 11:00:00-04:00,0,6,11,5,0,3746,22544,26290
2016-06-04 12:00:00-04:00,0,6,12,5,0,3147,18555,21702
2016-06-04 13:00:00-04:00,0,6,13,5,0,2682,15170,17852
2016-06-04 14:00:00-04:00,0,6,14,5,0,2059,11502,13561
2016-06-04 15:00:00-04:00,0,6,15,5,0,1480,7112,8592
2016-06-04 16:00:00-04:00,0,6,16,5,0,884,3775,4659
2016-06-04 17:00:00-04:00,0,6,17,5,0,738,4779,5517
2016-06-04 18:00:00-04:00,0,6,18,5,0,988,8750,9738
2016-06-04 19:00:00-04:00,0.07,6,19,5,0,1287,10803,12090
2016-06-04 20:00:00-04:00,0.09,6,20,5,0,1802,15080,16882
2016-06-04 21:00:00-04:00,0.12,6,21,5,0,2086,18007,20093
2016-06-04 22:00:00-04:00,0,6,22,5,0,2353,19888,22241
2016-06-04 23:00:00-04:00,0,6,23,5,0,2382,20863,23245
2016-06-05 00:00:00-04:00,0,6,0,6,0,2556,22220,24776
2016-06-05 01:00:00-04:00,0,6,1,6,0,2823,21602,24425
2016-06-05 02:00:00-04:00,0,6,2,6,0,3101,20365,23466
2016-06-05 03:00:00-04:00,0,6,3,6,0,3218,18187,21405
2016-06-05 04:00:00-04:00,0,6,4,6,0,3450,20116,23566
2016-06-05 05:00:00-04:00,0,6,5,6,0,3967,24146,28113
2016-06-05 06:00:00-04:00,0,6,6,6,0,4849,27685,32534
2016-06-05 07:00:00-04:00,0,6,7,6,0,3982,22472,26454
2016-06-05 08:00:00-04:00,0.01,6,8,6,0,4073,20162,24235
2016-06-05 09:00:00-04:00,0,6,9,6,0,4146,22642,26788
2016-06-05 10:00:00-04:00,0,6,10,6,0,4387,24160,28547
2016-06-05 11:00:00-04:00,0.16,6,11,6,0,3984,22760,26744
2016-06-05 12:00:00-04:00,0.02,6,12,6,0,3514,19952,23466
2016-06-05 13:00:00-04:00,0,6,13,6,0,2910,16951,19861
2016-06-05 14:00:00-04:00,0,6,14,6,0,2352,12665,15017
2016-06-05 15:00:00-04:00,0,6,15,6,0,1666,8142,9808
2016-06-05 16:00:00-04:00,0,6,16,6,0,834,3707,4541
2016-06-05 17:00:00-04:00,0,6,17,6,0,627,3786,4413
2016-06-05 18:00:00-04:00,0.25,6,18,6,0,686,5564,6250
2016-06-05 19:00:00-04:00,0.21,6,19,6,0,900,8171,9071
2016-06-05 20:00:00-04:00,0.02,6,20,6,0,1356,11622,12978
2016-06-05 21:00:00-04:00,0,6,21,6,0,1740,15635,17375
2016-06-05 22:00:00-04:00,0,6,22,6,0,2426,22671,25097
2016-06-05 23:00:00-04:00,0,6,23,6,0,2100,18452,20552
2016-06-06 00:00:00-04:00,0,6,0,0,0,2152,17526,19678
2016-06-06 01:00:00-04:00,0,6,1,0,0,2270,17244,19514
2016-06-06 02:00:00-04:00,0,6,2,0,0,2454,17196,19650
2016-06-06 03:00:00-04:00,0,6,3,0,0,2557,17111,19668
2016-06-06 04:00:00-04:00,0,6,4,0,0,2638,18631,21269
2016-06-06 05:00:00-04:00,0,6,5,0,0,3458,22833,26291
2016-06-06 06:00:00-04:00,0,6,6,0,0,3429,20001,23430
2016-06-06 07:00:00-04:00,0,6,7,0,0,2164,14234,16398
2016-06-06 08:00:00-04:00,0,6,8,0,0,1925,13926,15851
2016-06-06 09:00:00-04:00,0,6,9,0,0,1814,13655,15469
2016-06-06 10:00:00-04:00,0,6,10,0,0,1596,10710,12306
2016-06-06 11:00:00-04:00,0,6,11,0,0,1286,8322,9608
2016-06-06 12:00:00-04:00,0,6,12,0,0,858,5418,6276
2016-06-06 13:00:00-04:00,0,6,13,0,0,532,3691,4223
2016-06-06 14:00:00-04:00,0,6,14,0,0,392,2389,2781
2016-06-06 15:00:00-04:00,0,6,15,0,0,434,2619,3053
2016-06-06 16:00:00-04:00,0,6,16,0,0,522,4201,4723
2016-06-06 17:00:00-04:00,0,6,17,0,0,821,10227,11048
2016-06-06 18:00:00-04:00,0,6,18,0,0,1650,17095,18745
2016-06-06 19:00:00-04:00,0,6,19,0,0,2294,19104,21398
2016-06-06 20:00:00-04:00,0,6,20,0,0,2319,18684,21003
2016-06-06 21:00:00-04:00,0,6,21,0,0,1849,16670,18519
2016-06-06 22:00:00-04:00,0,6,22,0,0,1761,16546,18307
2016-06-06 23:00:00-04:00,0,6,23,0,0,1734,16890,18624
2016-06-07 00:00:00-04:00,0,6,0,1,0,1688,17237,18925
2016-06-07 01:00:00-04:00,0,6,1,1,0,1943,18494,20437
2016-06-07 02:00:00-04:00,0,6,2,1,0,2164,18710,20874
2016-06-07 03:00:00-04:00,0,6,3,1,0,2257,17214,19471
2016-06-07 04:00:00-04:00,0,6,4,1,0,2641,20300,22941
2016-06-07 05:00:00-04:00,0,6,5,1,0,2733,24066,26799
2016-06-07 06:00:00-04:00,0,6,6,1,0,2495,22571,25066
2016-06-07 07:00:00-04:00,0,6,7,1,0,1747,20638,22385
2016-06-07 08:00:00-04:00,0,6,8,1,0,1786,22065,23851
2016-06-07 09:00:00-04:00,0,6,9,1,0,1648,19394,21042
2016-06-07 10:00:00-04:00,0,6,10,1,0,1439,13997,15436
2016-06-07 11:00:00-04:00,0,6,11,1,0,1236,9170,10406
2016-06-07 12:00:00-04:00,0,6,12,1,0,778,5251,6029
2016-06-07 13:00:00-04:00,0,6,13,1,0,472,3190,3662
2016-06-07 14:00:00-04:00,0,6,14,1,0,314,2139,2453
2016-06-07 15:00:00-04:00,0,6,15,1,0,327,2081,2408
2016-06-07 16:00:00-04:00,0.01,6,16,1,0,414,3901,4315
2016-06-07 17:00:00-04:00,0,6,17,1,0,823,10323,11146
2016-06-07 18:00:00-04:00,0,6,18,1,0,1693,18427,20120
2016-06-07 19:00:00-04:00,0,6,19,1,0,2308,20786,23094
2016-06-07 20:00:00-04:00,0,6,20,1,0,2103,18674,20777
2016-06-07 21:00:00-04:00,0,6,21,1,0,1878,17473,19351
2016-06-07 22:00:00-04:00,0,6,22,1,0,1782,18015,19797
2016-06-07 23:00:00-04:00,0,6,23,1,0,1793,19197,20990
2016-06-08 00:00:00-04:00,0,6,0,2,0,1799,19325,21124
2016-06-08 01:00:00-04:00,0,6,1,2,0,2017,19906,21923
2016-06-08 02:00:00-04:00,0,6,2,2,0,2449,18938,21387
2016-06-08 03:00:00-04:00,0,6,3,2,0,2775,16085,18860
2016-06-08 04:00:00-04:00,0,6,4,2,0,2694,19226,21920
2016-06-08 05:00:00-04:00,0,6,5,2,0,2872,24676,27548
2016-06-08 06:00:00-04:00,0,6,6,2,0,2501,23511,26012
2016-06-08 07:00:00-04:00,0,6,7,2,0,1885,21985,23870
2016-06-08 08:00:00-04:00,0,6,8,2,0,1828,24226,26054
2016-06-08 09:00:00-04:00,0,6,9,2,0,1947,22280,24227
2016-06-08 10:00:00-04:00,0,6,10,2,0,1927,17644,19571
2016-06-08 11:00:00-04:00,0,6,11,2,0,1629,12507,14136
2016-06-08 12:00:00-04:00,0.03,6,12,2,0,1147,7799,8946
2016-06-08 13:00:00-04:00,0.26,6,13,2,0,587,4000,4587
2016-06-08 14:00:00-04:00,0.14,6,14,2,0,339,2591,2930
2016-06-08 15:00:00-04:00,0.04,6,15,2,0,385,2461,2846
2016-06-08 16:00:00-04:00,0,6,16,2,0,397,4003,4400
2016-06-08 17:00:00-04:00,0,6,17,2,0,758,10581,11339
2016-06-08 18:00:00-04:00,0,6,18,2,0,1591,19004,20595
2016-06-08 19:00:00-04:00,0,6,19,2,0,2287,21638,23925
2016-06-08 20:00:00-04:00,0,6,20,2,0,2191,20104,22295
2016-06-08 21:00:00-04:00,0,6,21,2,0,1803,18255,20058
2016-06-08 22:00:00-04:00,0,6,22,2,0,1885,19271,21156
2016-06-08 23:00:00-04:00,0,6,23,2,0,2544,22769,25313
2016-06-09 00:00:00-04:00,0,6,0,3,0,3218,21610,24828
2016-06-09 01:00:00-04:00,0,6,1,3,0,3357,19258,22615
2016-06-09 02:00:00-04:00,0,6,2,3,0,2980,15615,18595
2016-06-09 03:00:00-04:00,0,6,3,3,0,2840,11985,14825
2016-06-09 04:00:00-04:00,0,6,4,3,0,2946,15909,18855
2016-06-09 05:00:00-04:00,0,6,5,3,0,3007,20002,23009
2016-06-09 06:00:00-04:00,0,6,6,3,0,2739,22564,25303
2016-06-09 07:00:00-04:00,0,6,7,3,0,2023,21963,23986
2016-06-09 08:00:00-04:00,0,6,8,3,0,2166,25576,27742
2016-06-09 09:00:00-04:00,0,6,9,3,0,2217,22554,24771
2016-06-09 10:00:00-04:00,0,6,10,3,0,2242,19559,21801
2016-06-09 11:00:00-04:00,0,6,11,3,0,1944,14456,16400
2016-06-09 12:00:00-04:00,0,6,12,3,0,1285,7618,8903
2016-06-09 13:00:00-04:00,0,6,13,3,0,665,4306,4971
2016-06-09 14:00:00-04:00,0,6,14,3,0,397,2795,3192
2016-06-09 15:00:00-04:00,0,6,15,3,0,415,2879,3294
2016-06-09 16:00:00-04:00,0,6,16,3,0,464,4225,4689
2016-06-09 17:00:00-04:00,0,6,17,3,0,843,11023,11866
2016-06-09 18:00:00-04:00,0,6,18,3,0,1634,19024,20658
2016-06-09 19:00:00-04:00,0,6,19,3,0,2269,21818,24087
2016-06-09 20:00:00-04:00,0,6,20,3,0,2223,20124,22347
2016-06-09 21:00:00-04:00,0,6,21,3,0,1822,18621,20443
2016-06-09 22:00:00-04:00,0,6,22,3,0,1803,18589,20392
2016-06-09 23:00:00-04:00,0,6,23,3,0,1810,19142,20952
2016-06-10 00:00:00-04:00,0,6,0,4,0,1797,19077,20874
2016-06-10 01:00:00-04:00,0,6,1,4,0,2100,19297,21397
2016-06-10 02:00:00-04:00,0,6,2,4,0,2400,17687,20087
2016-06-10 03:00:00-04:00,0,6,3,4,0,2663,14333,16996
2016-06-10 04:00:00-04:00,0,6,4,4,0,2945,17761,20706
2016-06-10 05:00:00-04:00,0,6,5,4,0,3144,22231,25375
2016-06-10 06:00:00-04:00,0,6,6,4,0,2924,24234,27158
2016-06-10 07:00:00-04:00,0,6,7,4,0,2144,23032,25176
2016-06-10 08:00:00-04:00,0,6,8,4,0,2357,25940,28297
2016-06-10 09:00:00-04:00,0,6,9,4,0,2494,23836,26330
2016-06-10 10:00:00-04:00,0,6,10,4,0,2500,21636,24136
2016-06-10 11:00:00-04:00,0,6,11,4,0,2117,17310,19427
2016-06-10 12:00:00-04:00,0,6,12,4,0,1476,10934,12410
2016-06-10 13:00:00-04:00,0,6,13,4,0,862,7107,7969
2016-06-10 14:00:00-04:00,0,6,14,4,0,564,4916,5480
2016-06-10 15:00:00-04:00,0,6,15,4,0,535,3956,4491
2016-06-10 16:00:00-04:00,0,6,16,4,0,467,4405,4872
2016-06-10 17:00:00-04:00,0,6,17,4,0,829,10258,11087
2016-06-10 18:00:00-04:00,0,6,18,4,0,1563,17433,18996
2016-06-10 19:00:00-04:00,0,6,19,4,0,2289,20584,22873
2016-06-10 20:00:00-04:00,0,6,20,4,0,2347,19871,22218
2016-06-10 21:00:00-04:00,0,6,21,4,0,2089,17887,19976
2016-06-10 22:00:00-04:00,0,6,22,4,0,1801,18026,19827
2016-06-10 23:00:00-04:00,0,6,23,4,0,1746,18253,19999
2016-06-11 00:00:00-04:00,0,6,0,5,0,1671,17886,19557
2016-06-11 01:00:00-04:00,0,6,1,5,0,2196,19148,21344
2016-06-11 02:00:00-04:00,0,6,2,5,0,2584,17543,20127
2016-06-11 03:00:00-04:00,0,6,3,5,0,2920,15011,17931
2016-06-11 04:00:00-04:00,0,6,4,5,0,3300,19421,22721
2016-06-11 05:00:00-04:00,0,6,5,5,0,3714,23316,27030
2016-06-11 06:00:00-04:00,0,6,6,5,0,3479,24597,28076
2016-06-11 07:00:00-04:00,0,6,7,5,0,2604,22135,24739
2016-06-11 08:00:00-04:00,0,6,8,5,0,2893,23370,26263
2016-06-11 09:00:00-04:00,0,6,9,5,0,3233,24256,27489
2016-06-11 10:00:00-04:00,0,6,10,5,0,3516,23835,27351
2016-06-11 11:00:00-04:00,0,6,11,5,0,3679,22776,26455
2016-06-11 12:00:00-04:00,0,6,12,5,0,3075,18856,21931
2016-06-11 13:00:00-04:00,0,6,13,5,0,2482,15047,17529
2016-06-11 14:00:00-04:00,0,6,14,5,0,1783,11247,13030
2016-06-11 15:00:00-04:00,0,6,15,5,0,1380,7341,8721
2016-06-11 16:00:00-04:00,0,6,16,5,0,844,3802,4646
2016-06-11 17:00:00-04:00,0,6,17,5,0,685,4966,5651
2016-06-11 18:00:00-04:00,0.1,6,18,5,0,902,7522,8424
2016-06-11 19:00:00-04:00,0,6,19,5,0,1223,9973,11196
2016-06-11 20:00:00-04:00,0,6,20,5,0,1653,13570,15223
2016-06-11 21:00:00-04:00,0,6,21,5,0,2040,16233,18273
2016-06-11 22:00:00-04:00,0,6,22,5,0,2215,17991,20206
2016-06-11 23:00:00-04:00,0,6,23,5,0,2389,18982,21371
2016-06-12 00:00:00-04:00,0,6,0,6,0,2511,19352,21863
2016-06-12 01:00:00-04:00,0,6,1,6,0,2791,18799,21590
2016-06-12 02:00:00-04:00,0,6,2,6,0,2959,18057,21016
2016-06-12 03:00:00-04:00,0,6,3,6,0,3165,17219,20384
2016-06-12 04:00:00-04:00,0,6,4,6,0,3426,20191,23617
2016-06-12 05:00:00-04:00,0,6,5,6,0,3693,21490,25183
2016-06-12 06:00:00-04:00,0,6,6,6,0,3460,21927,25387
2016-06-12 07:00:00-04:00,0,6,7,6,0,2675,18369,21044
2016-06-12 08:00:00-04:00,0,6,8,6,0,3042,19954,22996
2016-06-12 09:00:00-04:00,0,6,9,6,0,3354,21567,24921
2016-06-12 10:00:00-04:00,0,6,10,6,0,3852,22777,26629
2016-06-12 11:00:00-04:00,0,6,11,6,0,3668,20670,24338
2016-06-12 12:00:00-04:00,0,6,12,6,0,3531,18268,21799
2016-06-12 13:00:00-04:00,0,6,13,6,0,2766,14855,17621
2016-06-12 14:00:00-04:00,0,6,14,6,0,1956,11211,13167
2016-06-12 15:00:00-04:00,0,6,15,6,0,1658,7437,9095
2016-06-12 16:00:00-04:00,0,6,16,6,0,885,3505,4390
2016-06-12 17:00:00-04:00,0,6,17,6,0,614,3629,4243
2016-06-12 18:00:00-04:00,0,6,18,6,0,603,5132,5735
2016-06-12 19:00:00-04:00,0,6,19,6,0,802,7694,8496
2016-06-12 20:00:00-04:00,0,6,20,6,0,1224,11163,12387
2016-06-12 21:00:00-04:00,0,6,21,6,0,1595,14163,15758
2016-06-12 22:00:00-04:00,0,6,22,6,0,1845,15712,17557
2016-06-12 23:00:00-04:00,0,6,23,6,0,1963,16545,18508
2016-06-13 00:00:00-04:00,0,6,0,0,0,2035,16999,19034
2016-06-13 01:00:00-04:00,0,6,1,0,0,2378,17020,19398
2016-06-13 02:00:00-04:00,0,6,2,0,0,2523,16111,18634
2016-06-13 03:00:00-04:00,0,6,3,0,0,2539,16284,18823
2016-06-13 04:00:00-04:00,0,6,4,0,0,2648,16838,19486
2016-06-13 05:00:00-04:00,0,6,5,0,0,2693,18244,20937
2016-06-13 06:00:00-04:00,0,6,6,0,0,2520,17619,20139
2016-06-13 07:00:00-04:00,0,6,7,0,0,1861,15924,17785
2016-06-13 08:00:00-04:00,0,6,8,0,0,2040,16554,18594
2016-06-13 09:00:00-04:00,0,6,9,0,0,2032,15050,17082
2016-06-13 10:00:00-04:00,0,6,10,0,0,2101,12517,14618
2016-06-13 11:00:00-04:00,0,6,11,0,0,1566,7890,9456
2016-06-13 12:00:00-04:00,0,6,12,0,0,965,4858,5823
2016-06-13 13:00:00-04:00,0,6,13,0,0,595,3227,3822
2016-06-13 14:00:00-04:00,0,6,14,0,0,392,2133,2525
2016-06-13 15:00:00-04:00,0,6,15,0,0,477,2618,3095
2016-06-13 16:00:00-04:00,0,6,16,0,0,518,4212,4730
2016-06-13 17:00:00-04:00,0,6,17,0,0,834,10219,11053
2016-06-13 18:00:00-04:00,0,6,18,0,0,1591,16561,18152
2016-06-13 19:00:00-04:00,0,6,19,0,0,2314,19356,21670
2016-06-13 20:00:00-04:00,0,6,20,0,0,2040,17573,19613
2016-06-13 21:00:00-04:00,0,6,21,0,0,1694,15277,16971
2016-06-13 22:00:00-04:00,0,6,22,0,0,1569,15548,17117
2016-06-13 23:00:00-04:00,0,6,23,0,0,1632,16433,18065
2016-06-14 00:00:00-04:00,0,6,0,1,0,1578,16172,17750
2016-06-14 01:00:00-04:00,0,6,1,1,0,1827,17748,19575
2016-06-14 02:00:00-04:00,0,6,2,1,0,2077,17497,19574
2016-06-14 03:00:00-04:00,0,6,3,1,0,2252,16267,18519
2016-06-14 04:00:00-04:00,0,6,4,1,0,2463,18908,21371
2016-06-14 05:00:00-04:00,0,6,5,1,0,2657,22552,25209
2016-06-14 06:00:00-04:00,0,6,6,1,0,2344,21548,23892
2016-06-14 07:00:00-04:00,0,6,7,1,0,1708,19973,21681
2016-06-14 08:00:00-04:00,0,6,8,1,0,1696,21154,22850
2016-06-14 09:00:00-04:00,0,6,9,1,0,1602,19006,20608
2016-06-14 10:00:00-04:00,0,6,10,1,0,1550,14359,15909
2016-06-14 11:00:00-04:00,0,6,11,1,0,1360,9633,10993
2016-06-14 12:00:00-04:00,0,6,12,1,0,834,5078,5912
2016-06-14 13:00:00-04:00,0,6,13,1,0,484,3092,3576
2016-06-14 14:00:00-04:00,0,6,14,1,0,279,1941,2220
2016-06-14 15:00:00-04:00,0,6,15,1,0,310,2127,2437
2016-06-14 16:00:00-04:00,0,6,16,1,0,412,3765,4177
2016-06-14 17:00:00-04:00,0,6,17,1,0,771,10874,11645
2016-06-14 18:00:00-04:00,0,6,18,1,0,1447,16910,18357
2016-06-14 19:00:00-04:00,0,6,19,1,0,2067,20183,22250
2016-06-14 20:00:00-04:00,0,6,20,1,0,1938,19051,20989
2016-06-14 21:00:00-04:00,0,6,21,1,0,1649,17226,18875
2016-06-14 22:00:00-04:00,0,6,22,1,0,1652,17301,18953
2016-06-14 23:00:00-04:00,0,6,23,1,0,1626,17675,19301
2016-06-15 00:00:00-04:00,0,6,0,2,0,1618,18101,19719
2016-06-15 01:00:00-04:00,0,6,1,2,0,1834,18907,20741
2016-06-15 02:00:00-04:00,0,6,2,2,0,2071,17745,19816
2016-06-15 03:00:00-04:00,0,6,3,2,0,2298,15270,17568
2016-06-15 04:00:00-04:00,0,6,4,2,0,2517,18535,21052
2016-06-15 05:00:00-04:00,0,6,5,2,0,2644,23365,26009
2016-06-15 06:00:00-04:00,0,6,6,2,0,2436,22972,25408
2016-06-15 07:00:00-04:00,0,6,7,2,0,1752,21311,23063
2016-06-15 08:00:00-04:00,0,6,8,2,0,1905,23762,25667
2016-06-15 09:00:00-04:00,0,6,9,2,0,1974,21784,23758
2016-06-15 10:00:00-04:00,0,6,10,2,0,1859,16823,18682
2016-06-15 11:00:00-04:00,0,6,11,2,0,1440,10985,12425
2016-06-15 12:00:00-04:00,0,6,12,2,0,970,6076,7046
2016-06-15 13:00:00-04:00,0,6,13,2,0,574,3666,4240
2016-06-15 14:00:00-04:00,0,6,14,2,0,332,2404,2736
2016-06-15 15:00:00-04:00,0,6,15,2,0,348,2476,2824
2016-06-15 16:00:00-04:00,0,6,16,2,0,381,3830,4211
2016-06-15 17:00:00-04:00,0,6,17,2,0,787,10072,10859
2016-06-15 18:00:00-04:00,0,6,18,2,0,1544,17380,18924
2016-06-15 19:00:00-04:00,0,6,19,2,0,2308,20724,23032
2016-06-15 20:00:00-04:00,0,6,20,2,0,2149,19503,21652
2016-06-15 21:00:00-04:00,0,6,21,2,0,1821,17808,19629
2016-06-15 22:00:00-04:00,0,6,22,2,0,1810,18216,20026
2016-06-15 23:00:00-04:00,0,6,23,2,0,1830,18755,20585
2016-06-16 00:00:00-04:00,0,6,0,3,0,1782,19236,21018
2016-06-16 01:00:00-04:00,0,6,1,3,0,2118,19676,21794
2016-06-16 02:00:00-04:00,0,6,2,3,0,2263,17910,20173
2016-06-16 03:00:00-04:00,0,6,3,3,0,2397,15427,17824
2016-06-16 04:00:00-04:00,0.01,6,4,3,0,2730,19066,21796
2016-06-16 05:00:00-04:00,0,6,5,3,0,3075,23946,27021
2016-06-16 06:00:00-04:00,0.04,6,6,3,0,2784,24356,27140
2016-06-16 07:00:00-04:00,0.09,6,7,3,0,2025,22875,24900
2016-06-16 08:00:00-04:00,0,6,8,3,0,2187,25255,27442
2016-06-16 09:00:00-04:00,0,6,9,3,0,2293,24154,26447
2016-06-16 10:00:00-04:00,0,6,10,3,0,2229,19287,21516
2016-06-16 11:00:00-04:00,0,6,11,3,0,1885,12925,14810
2016-06-16 12:00:00-04:00,0,6,12,3,0,1150,7618,8768
2016-06-16 13:00:00-04:00,0,6,13,3,0,706,4690,5396
2016-06-16 14:00:00-04:00,0,6,14,3,0,416,3115,3531
2016-06-16 15:00:00-04:00,0,6,15,3,0,391,2860,3251
2016-06-16 16:00:00-04:00,0,6,16,3,0,458,4158,4616
2016-06-16 17:00:00-04:00,0,6,17,3,0,904,12759,13663
2016-06-16 18:00:00-04:00,0,6,18,3,0,1711,19807,21518
2016-06-16 19:00:00-04:00,0,6,19,3,0,2548,21752,24300
2016-06-16 20:00:00-04:00,0,6,20,3,0,2372,20609,22981
2016-06-16 21:00:00-04:00,0,6,21,3,0,1911,18600,20511
2016-06-16 22:00:00-04:00,0,6,22,3,0,1730,18553,20283
2016-06-16 23:00:00-04:00,0,6,23,3,0,1820,19312,21132
2016-06-17 00:00:00-04:00,0,6,0,4,0,1845,19592,21437
2016-06-17 01:00:00-04:00,0,6,1,4,0,2284,19754,22038
2016-06-17 02:00:00-04:00,0,6,2,4,0,2320,17370,19690
2016-06-17 03:00:00-04:00,0,6,3,4,0,2463,14360,16823
2016-06-17 04:00:00-04:00,0,6,4,4,0,3004,18102,21106
2016-06-17 05:00:00-04:00,0,6,5,4,0,3200,23173,26373
2016-06-17 06:00:00-04:00,0,6,6,4,0,2907,24456,27363
2016-06-17 07:00:00-04:00,0,6,7,4,0,2148,22789,24937
2016-06-17 08:00:00-04:00,0,6,8,4,0,2452,25332,27784
2016-06-17 09:00:00-04:00,0,6,9,4,0,2471,24471,26942
2016-06-17 10:00:00-04:00,0,6,10,4,0,2590,22568,25158
2016-06-17 11:00:00-04:00,0,6,11,4,0,2315,18289,20604
2016-06-17 12:00:00-04:00,0,6,12,4,0,1640,11179,12819
2016-06-17 13:00:00-04:00,0,6,13,4,0,944,7039,7983
2016-06-17 14:00:00-04:00,0,6,14,4,0,599,4787,5386
2016-06-17 15:00:00-04:00,0,6,15,4,0,583,4199,4782
2016-06-17 16:00:00-04:00,0,6,16,4,0,517,4689,5206
2016-06-17 17:00:00-04:00,0,6,17,4,0,859,10075,10934
2016-06-17 18:00:00-04:00,0,6,18,4,0,1618,15847,17465
2016-06-17 19:00:00-04:00,0,6,19,4,0,2395,20001,22396
2016-06-17 20:00:00-04:00,0,6,20,4,0,2307,19055,21362
2016-06-17 21:00:00-04:00,0,6,21,4,0,1919,17147,19066
2016-06-17 22:00:00-04:00,0,6,22,4,0,1887,17425,19312
2016-06-17 23:00:00-04:00,0,6,23,4,0,1826,18054,19880
2016-06-18 00:00:00-04:00,0,6,0,5,0,1770,17676,19446
2016-06-18 01:00:00-04:00,0,6,1,5,0,2205,18388,20593
2016-06-18 02:00:00-04:00,0,6,2,5,0,2647,16607,19254
2016-06-18 03:00:00-04:00,0,6,3,5,0,2900,14563,17463
2016-06-18 04:00:00-04:00,0,6,4,5,0,3300,18178,21478
2016-06-18 05:00:00-04:00,0,6,5,5,0,3744,22389,26133
2016-06-18 06:00:00-04:00,0,6,6,5,0,3621,23694,27315
2016-06-18 07:00:00-04:00,0,6,7,5,0,2775,20622,23397
2016-06-18 08:00:00-04:00,0,6,8,5,0,2949,21858,24807
2016-06-18 09:00:00-04:00,0,6,9,5,0,3332,23472,26804
2016-06-18 10:00:00-04:00,0,6,10,5,0,3675,23127,26802
2016-06-18 11:00:00-04:00,0,6,11,5,0,3828,21128,24956
2016-06-18 12:00:00-04:00,0,6,12,5,0,3288,18090,21378
2016-06-18 13:00:00-04:00,0,6,13,5,0,2515,14463,16978
2016-06-18 14:00:00-04:00,0,6,14,5,0,1745,11010,12755
2016-06-18 15:00:00-04:00,0,6,15,5,0,1416,7297,8713
2016-06-18 16:00:00-04:00,0,6,16,5,0,781,3579,4360
2016-06-18 17:00:00-04:00,0,6,17,5,0,724,4848,5572
2016-06-18 18:00:00-04:00,0,6,18,5,0,890,6989,7879
2016-06-18 19:00:00-04:00,0,6,19,5,0,1261,9895,11156
2016-06-18 20:00:00-04:00,0,6,20,5,0,1709,13964,15673
2016-06-18 21:00:00-04:00,0,6,21,5,0,1985,16023,18008
2016-06-18 22:00:00-04:00,0,6,22,5,0,2289,17465,19754
2016-06-18 23:00:00-04:00,0,6,23,5,0,2426,18706,21132
2016-06-19 00:00:00-04:00,0,6,0,6,0,2451,18570,21021
2016-06-19 01:00:00-04:00,0,6,1,6,0,2757,17696,20453
2016-06-19 02:00:00-04:00,0,6,2,6,0,3100,17540,20640
2016-06-19 03:00:00-04:00,0,6,3,6,0,3341,16753,20094
2016-06-19 04:00:00-04:00,0,6,4,6,0,3444,18595,22039
2016-06-19 05:00:00-04:00,0,6,5,6,0,3730,20056,23786
2016-06-19 06:00:00-04:00,0,6,6,6,0,3653,20132,23785
2016-06-19 07:00:00-04:00,0,6,7,6,0,2724,16967,19691
2016-06-19 08:00:00-04:00,0,6,8,6,0,3169,18606,21775
2016-06-19 09:00:00-04:00,0,6,9,6,0,3682,20927,24609
2016-06-19 10:00:00-04:00,0,6,10,6,0,4001,21320,25321
2016-06-19 11:00:00-04:00,0,6,11,6,0,4034,20448,24482
2016-06-19 12:00:00-04:00,0,6,12,6,0,3510,17085,20595
2016-06-19 13:00:00-04:00,0,6,13,6,0,2678,14024,16702
2016-06-19 14:00:00-04:00,0,6,14,6,0,1933,11060,12993
2016-06-19 15:00:00-04:00,0,6,15,6,0,1631,7531,9162
2016-06-19 16:00:00-04:00,0,6,16,6,0,859,3474,4333
2016-06-19 17:00:00-04:00,0,6,17,6,0,590,3592,4182
2016-06-19 18:00:00-04:00,0,6,18,6,0,650,4850,5500
2016-06-19 19:00:00-04:00,0,6,19,6,0,864,7007,7871
2016-06-19 20:00:00-04:00,0,6,20,6,0,1320,10808,12128
2016-06-19 21:00:00-04:00,0,6,21,6,0,1716,14044,15760
2016-06-19 22:00:00-04:00,0,6,22,6,0,2017,16059,18076
2016-06-19 23:00:00-04:00,0,6,23,6,0,2194,17278,19472
2016-06-20 00:00:00-04:00,0,6,0,0,0,2325,16998,19323
2016-06-20 01:00:00-04:00,0,6,1,0,0,2573,17404,19977
2016-06-20 02:00:00-04:00,0,6,2,0,0,2862,16157,19019
2016-06-20 03:00:00-04:00,0,6,3,0,0,2949,16230,19179
2016-06-20 04:00:00-04:00,0,6,4,0,0,2854,17141,19995
2016-06-20 05:00:00-04:00,0,6,5,0,0,3057,18315,21372
2016-06-20 06:00:00-04:00,0,6,6,0,0,2894,18335,21229
2016-06-20 07:00:00-04:00,0,6,7,0,0,2023,16383,18406
2016-06-20 08:00:00-04:00,0,6,8,0,0,2269,16647,18916
2016-06-20 09:00:00-04:00,0,6,9,0,0,2288,15404,17692
2016-06-20 10:00:00-04:00,0,6,10,0,0,2438,13921,16359
2016-06-20 11:00:00-04:00,0,6,11,0,0,1718,8096,9814
2016-06-20 12:00:00-04:00,0,6,12,0,0,1054,4526,5580
2016-06-20 13:00:00-04:00,0,6,13,0,0,584,2897,3481
2016-06-20 14:00:00-04:00,0,6,14,0,0,374,2091,2465
2016-06-20 15:00:00-04:00,0,6,15,0,0,512,2534,3046
2016-06-20 16:00:00-04:00,0,6,16,0,0,530,4285,4815
2016-06-20 17:00:00-04:00,0,6,17,0,0,833,10154,10987
2016-06-20 18:00:00-04:00,0,6,18,0,0,1517,15708,17225
2016-06-20 19:00:00-04:00,0,6,19,0,0,2214,18580,20794
2016-06-20 20:00:00-04:00,0,6,20,0,0,2105,17661,19766
2016-06-20 21:00:00-04:00,0,6,21,0,0,1838,15347,17185
2016-06-20 22:00:00-04:00,0,6,22,0,0,1730,15504,17234
2016-06-20 23:00:00-04:00,0,6,23,0,0,1722,16456,18178
2016-06-21 00:00:00-04:00,0,6,0,1,0,1721,16708,18429
2016-06-21 01:00:00-04:00,0,6,1,1,0,2022,18227,20249
2016-06-21 02:00:00-04:00,0,6,2,1,0,2123,17246,19369
2016-06-21 03:00:00-04:00,0,6,3,1,0,2241,16152,18393
2016-06-21 04:00:00-04:00,0,6,4,1,0,2426,19160,21586
2016-06-21 05:00:00-04:00,0,6,5,1,0,2655,22187,24842
2016-06-21 06:00:00-04:00,0,6,6,1,0,2310,21202,23512
2016-06-21 07:00:00-04:00,0,6,7,1,0,1635,19782,21417
2016-06-21 08:00:00-04:00,0,6,8,1,0,1681,20308,21989
2016-06-21 09:00:00-04:00,0,6,9,1,0,1526,17811,19337
2016-06-21 10:00:00-04:00,0,6,10,1,0,1428,13370,14798
2016-06-21 11:00:00-04:00,0,6,11,1,0,1146,8725,9871
2016-06-21 12:00:00-04:00,0,6,12,1,0,784,5039,5823
2016-06-21 13:00:00-04:00,0,6,13,1,0,437,3043,3480
2016-06-21 14:00:00-04:00,0,6,14,1,0,293,1970,2263
2016-06-21 15:00:00-04:00,0,6,15,1,0,345,2106,2451
2016-06-21 16:00:00-04:00,0,6,16,1,0,400,3640,4040
2016-06-21 17:00:00-04:00,0,6,17,1,0,806,10614,11420
2016-06-21 18:00:00-04:00,0,6,18,1,0,1531,16874,18405
2016-06-21 19:00:00-04:00,0,6,19,1,0,2336,20117,22453
2016-06-21 20:00:00-04:00,0,6,20,1,0,2215,18810,21025
2016-06-21 21:00:00-04:00,0,6,21,1,0,1706,17189,18895
2016-06-21 22:00:00-04:00,0,6,22,1,0,1724,17071,18795
2016-06-21 23:00:00-04:00,0,6,23,1,0,1752,18030,19782
2016-06-22 00:00:00-04:00,0,6,0,2,0,1758,17712,19470
2016-06-22 01:00:00-04:00,0,6,1,2,0,2044,19081,21125
2016-06-22 02:00:00-04:00,0,6,2,2,0,2187,18021,20208
2016-06-22 03:00:00-04:00,0,6,3,2,0,2315,15662,17977
2016-06-22 04:00:00-04:00,0,6,4,2,0,2513,19152,21665
2016-06-22 05:00:00-04:00,0,6,5,2,0,2825,23328,26153
2016-06-22 06:00:00-04:00,0,6,6,2,0,2573,23189,25762
2016-06-22 07:00:00-04:00,0,6,7,2,0,1896,21417,23313
2016-06-22 08:00:00-04:00,0,6,8,2,0,1881,23111,24992
2016-06-22 09:00:00-04:00,0,6,9,2,0,1905,21785,23690
2016-06-22 10:00:00-04:00,0,6,10,2,0,1917,18776,20693
2016-06-22 11:00:00-04:00,0,6,11,2,0,1464,11293,12757
2016-06-22 12:00:00-04:00,0,6,12,2,0,920,6318,7238
2016-06-22 13:00:00-04:00,0,6,13,2,0,516,3692,4208
2016-06-22 14:00:00-04:00,0,6,14,2,0,349,2459,2808
2016-06-22 15:00:00-04:00,0,6,15,2,0,362,2522,2884
2016-06-22 16:00:00-04:00,0,6,16,2,0,400,3906,4306
2016-06-22 17:00:00-04:00,0,6,17,2,0,736,10012,10748
2016-06-22 18:00:00-04:00,0,6,18,2,0,1427,16428,17855
2016-06-22 19:00:00-04:00,0,6,19,2,0,2312,20348,22660
2016-06-22 20:00:00-04:00,0,6,20,2,0,2208,19395,21603
2016-06-22 21:00:00-04:00,0,6,21,2,0,1900,17397,19297
2016-06-22 22:00:00-04:00,0,6,22,2,0,1899,19076,20975
2016-06-22 23:00:00-04:00,0,6,23,2,0,1856,19204,21060
2016-06-23 00:00:00-04:00,0,6,0,3,0,1823,19294,21117
2016-06-23 01:00:00-04:00,0,6,1,3,0,2025,19068,21093
2016-06-23 02:00:00-04:00,0,6,2,3,0,2338,17757,20095
2016-06-23 03:00:00-04:00,0,6,3,3,0,2511,14871,17382
2016-06-23 04:00:00-04:00,0,6,4,3,0,2752,18448,21200
2016-06-23 05:00:00-04:00,0,6,5,3,0,2962,21991,24953
2016-06-23 06:00:00-04:00,0,6,6,3,0,2904,22722,25626
2016-06-23 07:00:00-04:00,0,6,7,3,0,1999,21296,23295
2016-06-23 08:00:00-04:00,0,6,8,3,0,2050,24156,26206
2016-06-23 09:00:00-04:00,0,6,9,3,0,2089,22999,25088
2016-06-23 10:00:00-04:00,0,6,10,3,0,2067,18795,20862
2016-06-23 11:00:00-04:00,0,6,11,3,0,1743,13059,14802
2016-06-23 12:00:00-04:00,0,6,12,3,0,1157,7248,8405
2016-06-23 13:00:00-04:00,0,6,13,3,0,680,4461,5141
2016-06-23 14:00:00-04:00,0,6,14,3,0,402,2988,3390
2016-06-23 15:00:00-04:00,0,6,15,3,0,396,2763,3159
2016-06-23 16:00:00-04:00,0,6,16,3,0,442,4132,4574
2016-06-23 17:00:00-04:00,0,6,17,3,0,755,10249,11004
2016-06-23 18:00:00-04:00,0,6,18,3,0,1499,17105,18604
2016-06-23 19:00:00-04:00,0,6,19,3,0,2374,21032,23406
2016-06-23 20:00:00-04:00,0,6,20,3,0,2204,19725,21929
2016-06-23 21:00:00-04:00,0,6,21,3,0,1905,17812,19717
2016-06-23 22:00:00-04:00,0,6,22,3,0,1859,18382,20241
2016-06-23 23:00:00-04:00,0,6,23,3,0,1861,18358,20219
2016-06-24 00:00:00-04:00,0,6,0,4,0,1839,18304,20143
2016-06-24 01:00:00-04:00,0,6,1,4,0,2230,19604,21834
2016-06-24 02:00:00-04:00,0,6,2,4,0,2351,18158,20509
2016-06-24 03:00:00-04:00,0,6,3,4,0,2534,15609,18143
2016-06-24 04:00:00-04:00,0,6,4,4,0,2893,19662,22555
2016-06-24 05:00:00-04:00,0,6,5,4,0,3585,24540,28125
2016-06-24 06:00:00-04:00,0,6,6,4,0,3066,24901,27967
2016-06-24 07:00:00-04:00,0,6,7,4,0,2198,21942,24140
2016-06-24 08:00:00-04:00,0,6,8,4,0,2256,24712,26968
2016-06-24 09:00:00-04:00,0,6,9,4,0,2375,23637,26012
2016-06-24 10:00:00-04:00,0,6,10,4,0,2428,21675,24103
2016-06-24 11:00:00-04:00,0,6,11,4,0,2014,17371,19385
2016-06-24 12:00:00-04:00,0,6,12,4,0,1396,11886,13282
2016-06-24 13:00:00-04:00,0,6,13,4,0,931,7639,8570
2016-06-24 14:00:00-04:00,0,6,14,4,0,568,5089,5657
2016-06-24 15:00:00-04:00,0,6,15,4,0,583,4554,5137
2016-06-24 16:00:00-04:00,0,6,16,4,0,524,5419,5943
2016-06-24 17:00:00-04:00,0,6,17,4,0,827,10267,11094
2016-06-24 18:00:00-04:00,0,6,18,4,0,1506,15211,16717
2016-06-24 19:00:00-04:00,0,6,19,4,0,2266,19332,21598
2016-06-24 20:00:00-04:00,0,6,20,4,0,2320,18369,20689
2016-06-24 21:00:00-04:00,0,6,21,4,0,2004,16882,18886
2016-06-24 22:00:00-04:00,0,6,22,4,0,1949,17218,19167
2016-06-24 23:00:00-04:00,0,6,23,4,0,1862,18278,20140
2016-06-25 00:00:00-04:00,0,6,0,5,0,1658,18040,19698
2016-06-25 01:00:00-04:00,0,6,1,5,0,2227,18564,20791
2016-06-25 02:00:00-04:00,0,6,2,5,0,2636,16728,19364
2016-06-25 03:00:00-04:00,0,6,3,5,0,2901,14653,17554
2016-06-25 04:00:00-04:00,0,6,4,5,0,3286,18144,21430
2016-06-25 05:00:00-04:00,0,6,5,5,0,3581,22078,25659
2016-06-25 06:00:00-04:00,0,6,6,5,0,3354,23113,26467
2016-06-25 07:00:00-04:00,0,6,7,5,0,2636,20934,23570
2016-06-25 08:00:00-04:00,0,6,8,5,0,2867,21900,24767
2016-06-25 09:00:00-04:00,0,6,9,5,0,3154,23184,26338
2016-06-25 10:00:00-04:00,0,6,10,5,0,3627,23541,27168
2016-06-25 11:00:00-04:00,0,6,11,5,0,3729,21560,25289
2016-06-25 12:00:00-04:00,0,6,12,5,0,3219,18647,21866
2016-06-25 13:00:00-04:00,0,6,13,5,0,2479,15469,17948
2016-06-25 14:00:00-04:00,0,6,14,5,0,1719,11993,13712
2016-06-25 15:00:00-04:00,0,6,15,5,0,1501,8083,9584
2016-06-25 16:00:00-04:00,0,6,16,5,0,843,4144,4987
2016-06-25 17:00:00-04:00,0,6,17,5,0,713,5030,5743
2016-06-25 18:00:00-04:00,0,6,18,5,0,862,7209,8071
2016-06-25 19:00:00-04:00,0,6,19,5,0,1178,10390,11568
2016-06-25 20:00:00-04:00,0,6,20,5,0,1660,13833,15493
2016-06-25 21:00:00-04:00,0,6,21,5,0,1875,16278,18153
2016-06-25 22:00:00-04:00,0,6,22,5,0,2179,18046,20225
2016-06-25 23:00:00-04:00,0,6,23,5,0,2357,19176,21533
2016-06-26 00:00:00-04:00,0,6,0,6,0,2342,19500,21842
2016-06-26 01:00:00-04:00,0,6,1,6,0,2525,18289,20814
2016-06-26 02:00:00-04:00,0,6,2,6,0,2857,18088,20945
2016-06-26 03:00:00-04:00,0,6,3,6,0,3170,17286,20456
2016-06-26 04:00:00-04:00,0,6,4,6,0,3311,19253,22564
2016-06-26 05:00:00-04:00,0,6,5,6,0,3639,21276,24915
2016-06-26 06:00:00-04:00,0,6,6,6,0,3425,21757,25182
2016-06-26 07:00:00-04:00,0,6,7,6,0,2807,18673,21480
2016-06-26 08:00:00-04:00,0,6,8,6,0,3140,20180,23320
2016-06-26 09:00:00-04:00,0,6,9,6,0,3537,22105,25642
2016-06-26 10:00:00-04:00,0,6,10,6,0,3885,22598,26483
2016-06-26 11:00:00-04:00,0,6,11,6,0,3893,22101,25994
2016-06-26 12:00:00-04:00,0,6,12,6,0,3437,19020,22457
2016-06-26 13:00:00-04:00,0,6,13,6,0,2636,15555,18191
2016-06-26 14:00:00-04:00,0,6,14,6,0,2036,12191,14227
2016-06-26 15:00:00-04:00,0,6,15,6,0,1641,8468,10109
2016-06-26 16:00:00-04:00,0,6,16,6,0,916,4074,4990
2016-06-26 17:00:00-04:00,0,6,17,6,0,598,3903,4501
2016-06-26 18:00:00-04:00,0,6,18,6,0,643,5433,6076
2016-06-26 19:00:00-04:00,0,6,19,6,0,881,8451,9332
2016-06-26 20:00:00-04:00,0,6,20,6,0,1316,11670,12986
2016-06-26 21:00:00-04:00,0,6,21,6,0,1762,14672,16434
2016-06-26 22:00:00-04:00,0,6,22,6,0,1986,16236,18222
2016-06-26 23:00:00-04:00,0,6,23,6,0,2214,16705,18919
2016-06-27 00:00:00-04:00,0,6,0,0,0,2125,16755,18880
2016-06-27 01:00:00-04:00,0,6,1,0,0,2536,16761,19297
2016-06-27 02:00:00-04:00,0,6,2,0,0,2657,15623,18280
2016-06-27 03:00:00-04:00,0,6,3,0,0,2784,14863,17647
2016-06-27 04:00:00-04:00,0,6,4,0,0,2837,15338,18175
2016-06-27 05:00:00-04:00,0,6,5,0,0,3000,16172,19172
2016-06-27 06:00:00-04:00,0,6,6,0,0,2851,15741,18592
2016-06-27 07:00:00-04:00,0,6,7,0,0,1984,14974,16958
2016-06-27 08:00:00-04:00,0,6,8,0,0,2088,16395,18483
2016-06-27 09:00:00-04:00,0,6,9,0,0,2143,16026,18169
2016-06-27 10:00:00-04:00,0,6,10,0,0,2399,14675,17074
2016-06-27 11:00:00-04:00,0,6,11,0,0,1784,11031,12815
2016-06-27 12:00:00-04:00,0,6,12,0,0,1120,6874,7994
2016-06-27 13:00:00-04:00,0,6,13,0,0,664,4296,4960
2016-06-27 14:00:00-04:00,0,6,14,0,0,447,3009,3456
2016-06-27 15:00:00-04:00,0,6,15,0,0,499,3231,3730
2016-06-27 16:00:00-04:00,0,6,16,0,0,579,4721,5300
2016-06-27 17:00:00-04:00,0,6,17,0,0,777,10357,11134
2016-06-27 18:00:00-04:00,0,6,18,0,0,1407,15284,16691
2016-06-27 19:00:00-04:00,0,6,19,0,0,2173,18649,20822
2016-06-27 20:00:00-04:00,0,6,20,0,0,2022,18132,20154
2016-06-27 21:00:00-04:00,0.03,6,21,0,0,1704,16308,18012
2016-06-27 22:00:00-04:00,0.04,6,22,0,0,1708,16083,17791
2016-06-27 23:00:00-04:00,0.11,6,23,0,0,1622,16874,18496
2016-06-28 00:00:00-04:00,0.1,6,0,1,0,1586,17209,18795
2016-06-28 01:00:00-04:00,0.26,6,1,1,0,1864,18469,20333
2016-06-28 02:00:00-04:00,0,6,2,1,0,2093,17334,19427
2016-06-28 03:00:00-04:00,0,6,3,1,0,2196,16077,18273
2016-06-28 04:00:00-04:00,0,6,4,1,0,2347,19198,21545
2016-06-28 05:00:00-04:00,0,6,5,1,0,2757,23116,25873
2016-06-28 06:00:00-04:00,0,6,6,1,0,2415,23095,25510
2016-06-28 07:00:00-04:00,0,6,7,1,0,1863,20445,22308
2016-06-28 08:00:00-04:00,0,6,8,1,0,2169,23546,25715
2016-06-28 09:00:00-04:00,0,6,9,1,0,2129,20165,22294
2016-06-28 10:00:00-04:00,0,6,10,1,0,1907,15256,17163
2016-06-28 11:00:00-04:00,0,6,11,1,0,1418,9401,10819
2016-06-28 12:00:00-04:00,0,6,12,1,0,776,4580,5356
2016-06-28 13:00:00-04:00,0,6,13,1,0,394,2534,2928
2016-06-28 14:00:00-04:00,0,6,14,1,0,247,1828,2075
2016-06-28 15:00:00-04:00,0,6,15,1,0,299,2179,2478
2016-06-28 16:00:00-04:00,0,6,16,1,0,409,3656,4065
2016-06-28 17:00:00-04:00,0,6,17,1,0,763,9929,10692
2016-06-28 18:00:00-04:00,0,6,18,1,0,1407,16121,17528
2016-06-28 19:00:00-04:00,0,6,19,1,0,2137,19872,22009
2016-06-28 20:00:00-04:00,0,6,20,1,0,2069,19283,21352
2016-06-28 21:00:00-04:00,0,6,21,1,0,1711,17073,18784
2016-06-28 22:00:00-04:00,0.04,6,22,1,0,1756,17307,19063
2016-06-28 23:00:00-04:00,0.03,6,23,1,0,1748,17820,19568
2016-06-29 00:00:00-04:00,0,6,0,2,0,1611,17175,18786
2016-06-29 01:00:00-04:00,0,6,1,2,0,1870,17633,19503
2016-06-29 02:00:00-04:00,0,6,2,2,0,2181,16882,19063
2016-06-29 03:00:00-04:00,0,6,3,2,0,2107,14899,17006
2016-06-29 04:00:00-04:00,0,6,4,2,0,2357,17669,20026
2016-06-29 05:00:00-04:00,0,6,5,2,0,2601,22260,24861
2016-06-29 06:00:00-04:00,0,6,6,2,0,2458,22410,24868
2016-06-29 07:00:00-04:00,0,6,7,2,0,1754,20767,22521
2016-06-29 08:00:00-04:00,0,6,8,2,0,1799,22411,24210
2016-06-29 09:00:00-04:00,0,6,9,2,0,1944,19974,21918
2016-06-29 10:00:00-04:00,0,6,10,2,0,1681,15077,16758
2016-06-29 11:00:00-04:00,0,6,11,2,0,1317,10792,12109
2016-06-29 12:00:00-04:00,0,6,12,2,0,777,6516,7293
2016-06-29 13:00:00-04:00,0,6,13,2,0,476,3848,4324
2016-06-29 14:00:00-04:00,0,6,14,2,0,308,2485,2793
2016-06-29 15:00:00-04:00,0,6,15,2,0,367,2552,2919
2016-06-29 16:00:00-04:00,0,6,16,2,0,395,3981,4376
2016-06-29 17:00:00-04:00,0,6,17,2,0,685,9817,10502
2016-06-29 18:00:00-04:00,0,6,18,2,0,1138,15597,16735
2016-06-29 19:00:00-04:00,0,6,19,2,0,2006,19617,21623
2016-06-29 20:00:00-04:00,0,6,20,2,0,1958,19252,21210
2016-06-29 21:00:00-04:00,0,6,21,2,0,1670,16869,18539
2016-06-29 22:00:00-04:00,0,6,22,2,0,1676,17003,18679
2016-06-29 23:00:00-04:00,0,6,23,2,0,1692,17835,19527
2016-06-30 00:00:00-04:00,0,6,0,3,0,1703,18015,19718
2016-06-30 01:00:00-04:00,0,6,1,3,0,1874,17956,19830
2016-06-30 02:00:00-04:00,0,6,2,3,0,2066,16676,18742
2016-06-30 03:00:00-04:00,0,6,3,3,0,2258,14247,16505
2016-06-30 04:00:00-04:00,0,6,4,3,0,2466,16985,19451
2016-06-30 05:00:00-04:00,0,6,5,3,0,2847,21346,24193
2016-06-30 06:00:00-04:00,0,6,6,3,0,2581,22282,24863
2016-06-30 07:00:00-04:00,0,6,7,3,0,1976,20776,22752
2016-06-30 08:00:00-04:00,0,6,8,3,0,1961,23119,25080
2016-06-30 09:00:00-04:00,0,6,9,3,0,2018,21785,23803
2016-06-30 10:00:00-04:00,0,6,10,3,0,1953,17774,19727
2016-06-30 11:00:00-04:00,0,6,11,3,0,1645,11872,13517
2016-06-30 12:00:00-04:00,0,6,12,3,0,1056,7098,8154
2016-06-30 13:00:00-04:00,0,6,13,3,0,616,4510,5126
2016-06-30 14:00:00-04:00,0,6,14,3,0,396,2933,3329
2016-06-30 15:00:00-04:00,0,6,15,3,0,374,2885,3259
2016-06-30 16:00:00-04:00,0,6,16,3,0,467,4105,4572
2016-06-30 17:00:00-04:00,0,6,17,3,0,740,10544,11284
2016-06-30 18:00:00-04:00,0,6,18,3,0,1175,15823,16998
2016-06-30 19:00:00-04:00,0,6,19,3,0,1964,19209,21173
2016-06-30 20:00:00-04:00,0,6,20,3,0,1971,18567,20538
2016-06-30 21:00:00-04:00,0,6,21,3,0,1745,16577,18322
2016-06-30 22:00:00-04:00,0,6,22,3,0,1682,16748,18430
2016-06-30 23:00:00-04:00,0,6,23,3,0,1803,18037,19840
2016-07-01 00:00:00-04:00,0,7,0,4,0,1776,17316,19092
2016-07-01 01:00:00-04:00,0,7,1,4,0,2111,17671,19782
2016-07-01 02:00:00-04:00,0,7,2,4,0,2315,15873,18188
2016-07-01 03:00:00-04:00,0,7,3,4,0,2510,13707,16217
2016-07-01 04:00:00-04:00,0,7,4,4,0,2831,17077,19908
2016-07-01 05:00:00-04:00,0,7,5,4,0,3004,20561,23565
2016-07-01 06:00:00-04:00,0,7,6,4,0,2846,21785,24631
2016-07-01 07:00:00-04:00,0,7,7,4,0,2182,20414,22596
2016-07-01 08:00:00-04:00,0,7,8,4,0,2330,22652,24982
2016-07-01 09:00:00-04:00,0,7,9,4,0,2469,22146,24615
2016-07-01 10:00:00-04:00,0,7,10,4,0,2417,20141,22558
2016-07-01 11:00:00-04:00,0,7,11,4,0,2005,16011,18016
2016-07-01 12:00:00-04:00,0,7,12,4,0,1470,10661,12131
2016-07-01 13:00:00-04:00,0,7,13,4,0,846,7193,8039
2016-07-01 14:00:00-04:00,0,7,14,4,0,520,4954,5474
2016-07-01 15:00:00-04:00,0,7,15,4,0,566,4284,4850
2016-07-01 16:00:00-04:00,0,7,16,4,0,528,4904,5432
2016-07-01 17:00:00-04:00,0.02,7,17,4,0,773,9212,9985
2016-07-01 18:00:00-04:00,0.03,7,18,4,0,1181,12525,13706
2016-07-01 19:00:00-04:00,0,7,19,4,0,1906,15733,17639
2016-07-01 20:00:00-04:00,0.04,7,20,4,0,2028,15590,17618
2016-07-01 21:00:00-04:00,0,7,21,4,0,1827,14350,16177
2016-07-01 22:00:00-04:00,0.19,7,22,4,0,1869,14492,16361
2016-07-01 23:00:00-04:00,0,7,23,4,0,1817,15378,17195
2016-07-02 00:00:00-04:00,0,7,0,5,0,1663,15352,17015
2016-07-02 01:00:00-04:00,0,7,1,5,0,2244,16091,18335
2016-07-02 02:00:00-04:00,0,7,2,5,0,3075,16786,19861
2016-07-02 03:00:00-04:00,0,7,3,5,0,3095,14152,17247
2016-07-02 04:00:00-04:00,0,7,4,5,0,3995,19448,23443
2016-07-02 05:00:00-04:00,0,7,5,5,0,3521,17558,21079
2016-07-02 06:00:00-04:00,0,7,6,5,0,3215,16114,19329
2016-07-02 07:00:00-04:00,0,7,7,5,0,2640,16142,18782
2016-07-02 08:00:00-04:00,0,7,8,5,0,2436,15457,17893
2016-07-02 09:00:00-04:00,0,7,9,5,0,2693,17932,20625
2016-07-02 10:00:00-04:00,0,7,10,5,0,2409,14671,17080
2016-07-02 11:00:00-04:00,0,7,11,5,0,2469,13610,16079
2016-07-02 12:00:00-04:00,0,7,12,5,0,2028,11869,13897
2016-07-02 13:00:00-04:00,0,7,13,5,0,1591,10103,11694
2016-07-02 14:00:00-04:00,0,7,14,5,0,1250,8045,9295
2016-07-02 15:00:00-04:00,0,7,15,5,0,1071,5843,6914
2016-07-02 16:00:00-04:00,0,7,16,5,0,656,3180,3836
2016-07-02 17:00:00-04:00,0,7,17,5,0,606,4346,4952
2016-07-02 18:00:00-04:00,0,7,18,5,0,759,5633,6392
2016-07-02 19:00:00-04:00,0,7,19,5,0,1031,7317,8348
2016-07-02 20:00:00-04:00,0,7,20,5,0,1318,9959,11277
2016-07-02 21:00:00-04:00,0,7,21,5,0,1572,11157,12729
2016-07-02 22:00:00-04:00,0,7,22,5,0,1822,12078,13900
2016-07-02 23:00:00-04:00,0,7,23,5,0,1931,12870,14801
2016-07-03 00:00:00-04:00,0,7,0,6,0,1987,13279,15266
2016-07-03 01:00:00-04:00,0,7,1,6,0,2361,13149,15510
2016-07-03 02:00:00-04:00,0,7,2,6,0,2484,12962,15446
2016-07-03 03:00:00-04:00,0,7,3,6,0,2551,12859,15410
2016-07-03 04:00:00-04:00,0,7,4,6,0,2736,13966,16702
2016-07-03 05:00:00-04:00,0,7,5,6,0,2856,14892,17748
2016-07-03 06:00:00-04:00,0,7,6,6,0,2661,14591,17252
2016-07-03 07:00:00-04:00,0,7,7,6,0,2153,12262,14415
2016-07-03 08:00:00-04:00,0,7,8,6,0,2495,13793,16288
2016-07-03 09:00:00-04:00,0,7,9,6,0,2905,14012,16917
2016-07-03 10:00:00-04:00,0,7,10,6,0,3134,14501,17635
2016-07-03 11:00:00-04:00,0,7,11,6,0,3072,12689,15761
2016-07-03 12:00:00-04:00,0,7,12,6,0,2699,10785,13484
2016-07-03 13:00:00-04:00,0,7,13,6,0,2115,9498,11613
2016-07-03 14:00:00-04:00,0,7,14,6,0,1609,7491,9100
2016-07-03 15:00:00-04:00,0,7,15,6,0,1317,5362,6679
2016-07-03 16:00:00-04:00,0,7,16,6,0,838,2609,3447
2016-07-03 17:00:00-04:00,0,7,17,6,0,514,2827,3341
2016-07-03 18:00:00-04:00,0,7,18,6,0,554,3775,4329
2016-07-03 19:00:00-04:00,0,7,19,6,0,690,4951,5641
2016-07-03 20:00:00-04:00,0,7,20,6,0,913,7412,8325
2016-07-03 21:00:00-04:00,0,7,21,6,0,1231,9372,10603
2016-07-03 22:00:00-04:00,0,7,22,6,0,1500,10798,12298
2016-07-03 23:00:00-04:00,0,7,23,6,0,1578,11581,13159
2016-07-04 00:00:00-04:00,0,7,0,0,1,1653,11874,13527
2016-07-04 01:00:00-04:00,0,7,1,0,1,1999,12579,14578
2016-07-04 02:00:00-04:00,0,7,2,0,1,2186,11983,14169
2016-07-04 03:00:00-04:00,0,7,3,0,1,2275,12224,14499
2016-07-04 04:00:00-04:00,0,7,4,0,1,2176,12973,15149
2016-07-04 05:00:00-04:00,0,7,5,0,1,2364,13295,15659
2016-07-04 06:00:00-04:00,0,7,6,0,1,2089,11893,13982
2016-07-04 07:00:00-04:00,0,7,7,0,1,1667,11028,12695
2016-07-04 08:00:00-04:00,0,7,8,0,1,1874,12183,14057
2016-07-04 09:00:00-04:00,0,7,9,0,1,2085,11750,13835
2016-07-04 10:00:00-04:00,0,7,10,0,1,2280,11411,13691
2016-07-04 11:00:00-04:00,0,7,11,0,1,2264,9281,11545
2016-07-04 12:00:00-04:00,0,7,12,0,1,1773,7181,8954
2016-07-04 13:00:00-04:00,0,7,13,0,1,1288,5561,6849
2016-07-04 14:00:00-04:00,0,7,14,0,1,911,4363,5274
2016-07-04 15:00:00-04:00,0,7,15,0,1,803,3414,4217
2016-07-04 16:00:00-04:00,0,7,16,0,1,564,2044,2608
2016-07-04 17:00:00-04:00,0,7,17,0,1,425,2483,2908
2016-07-04 18:00:00-04:00,0,7,18,0,1,395,2938,3333
2016-07-04 19:00:00-04:00,0,7,19,0,1,411,3728,4139
2016-07-04 20:00:00-04:00,0.04,7,20,0,1,605,5187,5792
2016-07-04 21:00:00-04:00,0.08,7,21,0,1,793,7442,8235
2016-07-04 22:00:00-04:00,0,7,22,0,1,1077,9098,10175
2016-07-04 23:00:00-04:00,0.08,7,23,0,1,1328,10583,11911
2016-07-05 00:00:00-04:00,0.27,7,0,1,0,1443,11417,12860
2016-07-05 01:00:00-04:00,0.16,7,1,1,0,1766,12157,13923
2016-07-05 02:00:00-04:00,0.13,7,2,1,0,2067,12575,14642
2016-07-05 03:00:00-04:00,0.43,7,3,1,0,2268,12879,15147
2016-07-05 04:00:00-04:00,0.01,7,4,1,0,2465,14303,16768
2016-07-05 05:00:00-04:00,0.01,7,5,1,0,2646,15315,17961
2016-07-05 06:00:00-04:00,0,7,6,1,0,2657,14854,17511
2016-07-05 07:00:00-04:00,0,7,7,1,0,2105,15088,17193
2016-07-05 08:00:00-04:00,0,7,8,1,0,2255,14732,16987
2016-07-05 09:00:00-04:00,0,7,9,1,0,2513,15381,17894
2016-07-05 10:00:00-04:00,0,7,10,1,0,2900,14833,17733
2016-07-05 11:00:00-04:00,0,7,11,1,0,2591,9887,12478
2016-07-05 12:00:00-04:00,0,7,12,1,0,1530,4435,5965
2016-07-05 13:00:00-04:00,0,7,13,1,0,792,2595,3387
2016-07-05 14:00:00-04:00,0,7,14,1,0,488,1855,2343
2016-07-05 15:00:00-04:00,0,7,15,1,0,456,2194,2650
2016-07-05 16:00:00-04:00,0,7,16,1,0,484,3718,4202
2016-07-05 17:00:00-04:00,0,7,17,1,0,744,9104,9848
2016-07-05 18:00:00-04:00,0,7,18,1,0,1149,12985,14134
2016-07-05 19:00:00-04:00,0,7,19,1,0,1897,16624,18521
2016-07-05 20:00:00-04:00,0,7,20,1,0,1910,16024,17934
2016-07-05 21:00:00-04:00,0,7,21,1,0,1599,13617,15216
2016-07-05 22:00:00-04:00,0,7,22,1,0,1527,13700,15227
2016-07-05 23:00:00-04:00,0,7,23,1,0,1573,14300,15873
2016-07-06 00:00:00-04:00,0,7,0,2,0,1507,14984,16491
2016-07-06 01:00:00-04:00,0,7,1,2,0,1741,15532,17273
2016-07-06 02:00:00-04:00,0,7,2,2,0,1894,15268,17162
2016-07-06 03:00:00-04:00,0,7,3,2,0,2058,14383,16441
2016-07-06 04:00:00-04:00,0,7,4,2,0,2142,16719,18861
2016-07-06 05:00:00-04:00,0,7,5,2,0,2409,19465,21874
2016-07-06 06:00:00-04:00,0,7,6,2,0,2162,17983,20145
2016-07-06 07:00:00-04:00,0,7,7,2,0,1572,15996,17568
2016-07-06 08:00:00-04:00,0,7,8,2,0,1613,16768,18381
2016-07-06 09:00:00-04:00,0,7,9,2,0,1451,14682,16133
2016-07-06 10:00:00-04:00,0,7,10,2,0,1251,10618,11869
2016-07-06 11:00:00-04:00,0,7,11,2,0,919,7128,8047
2016-07-06 12:00:00-04:00,0,7,12,2,0,620,4191,4811
2016-07-06 13:00:00-04:00,0,7,13,2,0,362,2812,3174
2016-07-06 14:00:00-04:00,0,7,14,2,0,255,1904,2159
2016-07-06 15:00:00-04:00,0,7,15,2,0,240,1977,2217
2016-07-06 16:00:00-04:00,0,7,16,2,0,281,3630,3911
2016-07-06 17:00:00-04:00,0,7,17,2,0,554,8736,9290
2016-07-06 18:00:00-04:00,0,7,18,2,0,963,12654,13617
2016-07-06 19:00:00-04:00,0,7,19,2,0,1581,15007,16588
2016-07-06 20:00:00-04:00,0,7,20,2,0,1676,15241,16917
2016-07-06 21:00:00-04:00,0,7,21,2,0,1478,14911,16389
2016-07-06 22:00:00-04:00,0,7,22,2,0,1415,15539,16954
2016-07-06 23:00:00-04:00,0,7,23,2,0,1460,16188,17648
2016-07-07 00:00:00-04:00,0,7,0,3,0,1434,16589,18023
2016-07-07 01:00:00-04:00,0,7,1,3,0,1546,16648,18194
2016-07-07 02:00:00-04:00,0,7,2,3,0,1599,16044,17643
2016-07-07 03:00:00-04:00,0,7,3,3,0,1776,14820,16596
2016-07-07 04:00:00-04:00,0,7,4,3,0,1848,16781,18629
2016-07-07 05:00:00-04:00,0,7,5,3,0,2163,19874,22037
2016-07-07 06:00:00-04:00,0,7,6,3,0,2127,20587,22714
2016-07-07 07:00:00-04:00,0,7,7,3,0,1728,18959,20687
2016-07-07 08:00:00-04:00,0,7,8,3,0,1619,18718,20337
2016-07-07 09:00:00-04:00,0,7,9,3,0,1432,17297,18729
2016-07-07 10:00:00-04:00,0,7,10,3,0,1263,14913,16176
2016-07-07 11:00:00-04:00,0,7,11,3,0,999,9623,10622
2016-07-07 12:00:00-04:00,0,7,12,3,0,748,5783,6531
2016-07-07 13:00:00-04:00,0,7,13,3,0,437,3748,4185
2016-07-07 14:00:00-04:00,0.02,7,14,3,0,329,2435,2764
2016-07-07 15:00:00-04:00,0,7,15,3,0,307,2258,2565
2016-07-07 16:00:00-04:00,0,7,16,3,0,342,3575,3917
2016-07-07 17:00:00-04:00,0,7,17,3,0,659,9435,10094
2016-07-07 18:00:00-04:00,0,7,18,3,0,1233,15188,16421
2016-07-07 19:00:00-04:00,0,7,19,3,0,2109,18577,20686
2016-07-07 20:00:00-04:00,0,7,20,3,0,2020,17854,19874
2016-07-07 21:00:00-04:00,0,7,21,3,0,1744,16754,18498
2016-07-07 22:00:00-04:00,0,7,22,3,0,1699,16855,18554
2016-07-07 23:00:00-04:00,0,7,23,3,0,1656,17766,19422
2016-07-08 00:00:00-04:00,0,7,0,4,0,1691,18096,19787
2016-07-08 01:00:00-04:00,0,7,1,4,0,2047,19418,21465
2016-07-08 02:00:00-04:00,0,7,2,4,0,2007,16548,18555
2016-07-08 03:00:00-04:00,0,7,3,4,0,2216,14754,16970
2016-07-08 04:00:00-04:00,0,7,4,4,0,2462,17687,20149
2016-07-08 05:00:00-04:00,0,7,5,4,0,3013,22054,25067
2016-07-08 06:00:00-04:00,0,7,6,4,0,2771,21445,24216
2016-07-08 07:00:00-04:00,0,7,7,4,0,2358,20964,23322
2016-07-08 08:00:00-04:00,0,7,8,4,0,2197,21026,23223
2016-07-08 09:00:00-04:00,0,7,9,4,0,2126,20533,22659
2016-07-08 10:00:00-04:00,0,7,10,4,0,1964,18028,19992
2016-07-08 11:00:00-04:00,0,7,11,4,0,1568,13399,14967
2016-07-08 12:00:00-04:00,0,7,12,4,0,1106,8357,9463
2016-07-08 13:00:00-04:00,0,7,13,4,0,739,5521,6260
2016-07-08 14:00:00-04:00,0,7,14,4,0,481,3622,4103
2016-07-08 15:00:00-04:00,0,7,15,4,0,402,3159,3561
2016-07-08 16:00:00-04:00,0,7,16,4,0,391,3935,4326
2016-07-08 17:00:00-04:00,0,7,17,4,0,659,9558,10217
2016-07-08 18:00:00-04:00,0,7,18,4,0,1223,14022,15245
2016-07-08 19:00:00-04:00,0,7,19,4,0,2123,17993,20116
2016-07-08 20:00:00-04:00,0,7,20,4,0,1977,17368,19345
2016-07-08 21:00:00-04:00,0,7,21,4,0,1803,15343,17146
2016-07-08 22:00:00-04:00,0.01,7,22,4,0,1647,15806,17453
2016-07-08 23:00:00-04:00,0,7,23,4,0,1691,16719,18410
2016-07-09 00:00:00-04:00,0,7,0,5,0,1568,16546,18114
2016-07-09 01:00:00-04:00,0,7,1,5,0,1829,17270,19099
2016-07-09 02:00:00-04:00,0,7,2,5,0,2182,15918,18100
2016-07-09 03:00:00-04:00,0,7,3,5,0,2524,15126,17650
2016-07-09 04:00:00-04:00,0,7,4,5,0,3174,18551,21725
2016-07-09 05:00:00-04:00,0,7,5,5,0,3930,23250,27180
2016-07-09 06:00:00-04:00,0,7,6,5,0,3156,20516,23672
2016-07-09 07:00:00-04:00,0,7,7,5,0,2652,17778,20430
2016-07-09 08:00:00-04:00,0,7,8,5,0,2757,17528,20285
2016-07-09 09:00:00-04:00,0,7,9,5,0,3152,20656,23808
2016-07-09 10:00:00-04:00,0,7,10,5,0,3108,19611,22719
2016-07-09 11:00:00-04:00,0,7,11,5,0,3146,18731,21877
2016-07-09 12:00:00-04:00,0,7,12,5,0,2690,16760,19450
2016-07-09 13:00:00-04:00,0,7,13,5,0,2132,13911,16043
2016-07-09 14:00:00-04:00,0,7,14,5,0,1779,10570,12349
2016-07-09 15:00:00-04:00,0,7,15,5,0,1293,6574,7867
2016-07-09 16:00:00-04:00,0,7,16,5,0,706,3221,3927
2016-07-09 17:00:00-04:00,0,7,17,5,0,621,4161,4782
2016-07-09 18:00:00-04:00,0,7,18,5,0,737,5430,6167
2016-07-09 19:00:00-04:00,0,7,19,5,0,1026,7609,8635
2016-07-09 20:00:00-04:00,0,7,20,5,0,1269,10332,11601
2016-07-09 21:00:00-04:00,0,7,21,5,0,1482,12778,14260
2016-07-09 22:00:00-04:00,0.22,7,22,5,0,1742,14540,16282
2016-07-09 23:00:00-04:00,0.09,7,23,5,0,1903,15532,17435
2016-07-10 00:00:00-04:00,0,7,0,6,0,1923,15688,17611
2016-07-10 01:00:00-04:00,0,7,1,6,0,2169,15521,17690
2016-07-10 02:00:00-04:00,0,7,2,6,0,2538,15825,18363
2016-07-10 03:00:00-04:00,0,7,3,6,0,2599,15532,18131
2016-07-10 04:00:00-04:00,0,7,4,6,0,2560,17126,19686
2016-07-10 05:00:00-04:00,0,7,5,6,0,2953,18060,21013
2016-07-10 06:00:00-04:00,0,7,6,6,0,3088,18112,21200
2016-07-10 07:00:00-04:00,0,7,7,6,0,3017,17666,20683
2016-07-10 08:00:00-04:00,0,7,8,6,0,3082,17150,20232
2016-07-10 09:00:00-04:00,0,7,9,6,0,4266,22449,26715
2016-07-10 10:00:00-04:00,0,7,10,6,0,3989,19735,23724
2016-07-10 11:00:00-04:00,0,7,11,6,0,3163,16968,20131
2016-07-10 12:00:00-04:00,0,7,12,6,0,3058,16062,19120
2016-07-10 13:00:00-04:00,0,7,13,6,0,2573,14229,16802
2016-07-10 14:00:00-04:00,0,7,14,6,0,2018,10995,13013
2016-07-10 15:00:00-04:00,0,7,15,6,0,1438,7006,8444
2016-07-10 16:00:00-04:00,0,7,16,6,0,775,3230,4005
2016-07-10 17:00:00-04:00,0,7,17,6,0,587,3382,3969
2016-07-10 18:00:00-04:00,0,7,18,6,0,565,4380,4945
2016-07-10 19:00:00-04:00,0,7,19,6,0,708,6133,6841
2016-07-10 20:00:00-04:00,0,7,20,6,0,1161,9186,10347
2016-07-10 21:00:00-04:00,0,7,21,6,0,1463,12364,13827
2016-07-10 22:00:00-04:00,0,7,22,6,0,1729,14991,16720
2016-07-10 23:00:00-04:00,0,7,23,6,0,1796,15898,17694
2016-07-11 00:00:00-04:00,0,7,0,0,0,1921,17019,18940
2016-07-11 01:00:00-04:00,0,7,1,0,0,2195,17728,19923
2016-07-11 02:00:00-04:00,0,7,2,0,0,2180,16584,18764
2016-07-11 03:00:00-04:00,0,7,3,0,0,2237,14921,17158
2016-07-11 04:00:00-04:00,0,7,4,0,0,2200,16318,18518
2016-07-11 05:00:00-04:00,0,7,5,0,0,2517,17126,19643
2016-07-11 06:00:00-04:00,0,7,6,0,0,2354,15509,17863
2016-07-11 07:00:00-04:00,0,7,7,0,0,2164,14431,16595
2016-07-11 08:00:00-04:00,0,7,8,0,0,2175,14726,16901
2016-07-11 09:00:00-04:00,0,7,9,0,0,2014,13176,15190
2016-07-11 10:00:00-04:00,0,7,10,0,0,1755,10331,12086
2016-07-11 11:00:00-04:00,0,7,11,0,0,1274,6920,8194
2016-07-11 12:00:00-04:00,0,7,12,0,0,878,3832,4710
2016-07-11 13:00:00-04:00,0,7,13,0,0,526,2533,3059
2016-07-11 14:00:00-04:00,0,7,14,0,0,399,1811,2210
2016-07-11 15:00:00-04:00,0,7,15,0,0,454,2241,2695
2016-07-11 16:00:00-04:00,0,7,16,0,0,413,3688,4101
2016-07-11 17:00:00-04:00,0,7,17,0,0,679,9300,9979
2016-07-11 18:00:00-04:00,0,7,18,0,0,1243,14173,15416
2016-07-11 19:00:00-04:00,0,7,19,0,0,2032,17723,19755
2016-07-11 20:00:00-04:00,0,7,20,0,0,1844,16371,18215
2016-07-11 21:00:00-04:00,0,7,21,0,0,1595,14180,15775
2016-07-11 22:00:00-04:00,0,7,22,0,0,1581,14196,15777
2016-07-11 23:00:00-04:00,0,7,23,0,0,1462,14820,16282
2016-07-12 00:00:00-04:00,0,7,0,1,0,1465,15108,16573
2016-07-12 01:00:00-04:00,0,7,1,1,0,1610,16048,17658
2016-07-12 02:00:00-04:00,0,7,2,1,0,1737,15648,17385
2016-07-12 03:00:00-04:00,0,7,3,1,0,1984,14829,16813
2016-07-12 04:00:00-04:00,0,7,4,1,0,2126,17041,19167
2016-07-12 05:00:00-04:00,0,7,5,1,0,2273,20293,22566
2016-07-12 06:00:00-04:00,0,7,6,1,0,2284,20246,22530
2016-07-12 07:00:00-04:00,0,7,7,1,0,1859,18135,19994
2016-07-12 08:00:00-04:00,0,7,8,1,0,1792,18273,20065
2016-07-12 09:00:00-04:00,0,7,9,1,0,1510,16464,17974
2016-07-12 10:00:00-04:00,0,7,10,1,0,1296,12764,14060
2016-07-12 11:00:00-04:00,0,7,11,1,0,1038,8166,9204
2016-07-12 12:00:00-04:00,0,7,12,1,0,721,4728,5449
2016-07-12 13:00:00-04:00,0,7,13,1,0,437,2912,3349
2016-07-12 14:00:00-04:00,0,7,14,1,0,294,1912,2206
2016-07-12 15:00:00-04:00,0,7,15,1,0,298,1984,2282
2016-07-12 16:00:00-04:00,0,7,16,1,0,377,3600,3977
2016-07-12 17:00:00-04:00,0,7,17,1,0,705,9767,10472
2016-07-12 18:00:00-04:00,0,7,18,1,0,1144,14817,15961
2016-07-12 19:00:00-04:00,0,7,19,1,0,1996,19577,21573
2016-07-12 20:00:00-04:00,0,7,20,1,0,1942,18181,20123
2016-07-12 21:00:00-04:00,0,7,21,1,0,1644,16063,17707
2016-07-12 22:00:00-04:00,0,7,22,1,0,1561,16147,17708
2016-07-12 23:00:00-04:00,0,7,23,1,0,1495,16781,18276
2016-07-13 00:00:00-04:00,0,7,0,2,0,1466,16887,18353
2016-07-13 01:00:00-04:00,0,7,1,2,0,1630,17472,19102
2016-07-13 02:00:00-04:00,0,7,2,2,0,1822,16950,18772
2016-07-13 03:00:00-04:00,0,7,3,2,0,1976,15385,17361
2016-07-13 04:00:00-04:00,0,7,4,2,0,2185,17844,20029
2016-07-13 05:00:00-04:00,0,7,5,2,0,2403,21808,24211
2016-07-13 06:00:00-04:00,0,7,6,2,0,2361,21859,24220
2016-07-13 07:00:00-04:00,0,7,7,2,0,2005,21016,23021
2016-07-13 08:00:00-04:00,0,7,8,2,0,1982,21698,23680
2016-07-13 09:00:00-04:00,0,7,9,2,0,1808,19900,21708
2016-07-13 10:00:00-04:00,0,7,10,2,0,1656,15939,17595
2016-07-13 11:00:00-04:00,0,7,11,2,0,1245,10367,11612
2016-07-13 12:00:00-04:00,0,7,12,2,0,794,5893,6687
2016-07-13 13:00:00-04:00,0,7,13,2,0,493,3911,4404
2016-07-13 14:00:00-04:00,0,7,14,2,0,360,2441,2801
2016-07-13 15:00:00-04:00,0,7,15,2,0,341,2373,2714
2016-07-13 16:00:00-04:00,0,7,16,2,0,397,3880,4277
2016-07-13 17:00:00-04:00,0,7,17,2,0,649,10042,10691
2016-07-13 18:00:00-04:00,0,7,18,2,0,1264,16059,17323
2016-07-13 19:00:00-04:00,0,7,19,2,0,2109,20218,22327
2016-07-13 20:00:00-04:00,0,7,20,2,0,2014,19160,21174
2016-07-13 21:00:00-04:00,0,7,21,2,0,1658,17191,18849
2016-07-13 22:00:00-04:00,0,7,22,2,0,1582,17239,18821
2016-07-13 23:00:00-04:00,0,7,23,2,0,1620,18252,19872
2016-07-14 00:00:00-04:00,0,7,0,3,0,1847,19769,21616
2016-07-14 01:00:00-04:00,0,7,1,3,0,1909,19468,21377
2016-07-14 02:00:00-04:00,0,7,2,3,0,2066,18147,20213
2016-07-14 03:00:00-04:00,0,7,3,3,0,2196,15689,17885
2016-07-14 04:00:00-04:00,0,7,4,3,0,2572,18334,20906
2016-07-14 05:00:00-04:00,0,7,5,3,0,2783,23030,25813
2016-07-14 06:00:00-04:00,0,7,6,3,0,2744,24066,26810
2016-07-14 07:00:00-04:00,0,7,7,3,0,2264,22509,24773
2016-07-14 08:00:00-04:00,0,7,8,3,0,2196,23392,25588
2016-07-14 09:00:00-04:00,0,7,9,3,0,1981,21404,23385
2016-07-14 10:00:00-04:00,0,7,10,3,0,1786,17843,19629
2016-07-14 11:00:00-04:00,0,7,11,3,0,1357,12190,13547
2016-07-14 12:00:00-04:00,0,7,12,3,0,952,7226,8178
2016-07-14 13:00:00-04:00,0,7,13,3,0,592,4512,5104
2016-07-14 14:00:00-04:00,0,7,14,3,0,430,2805,3235
2016-07-14 15:00:00-04:00,0,7,15,3,0,397,2627,3024
2016-07-14 16:00:00-04:00,0.5,7,16,3,0,427,3983,4410
2016-07-14 17:00:00-04:00,0,7,17,3,0,740,10701,11441
2016-07-14 18:00:00-04:00,0,7,18,3,0,1251,16912,18163
2016-07-14 19:00:00-04:00,0,7,19,3,0,2263,20469,22732
2016-07-14 20:00:00-04:00,0,7,20,3,0,2102,19633,21735
2016-07-14 21:00:00-04:00,0,7,21,3,0,1743,17657,19400
2016-07-14 22:00:00-04:00,0,7,22,3,0,1636,17521,19157
2016-07-14 23:00:00-04:00,0,7,23,3,0,1657,18792,20449
2016-07-15 00:00:00-04:00,0,7,0,4,0,1741,18567,20308
2016-07-15 01:00:00-04:00,0,7,1,4,0,1897,19364,21261
2016-07-15 02:00:00-04:00,0,7,2,4,0,2210,18282,20492
2016-07-15 03:00:00-04:00,0,7,3,4,0,3085,14797,17882
2016-07-15 04:00:00-04:00,0,7,4,4,0,2472,15573,18045
2016-07-15 05:00:00-04:00,0,7,5,4,0,2815,21005,23820
2016-07-15 06:00:00-04:00,0,7,6,4,0,2691,23351,26042
2016-07-15 07:00:00-04:00,0,7,7,4,0,2453,22840,25293
2016-07-15 08:00:00-04:00,0,7,8,4,0,2446,23457,25903
2016-07-15 09:00:00-04:00,0,7,9,4,0,2493,21971,24464
2016-07-15 10:00:00-04:00,0,7,10,4,0,2175,19915,22090
2016-07-15 11:00:00-04:00,0,7,11,4,0,1800,16619,18419
2016-07-15 12:00:00-04:00,0,7,12,4,0,1286,11009,12295
2016-07-15 13:00:00-04:00,0,7,13,4,0,866,6720,7586
2016-07-15 14:00:00-04:00,0,7,14,4,0,576,4566,5142
2016-07-15 15:00:00-04:00,0,7,15,4,0,464,3940,4404
2016-07-15 16:00:00-04:00,0,7,16,4,0,484,4628,5112
2016-07-15 17:00:00-04:00,0,7,17,4,0,781,10176,10957
2016-07-15 18:00:00-04:00,0,7,18,4,0,1303,15389,16692
2016-07-15 19:00:00-04:00,0,7,19,4,0,2260,19528,21788
2016-07-15 20:00:00-04:00,0,7,20,4,0,2284,18821,21105
2016-07-15 21:00:00-04:00,0,7,21,4,0,1871,16560,18431
2016-07-15 22:00:00-04:00,0,7,22,4,0,1803,17302,19105
2016-07-15 23:00:00-04:00,0,7,23,4,0,1776,17460,19236
2016-07-16 00:00:00-04:00,0,7,0,5,0,1627,17224,18851
2016-07-16 01:00:00-04:00,0,7,1,5,0,1977,17969,19946
2016-07-16 02:00:00-04:00,0,7,2,5,0,2312,16868,19180
2016-07-16 03:00:00-04:00,0,7,3,5,0,2629,14847,17476
2016-07-16 04:00:00-04:00,0,7,4,5,0,2990,18038,21028
2016-07-16 05:00:00-04:00,0,7,5,5,0,3324,21644,24968
2016-07-16 06:00:00-04:00,0,7,6,5,0,3244,22161,25405
2016-07-16 07:00:00-04:00,0,7,7,5,0,2995,20536,23531
2016-07-16 08:00:00-04:00,0,7,8,5,0,3102,20187,23289
2016-07-16 09:00:00-04:00,0,7,9,5,0,3224,21091,24315
2016-07-16 10:00:00-04:00,0,7,10,5,0,3475,20625,24100
2016-07-16 11:00:00-04:00,0,7,11,5,0,3304,19439,22743
2016-07-16 12:00:00-04:00,0,7,12,5,0,2847,17019,19866
2016-07-16 13:00:00-04:00,0,7,13,5,0,2367,14626,16993
2016-07-16 14:00:00-04:00,0,7,14,5,0,1925,11449,13374
2016-07-16 15:00:00-04:00,0,7,15,5,0,1426,7084,8510
2016-07-16 16:00:00-04:00,0,7,16,5,0,763,3743,4506
2016-07-16 17:00:00-04:00,0,7,17,5,0,686,4657,5343
2016-07-16 18:00:00-04:00,0,7,18,5,0,822,6625,7447
2016-07-16 19:00:00-04:00,0,7,19,5,0,1043,8686,9729
2016-07-16 20:00:00-04:00,0,7,20,5,0,1525,12299,13824
2016-07-16 21:00:00-04:00,0,7,21,5,0,1777,14313,16090
2016-07-16 22:00:00-04:00,0,7,22,5,0,1973,16157,18130
2016-07-16 23:00:00-04:00,0,7,23,5,0,2217,17313,19530
2016-07-17 00:00:00-04:00,0,7,0,6,0,2243,18382,20625
2016-07-17 01:00:00-04:00,0,7,1,6,0,2440,18187,20627
2016-07-17 02:00:00-04:00,0,7,2,6,0,2903,18118,21021
2016-07-17 03:00:00-04:00,0,7,3,6,0,3448,18384,21832
2016-07-17 04:00:00-04:00,0,7,4,6,0,2829,16840,19669
2016-07-17 05:00:00-04:00,0,7,5,6,0,3047,17967,21014
2016-07-17 06:00:00-04:00,0,7,6,6,0,3310,18626,21936
2016-07-17 07:00:00-04:00,0,7,7,6,0,3116,16652,19768
2016-07-17 08:00:00-04:00,0,7,8,6,0,3261,17111,20372
2016-07-17 09:00:00-04:00,0,7,9,6,0,3339,17869,21208
2016-07-17 10:00:00-04:00,0,7,10,6,0,3685,18903,22588
2016-07-17 11:00:00-04:00,0,7,11,6,0,3570,18647,22217
2016-07-17 12:00:00-04:00,0,7,12,6,0,3216,17016,20232
2016-07-17 13:00:00-04:00,0,7,13,6,0,2786,14596,17382
2016-07-17 14:00:00-04:00,0,7,14,6,0,2336,11682,14018
2016-07-17 15:00:00-04:00,0,7,15,6,0,1611,7604,9215
2016-07-17 16:00:00-04:00,0,7,16,6,0,884,3534,4418
2016-07-17 17:00:00-04:00,0,7,17,6,0,620,3543,4163
2016-07-17 18:00:00-04:00,0,7,18,6,0,596,4499,5095
2016-07-17 19:00:00-04:00,0,7,19,6,0,749,6650,7399
2016-07-17 20:00:00-04:00,0,7,20,6,0,1132,9683,10815
2016-07-17 21:00:00-04:00,0,7,21,6,0,1536,13481,15017
2016-07-17 22:00:00-04:00,0,7,22,6,0,1825,16230,18055
2016-07-17 23:00:00-04:00,0,7,23,6,0,2049,17466,19515
2016-07-18 00:00:00-04:00,0,7,0,0,0,2065,18025,20090
2016-07-18 01:00:00-04:00,0,7,1,0,0,2223,18317,20540
2016-07-18 02:00:00-04:00,0,7,2,0,0,2363,17720,20083
2016-07-18 03:00:00-04:00,0,7,3,0,0,2443,17172,19615
2016-07-18 04:00:00-04:00,0,7,4,0,0,2443,18166,20609
2016-07-18 05:00:00-04:00,0,7,5,0,0,2597,18317,20914
2016-07-18 06:00:00-04:00,0,7,6,0,0,2512,17078,19590
2016-07-18 07:00:00-04:00,0,7,7,0,0,2079,15281,17360
2016-07-18 08:00:00-04:00,0,7,8,0,0,2271,15604,17875
2016-07-18 09:00:00-04:00,0,7,9,0,0,2195,13766,15961
2016-07-18 10:00:00-04:00,0,7,10,0,0,1963,11593,13556
2016-07-18 11:00:00-04:00,0,7,11,0,0,1445,8368,9813
2016-07-18 12:00:00-04:00,0,7,12,0,0,885,4821,5706
2016-07-18 13:00:00-04:00,0,7,13,0,0,569,2735,3304
2016-07-18 14:00:00-04:00,0,7,14,0,0,392,1863,2255
2016-07-18 15:00:00-04:00,0,7,15,0,0,475,2382,2857
2016-07-18 16:00:00-04:00,0,7,16,0,0,459,3907,4366
2016-07-18 17:00:00-04:00,0.12,7,17,0,0,742,9898,10640
2016-07-18 18:00:00-04:00,0,7,18,0,0,1363,15400,16763
2016-07-18 19:00:00-04:00,0,7,19,0,0,2078,18712,20790
2016-07-18 20:00:00-04:00,0,7,20,0,0,2086,18225,20311
2016-07-18 21:00:00-04:00,0,7,21,0,0,1691,16169,17860
2016-07-18 22:00:00-04:00,0,7,22,0,0,1723,16224,17947
2016-07-18 23:00:00-04:00,0,7,23,0,0,1594,17136,18730
2016-07-19 00:00:00-04:00,0,7,0,1,0,1622,17880,19502
2016-07-19 01:00:00-04:00,0,7,1,1,0,1725,18289,20014
2016-07-19 02:00:00-04:00,0,7,2,1,0,1873,17317,19190
2016-07-19 03:00:00-04:00,0,7,3,1,0,2453,17218,19671
2016-07-19 04:00:00-04:00,0,7,4,1,0,2995,19093,22088
2016-07-19 05:00:00-04:00,0,7,5,1,0,2320,18943,21263
2016-07-19 06:00:00-04:00,0,7,6,1,0,2275,19609,21884
2016-07-19 07:00:00-04:00,0,7,7,1,0,1832,18301,20133
2016-07-19 08:00:00-04:00,0,7,8,1,0,1719,18272,19991
2016-07-19 09:00:00-04:00,0,7,9,1,0,1504,16586,18090
2016-07-19 10:00:00-04:00,0,7,10,1,0,1361,12313,13674
2016-07-19 11:00:00-04:00,0,7,11,1,0,1012,8397,9409
2016-07-19 12:00:00-04:00,0,7,12,1,0,752,5114,5866
2016-07-19 13:00:00-04:00,0,7,13,1,0,415,2973,3388
2016-07-19 14:00:00-04:00,0,7,14,1,0,285,1940,2225
2016-07-19 15:00:00-04:00,0,7,15,1,0,338,2170,2508
2016-07-19 16:00:00-04:00,0,7,16,1,0,402,3963,4365
2016-07-19 17:00:00-04:00,0,7,17,1,0,684,10243,10927
2016-07-19 18:00:00-04:00,0,7,18,1,0,1197,15720,16917
2016-07-19 19:00:00-04:00,0,7,19,1,0,2040,19597,21637
2016-07-19 20:00:00-04:00,0,7,20,1,0,1802,18442,20244
2016-07-19 21:00:00-04:00,0,7,21,1,0,1599,16384,17983
2016-07-19 22:00:00-04:00,0,7,22,1,0,1567,16040,17607
2016-07-19 23:00:00-04:00,0,7,23,1,0,1493,17173,18666
2016-07-20 00:00:00-04:00,0,7,0,2,0,1462,17201,18663
2016-07-20 01:00:00-04:00,0,7,1,2,0,1566,17718,19284
2016-07-20 02:00:00-04:00,0,7,2,2,0,1848,16823,18671
2016-07-20 03:00:00-04:00,0,7,3,2,0,1993,14989,16982
2016-07-20 04:00:00-04:00,0,7,4,2,0,2214,17202,19416
2016-07-20 05:00:00-04:00,0,7,5,2,0,2546,21336,23882
2016-07-20 06:00:00-04:00,0,7,6,2,0,2419,21680,24099
2016-07-20 07:00:00-04:00,0,7,7,2,0,2056,21025,23081
2016-07-20 08:00:00-04:00,0,7,8,2,0,1999,21867,23866
2016-07-20 09:00:00-04:00,0,7,9,2,0,1879,20277,22156
2016-07-20 10:00:00-04:00,0,7,10,2,0,1757,16036,17793
2016-07-20 11:00:00-04:00,0,7,11,2,0,1286,10914,12200
2016-07-20 12:00:00-04:00,0,7,12,2,0,830,6304,7134
2016-07-20 13:00:00-04:00,0,7,13,2,0,510,3866,4376
2016-07-20 14:00:00-04:00,0,7,14,2,0,394,2587,2981
2016-07-20 15:00:00-04:00,0,7,15,2,0,335,2623,2958
2016-07-20 16:00:00-04:00,0,7,16,2,0,382,3886,4268
2016-07-20 17:00:00-04:00,0,7,17,2,0,668,9860,10528
2016-07-20 18:00:00-04:00,0,7,18,2,0,1235,15887,17122
2016-07-20 19:00:00-04:00,0,7,19,2,0,2041,19856,21897
2016-07-20 20:00:00-04:00,0,7,20,2,0,1931,18231,20162
2016-07-20 21:00:00-04:00,0,7,21,2,0,1659,16536,18195
2016-07-20 22:00:00-04:00,0,7,22,2,0,1661,16520,18181
2016-07-20 23:00:00-04:00,0,7,23,2,0,1556,17451,19007
2016-07-21 00:00:00-04:00,0,7,0,3,0,1513,17389,18902
2016-07-21 01:00:00-04:00,0,7,1,3,0,1715,17877,19592
2016-07-21 02:00:00-04:00,0,7,2,3,0,1916,17238,19154
2016-07-21 03:00:00-04:00,0,7,3,3,0,2069,14439,16508
2016-07-21 04:00:00-04:00,0,7,4,3,0,2305,16937,19242
2016-07-21 05:00:00-04:00,0,7,5,3,0,2617,21173,23790
2016-07-21 06:00:00-04:00,0,7,6,3,0,2619,22724,25343
2016-07-21 07:00:00-04:00,0,7,7,3,0,2242,21704,23946
2016-07-21 08:00:00-04:00,0,7,8,3,0,2275,23066,25341
2016-07-21 09:00:00-04:00,0,7,9,3,0,2112,21826,23938
2016-07-21 10:00:00-04:00,0,7,10,3,0,1958,18588,20546
2016-07-21 11:00:00-04:00,0,7,11,3,0,1505,12072,13577
2016-07-21 12:00:00-04:00,0,7,12,3,0,984,7147,8131
2016-07-21 13:00:00-04:00,0,7,13,3,0,678,4331,5009
2016-07-21 14:00:00-04:00,0,7,14,3,0,435,2877,3312
2016-07-21 15:00:00-04:00,0,7,15,3,0,439,2621,3060
2016-07-21 16:00:00-04:00,0,7,16,3,0,402,4170,4572
2016-07-21 17:00:00-04:00,0,7,17,3,0,700,10655,11355
2016-07-21 18:00:00-04:00,0,7,18,3,0,1325,16207,17532
2016-07-21 19:00:00-04:00,0,7,19,3,0,2148,19429,21577
2016-07-21 20:00:00-04:00,0,7,20,3,0,1998,18564,20562
2016-07-21 21:00:00-04:00,0,7,21,3,0,1749,16930,18679
2016-07-21 22:00:00-04:00,0,7,22,3,0,1675,17193,18868
2016-07-21 23:00:00-04:00,0,7,23,3,0,1570,17546,19116
2016-07-22 00:00:00-04:00,0,7,0,4,0,1637,17722,19359
2016-07-22 01:00:00-04:00,0,7,1,4,0,1816,18056,19872
2016-07-22 02:00:00-04:00,0,7,2,4,0,1981,16535,18516
2016-07-22 03:00:00-04:00,0,7,3,4,0,2263,14272,16535
2016-07-22 04:00:00-04:00,0,7,4,4,0,2489,16042,18531
2016-07-22 05:00:00-04:00,0,7,5,4,0,2817,20505,23322
2016-07-22 06:00:00-04:00,0,7,6,4,0,2873,22995,25868
2016-07-22 07:00:00-04:00,0,7,7,4,0,2537,22231,24768
2016-07-22 08:00:00-04:00,0,7,8,4,0,2544,22664,25208
2016-07-22 09:00:00-04:00,0,7,9,4,0,2446,22484,24930
2016-07-22 10:00:00-04:00,0,7,10,4,0,2372,20480,22852
2016-07-22 11:00:00-04:00,0,7,11,4,0,1945,16637,18582
2016-07-22 12:00:00-04:00,0,7,12,4,0,1364,11306,12670
2016-07-22 13:00:00-04:00,0,7,13,4,0,892,7565,8457
2016-07-22 14:00:00-04:00,0,7,14,4,0,625,4819,5444
2016-07-22 15:00:00-04:00,0,7,15,4,0,538,3941,4479
2016-07-22 16:00:00-04:00,0,7,16,4,0,507,4837,5344
2016-07-22 17:00:00-04:00,0,7,17,4,0,712,9682,10394
2016-07-22 18:00:00-04:00,0,7,18,4,0,1232,14461,15693
2016-07-22 19:00:00-04:00,0,7,19,4,0,2106,18340,20446
2016-07-22 20:00:00-04:00,0,7,20,4,0,2062,17873,19935
2016-07-22 21:00:00-04:00,0,7,21,4,0,1801,15895,17696
2016-07-22 22:00:00-04:00,0,7,22,4,0,1713,16325,18038
2016-07-22 23:00:00-04:00,0,7,23,4,0,1679,17607,19286
2016-07-23 00:00:00-04:00,0,7,0,5,0,1666,17410,19076
2016-07-23 01:00:00-04:00,0,7,1,5,0,2020,18075,20095
2016-07-23 02:00:00-04:00,0,7,2,5,0,2343,17079,19422
2016-07-23 03:00:00-04:00,0,7,3,5,0,2699,15151,17850
2016-07-23 04:00:00-04:00,0,7,4,5,0,3019,18310,21329
2016-07-23 05:00:00-04:00,0,7,5,5,0,3367,22419,25786
2016-07-23 06:00:00-04:00,0,7,6,5,0,3378,22557,25935
2016-07-23 07:00:00-04:00,0,7,7,5,0,2975,20293,23268
2016-07-23 08:00:00-04:00,0,7,8,5,0,3326,21430,24756
2016-07-23 09:00:00-04:00,0,7,9,5,0,3344,21935,25279
2016-07-23 10:00:00-04:00,0,7,10,5,0,3503,21907,25410
2016-07-23 11:00:00-04:00,0,7,11,5,0,3360,19682,23042
2016-07-23 12:00:00-04:00,0,7,12,5,0,2761,17051,19812
2016-07-23 13:00:00-04:00,0,7,13,5,0,2247,14640,16887
2016-07-23 14:00:00-04:00,0,7,14,5,0,1823,10521,12344
2016-07-23 15:00:00-04:00,0,7,15,5,0,1384,6781,8165
2016-07-23 16:00:00-04:00,0,7,16,5,0,788,3622,4410
2016-07-23 17:00:00-04:00,0,7,17,5,0,657,4987,5644
2016-07-23 18:00:00-04:00,0,7,18,5,0,778,6950,7728
2016-07-23 19:00:00-04:00,0,7,19,5,0,1161,9005,10166
2016-07-23 20:00:00-04:00,0,7,20,5,0,1458,12936,14394
2016-07-23 21:00:00-04:00,0,7,21,5,0,1777,14833,16610
2016-07-23 22:00:00-04:00,0,7,22,5,0,1963,16911,18874
2016-07-23 23:00:00-04:00,0,7,23,5,0,2128,17752,19880
2016-07-24 00:00:00-04:00,0,7,0,6,0,2114,17986,20100
2016-07-24 01:00:00-04:00,0,7,1,6,0,2389,17595,19984
2016-07-24 02:00:00-04:00,0,7,2,6,0,2619,18391,21010
2016-07-24 03:00:00-04:00,0,7,3,6,0,2789,17085,19874
2016-07-24 04:00:00-04:00,0,7,4,6,0,2638,18153,20791
2016-07-24 05:00:00-04:00,0,7,5,6,0,2847,19308,22155
2016-07-24 06:00:00-04:00,0,7,6,6,0,3128,19225,22353
2016-07-24 07:00:00-04:00,0,7,7,6,0,2966,16767,19733
2016-07-24 08:00:00-04:00,0,7,8,6,0,3305,17043,20348
2016-07-24 09:00:00-04:00,0,7,9,6,0,3553,18774,22327
2016-07-24 10:00:00-04:00,0,7,10,6,0,3803,19726,23529
2016-07-24 11:00:00-04:00,0,7,11,6,0,3527,18591,22118
2016-07-24 12:00:00-04:00,0,7,12,6,0,3101,16918,20019
2016-07-24 13:00:00-04:00,0,7,13,6,0,2671,14678,17349
2016-07-24 14:00:00-04:00,0,7,14,6,0,2125,11252,13377
2016-07-24 15:00:00-04:00,0,7,15,6,0,1642,7646,9288
2016-07-24 16:00:00-04:00,0,7,16,6,0,870,3571,4441
2016-07-24 17:00:00-04:00,0,7,17,6,0,617,3737,4354
2016-07-24 18:00:00-04:00,0,7,18,6,0,665,4797,5462
2016-07-24 19:00:00-04:00,0,7,19,6,0,791,6506,7297
2016-07-24 20:00:00-04:00,0,7,20,6,0,1184,9718,10902
2016-07-24 21:00:00-04:00,0,7,21,6,0,1515,13511,15026
2016-07-24 22:00:00-04:00,0,7,22,6,0,1778,16181,17959
2016-07-24 23:00:00-04:00,0,7,23,6,0,1915,17615,19530
2016-07-25 00:00:00-04:00,0,7,0,0,0,1946,18232,20178
2016-07-25 01:00:00-04:00,0,7,1,0,0,2143,17731,19874
2016-07-25 02:00:00-04:00,0,7,2,0,0,2218,16721,18939
2016-07-25 03:00:00-04:00,0,7,3,0,0,2304,16654,18958
2016-07-25 04:00:00-04:00,0.02,7,4,0,0,2244,17415,19659
2016-07-25 05:00:00-04:00,0,7,5,0,0,2378,18067,20445
2016-07-25 06:00:00-04:00,0,7,6,0,0,2268,16449,18717
2016-07-25 07:00:00-04:00,0,7,7,0,0,2020,15100,17120
2016-07-25 08:00:00-04:00,0,7,8,0,0,2183,15764,17947
2016-07-25 09:00:00-04:00,0,7,9,0,0,2065,13955,16020
2016-07-25 10:00:00-04:00,0,7,10,0,0,2035,11659,13694
2016-07-25 11:00:00-04:00,0,7,11,0,0,1361,7998,9359
2016-07-25 12:00:00-04:00,0,7,12,0,0,846,4880,5726
2016-07-25 13:00:00-04:00,0,7,13,0,0,580,2816,3396
2016-07-25 14:00:00-04:00,0,7,14,0,0,434,1868,2302
2016-07-25 15:00:00-04:00,0,7,15,0,0,439,2441,2880
2016-07-25 16:00:00-04:00,0.37,7,16,0,0,442,3929,4371
2016-07-25 17:00:00-04:00,0.18,7,17,0,0,692,9862,10554
2016-07-25 18:00:00-04:00,0.21,7,18,0,0,1339,14932,16271
2016-07-25 19:00:00-04:00,0,7,19,0,0,2086,17945,20031
2016-07-25 20:00:00-04:00,0.01,7,20,0,0,2049,17647,19696
2016-07-25 21:00:00-04:00,0,7,21,0,0,1679,15585,17264
2016-07-25 22:00:00-04:00,0,7,22,0,0,1542,15066,16608
2016-07-25 23:00:00-04:00,0,7,23,0,0,1552,16181,17733
2016-07-26 00:00:00-04:00,0,7,0,1,0,1534,16714,18248
2016-07-26 01:00:00-04:00,0,7,1,1,0,1755,17889,19644
2016-07-26 02:00:00-04:00,0,7,2,1,0,1953,17103,19056
2016-07-26 03:00:00-04:00,0,7,3,1,0,2355,16235,18590
2016-07-26 04:00:00-04:00,0,7,4,1,0,3323,20013,23336
2016-07-26 05:00:00-04:00,0,7,5,1,0,3384,21007,24391
2016-07-26 06:00:00-04:00,0,7,6,1,0,2590,19418,22008
2016-07-26 07:00:00-04:00,0,7,7,1,0,1844,17865,19709
2016-07-26 08:00:00-04:00,0,7,8,1,0,1559,17569,19128
2016-07-26 09:00:00-04:00,0,7,9,1,0,1370,14749,16119
2016-07-26 10:00:00-04:00,0,7,10,1,0,1279,11264,12543
2016-07-26 11:00:00-04:00,0,7,11,1,0,922,8151,9073
2016-07-26 12:00:00-04:00,0,7,12,1,0,630,5543,6173
2016-07-26 13:00:00-04:00,0,7,13,1,0,444,3537,3981
2016-07-26 14:00:00-04:00,0,7,14,1,0,296,2099,2395
2016-07-26 15:00:00-04:00,0,7,15,1,0,304,2146,2450
2016-07-26 16:00:00-04:00,0,7,16,1,0,394,3946,4340
2016-07-26 17:00:00-04:00,0,7,17,1,0,703,10257,10960
2016-07-26 18:00:00-04:00,0,7,18,1,0,1169,15867,17036
2016-07-26 19:00:00-04:00,0,7,19,1,0,2086,19090,21176
2016-07-26 20:00:00-04:00,0,7,20,1,0,2023,17988,20011
2016-07-26 21:00:00-04:00,0,7,21,1,0,1669,16308,17977
2016-07-26 22:00:00-04:00,0,7,22,1,0,1600,16437,18037
2016-07-26 23:00:00-04:00,0,7,23,1,0,1650,17858,19508
2016-07-27 00:00:00-04:00,0,7,0,2,0,1484,17685,19169
2016-07-27 01:00:00-04:00,0,7,1,2,0,1677,17943,19620
2016-07-27 02:00:00-04:00,0,7,2,2,0,1837,17041,18878
2016-07-27 03:00:00-04:00,0,7,3,2,0,2085,15161,17246
2016-07-27 04:00:00-04:00,0,7,4,2,0,2237,17803,20040
2016-07-27 05:00:00-04:00,0,7,5,2,0,2703,21700,24403
2016-07-27 06:00:00-04:00,0,7,6,2,0,2620,22189,24809
2016-07-27 07:00:00-04:00,0,7,7,2,0,2182,21972,24154
2016-07-27 08:00:00-04:00,0,7,8,2,0,2044,22245,24289
2016-07-27 09:00:00-04:00,0,7,9,2,0,1995,20318,22313
2016-07-27 10:00:00-04:00,0,7,10,2,0,1822,17166,18988
2016-07-27 11:00:00-04:00,0,7,11,2,0,1404,10978,12382
2016-07-27 12:00:00-04:00,0,7,12,2,0,881,6423,7304
2016-07-27 13:00:00-04:00,0,7,13,2,0,525,4032,4557
2016-07-27 14:00:00-04:00,0,7,14,2,0,365,2562,2927
2016-07-27 15:00:00-04:00,0,7,15,2,0,346,2478,2824
2016-07-27 16:00:00-04:00,0,7,16,2,0,411,3890,4301
2016-07-27 17:00:00-04:00,0,7,17,2,0,717,10477,11194
2016-07-27 18:00:00-04:00,0,7,18,2,0,1158,15954,17112
2016-07-27 19:00:00-04:00,0,7,19,2,0,2096,19358,21454
2016-07-27 20:00:00-04:00,0,7,20,2,0,2006,18302,20308
2016-07-27 21:00:00-04:00,0,7,21,2,0,1680,16779,18459
2016-07-27 22:00:00-04:00,0,7,22,2,0,1636,16842,18478
2016-07-27 23:00:00-04:00,0,7,23,2,0,1672,17717,19389
2016-07-28 00:00:00-04:00,0,7,0,3,0,1534,17828,19362
2016-07-28 01:00:00-04:00,0,7,1,3,0,1717,18014,19731
2016-07-28 02:00:00-04:00,0,7,2,3,0,1967,17082,19049
2016-07-28 03:00:00-04:00,0,7,3,3,0,2052,14818,16870
2016-07-28 04:00:00-04:00,0,7,4,3,0,2371,17426,19797
2016-07-28 05:00:00-04:00,0,7,5,3,0,2668,22063,24731
2016-07-28 06:00:00-04:00,0,7,6,3,0,2719,23230,25949
2016-07-28 07:00:00-04:00,0,7,7,3,0,2241,22865,25106
2016-07-28 08:00:00-04:00,0,7,8,3,0,2263,23088,25351
2016-07-28 09:00:00-04:00,0,7,9,3,0,2227,21039,23266
2016-07-28 10:00:00-04:00,0,7,10,3,0,1980,18932,20912
2016-07-28 11:00:00-04:00,0,7,11,3,0,1610,12577,14187
2016-07-28 12:00:00-04:00,0,7,12,3,0,1069,7606,8675
2016-07-28 13:00:00-04:00,0,7,13,3,0,652,4611,5263
2016-07-28 14:00:00-04:00,0,7,14,3,0,448,3032,3480
2016-07-28 15:00:00-04:00,0,7,15,3,0,448,2764,3212
2016-07-28 16:00:00-04:00,0,7,16,3,0,430,4303,4733
2016-07-28 17:00:00-04:00,0,7,17,3,0,733,10622,11355
2016-07-28 18:00:00-04:00,0,7,18,3,0,1261,15879,17140
2016-07-28 19:00:00-04:00,0,7,19,3,0,2172,19887,22059
2016-07-28 20:00:00-04:00,0,7,20,3,0,2127,18560,20687
2016-07-28 21:00:00-04:00,0,7,21,3,0,1725,16798,18523
2016-07-28 22:00:00-04:00,0,7,22,3,0,1756,17198,18954
2016-07-28 23:00:00-04:00,0,7,23,3,0,1719,18035,19754
2016-07-29 00:00:00-04:00,0,7,0,4,0,1815,18309,20124
2016-07-29 01:00:00-04:00,0.01,7,1,4,0,1891,18613,20504
2016-07-29 02:00:00-04:00,0.01,7,2,4,0,2069,17050,19119
2016-07-29 03:00:00-04:00,0.01,7,3,4,0,2373,14415,16788
2016-07-29 04:00:00-04:00,0.12,7,4,4,0,2752,17998,20750
2016-07-29 05:00:00-04:00,0.7,7,5,4,0,3317,22638,25955
2016-07-29 06:00:00-04:00,0.01,7,6,4,0,2854,22487,25341
2016-07-29 07:00:00-04:00,0.04,7,7,4,0,2465,22565,25030
2016-07-29 08:00:00-04:00,0.1,7,8,4,0,2548,22734,25282
2016-07-29 09:00:00-04:00,0.02,7,9,4,0,2333,20787,23120
2016-07-29 10:00:00-04:00,0.01,7,10,4,0,2412,20351,22763
2016-07-29 11:00:00-04:00,0,7,11,4,0,1859,16408,18267
2016-07-29 12:00:00-04:00,0,7,12,4,0,1362,11434,12796
2016-07-29 13:00:00-04:00,0,7,13,4,0,851,7354,8205
2016-07-29 14:00:00-04:00,0,7,14,4,0,616,4659,5275
2016-07-29 15:00:00-04:00,0,7,15,4,0,493,3889,4382
2016-07-29 16:00:00-04:00,0,7,16,4,0,512,4724,5236
2016-07-29 17:00:00-04:00,0,7,17,4,0,760,10133,10893
2016-07-29 18:00:00-04:00,0,7,18,4,0,1468,16274,17742
2016-07-29 19:00:00-04:00,0,7,19,4,0,2282,19879,22161
2016-07-29 20:00:00-04:00,0,7,20,4,0,2315,18220,20535
2016-07-29 21:00:00-04:00,0,7,21,4,0,1788,15295,17083
2016-07-29 22:00:00-04:00,0,7,22,4,0,1614,14937,16551
2016-07-29 23:00:00-04:00,0,7,23,4,0,1599,15700,17299
2016-07-30 00:00:00-04:00,0,7,0,5,0,1504,15744,17248
2016-07-30 01:00:00-04:00,0,7,1,5,0,1859,16475,18334
2016-07-30 02:00:00-04:00,0,7,2,5,0,2204,15797,18001
2016-07-30 03:00:00-04:00,0,7,3,5,0,2509,13836,16345
2016-07-30 04:00:00-04:00,0,7,4,5,0,2864,16882,19746
2016-07-30 05:00:00-04:00,0,7,5,5,0,3271,20024,23295
2016-07-30 06:00:00-04:00,0,7,6,5,0,3347,21725,25072
2016-07-30 07:00:00-04:00,0,7,7,5,0,2958,21008,23966
2016-07-30 08:00:00-04:00,0,7,8,5,0,3089,19453,22542
2016-07-30 09:00:00-04:00,0,7,9,5,0,3230,20500,23730
2016-07-30 10:00:00-04:00,0,7,10,5,0,3288,20408,23696
2016-07-30 11:00:00-04:00,0,7,11,5,0,3304,19247,22551
2016-07-30 12:00:00-04:00,0,7,12,5,0,2863,17350,20213
2016-07-30 13:00:00-04:00,0,7,13,5,0,2511,15110,17621
2016-07-30 14:00:00-04:00,0,7,14,5,0,2048,11462,13510
2016-07-30 15:00:00-04:00,0.02,7,15,5,0,1496,7319,8815
2016-07-30 16:00:00-04:00,0.05,7,16,5,0,792,3714,4506
2016-07-30 17:00:00-04:00,0.04,7,17,5,0,700,4679,5379
2016-07-30 18:00:00-04:00,0.02,7,18,5,0,847,6188,7035
2016-07-30 19:00:00-04:00,0.01,7,19,5,0,1086,8450,9536
2016-07-30 20:00:00-04:00,0.03,7,20,5,0,1424,11300,12724
2016-07-30 21:00:00-04:00,0.01,7,21,5,0,1623,13479,15102
2016-07-30 22:00:00-04:00,0.01,7,22,5,0,1858,15066,16924
2016-07-30 23:00:00-04:00,0,7,23,5,0,2052,16643,18695
2016-07-31 00:00:00-04:00,0,7,0,6,0,2093,16822,18915
2016-07-31 01:00:00-04:00,0,7,1,6,0,2419,16420,18839
2016-07-31 02:00:00-04:00,0,7,2,6,0,3217,20175,23392
2016-07-31 03:00:00-04:00,0,7,3,6,0,3182,16033,19215
2016-07-31 04:00:00-04:00,0,7,4,6,0,3364,17882,21246
2016-07-31 05:00:00-04:00,0,7,5,6,0,3495,18216,21711
2016-07-31 06:00:00-04:00,0,7,6,6,0,3277,18477,21754
2016-07-31 07:00:00-04:00,0,7,7,6,0,3122,17246,20368
2016-07-31 08:00:00-04:00,0,7,8,6,0,3353,17250,20603
2016-07-31 09:00:00-04:00,0,7,9,6,0,3197,17269,20466
2016-07-31 10:00:00-04:00,0.0001,7,10,6,0,3430,17777,21207
2016-07-31 11:00:00-04:00,0.01,7,11,6,0,3347,18116,21463
2016-07-31 12:00:00-04:00,0.04,7,12,6,0,2846,15769,18615
2016-07-31 13:00:00-04:00,0,7,13,6,0,2526,14044,16570
2016-07-31 14:00:00-04:00,0,7,14,6,0,2148,10916,13064
2016-07-31 15:00:00-04:00,0,7,15,6,0,1584,7345,8929
2016-07-31 16:00:00-04:00,0,7,16,6,0,851,3382,4233
2016-07-31 17:00:00-04:00,0,7,17,6,0,665,3532,4197
2016-07-31 18:00:00-04:00,0,7,18,6,0,656,4544,5200
2016-07-31 19:00:00-04:00,0,7,19,6,0,784,6888,7672
2016-07-31 20:00:00-04:00,0,7,20,6,0,1114,9327,10441
2016-07-31 21:00:00-04:00,0.22,7,21,6,0,1528,12992,14520
2016-07-31 22:00:00-04:00,0.42,7,22,6,0,1742,15304,17046
2016-07-31 23:00:00-04:00,0.01,7,23,6,0,2155,18977,21132
2016-08-01 00:00:00-04:00,0.01,8,0,0,0,1782,15081,16863
2016-08-01 01:00:00-04:00,0,8,1,0,0,1954,15252,17206
2016-08-01 02:00:00-04:00,0,8,2,0,0,2080,15423,17503
2016-08-01 03:00:00-04:00,0,8,3,0,0,2216,15308,17524
2016-08-01 04:00:00-04:00,0,8,4,0,0,2206,16018,18224
2016-08-01 05:00:00-04:00,0,8,5,0,0,2383,16468,18851
2016-08-01 06:00:00-04:00,0,8,6,0,0,2133,15501,17634
2016-08-01 07:00:00-04:00,0,8,7,0,0,1989,14305,16294
2016-08-01 08:00:00-04:00,0,8,8,0,0,2165,16477,18642
2016-08-01 09:00:00-04:00,0,8,9,0,0,2095,13832,15927
2016-08-01 10:00:00-04:00,0,8,10,0,0,1783,10722,12505
2016-08-01 11:00:00-04:00,0,8,11,0,0,1267,7568,8835
2016-08-01 12:00:00-04:00,0,8,12,0,0,827,5319,6146
2016-08-01 13:00:00-04:00,0,8,13,0,0,496,3414,3910
2016-08-01 14:00:00-04:00,0,8,14,0,0,361,2160,2521
2016-08-01 15:00:00-04:00,0,8,15,0,0,415,2466,2881
2016-08-01 16:00:00-04:00,0,8,16,0,0,375,3666,4041
2016-08-01 17:00:00-04:00,0,8,17,0,0,687,9098,9785
2016-08-01 18:00:00-04:00,0,8,18,0,0,1254,13920,15174
2016-08-01 19:00:00-04:00,0,8,19,0,0,2138,17681,19819
2016-08-01 20:00:00-04:00,0,8,20,0,0,2038,16510,18548
2016-08-01 21:00:00-04:00,0,8,21,0,0,1652,14509,16161
2016-08-01 22:00:00-04:00,0,8,22,0,0,1560,14316,15876
2016-08-01 23:00:00-04:00,0,8,23,0,0,1534,15155,16689
2016-08-02 00:00:00-04:00,0,8,0,1,0,1408,15355,16763
2016-08-02 01:00:00-04:00,0,8,1,1,0,1665,15498,17163
2016-08-02 02:00:00-04:00,0,8,2,1,0,1815,15132,16947
2016-08-02 03:00:00-04:00,0,8,3,1,0,2114,14620,16734
2016-08-02 04:00:00-04:00,0,8,4,1,0,2322,17522,19844
2016-08-02 05:00:00-04:00,0,8,5,1,0,2502,20814,23316
2016-08-02 06:00:00-04:00,0,8,6,1,0,2380,19761,22141
2016-08-02 07:00:00-04:00,0,8,7,1,0,1869,18525,20394
2016-08-02 08:00:00-04:00,0,8,8,1,0,1851,17854,19705
2016-08-02 09:00:00-04:00,0,8,9,1,0,1684,15856,17540
2016-08-02 10:00:00-04:00,0,8,10,1,0,1636,12044,13680
2016-08-02 11:00:00-04:00,0,8,11,1,0,1212,8203,9415
2016-08-02 12:00:00-04:00,0,8,12,1,0,765,5358,6123
2016-08-02 13:00:00-04:00,0,8,13,1,0,502,3235,3737
2016-08-02 14:00:00-04:00,0,8,14,1,0,350,2169,2519
2016-08-02 15:00:00-04:00,0,8,15,1,0,332,2326,2658
2016-08-02 16:00:00-04:00,0,8,16,1,0,368,3855,4223
2016-08-02 17:00:00-04:00,0,8,17,1,0,650,9621,10271
2016-08-02 18:00:00-04:00,0,8,18,1,0,1250,14654,15904
2016-08-02 19:00:00-04:00,0,8,19,1,0,2067,18113,20180
2016-08-02 20:00:00-04:00,0,8,20,1,0,1968,17251,19219
2016-08-02 21:00:00-04:00,0,8,21,1,0,1629,15627,17256
2016-08-02 22:00:00-04:00,0,8,22,1,0,1569,15188,16757
2016-08-02 23:00:00-04:00,0,8,23,1,0,1613,17105,18718
2016-08-03 00:00:00-04:00,0,8,0,2,0,1531,16438,17969
2016-08-03 01:00:00-04:00,0,8,1,2,0,1718,16774,18492
2016-08-03 02:00:00-04:00,0,8,2,2,0,1832,15695,17527
2016-08-03 03:00:00-04:00,0,8,3,2,0,2073,13967,16040
2016-08-03 04:00:00-04:00,0,8,4,2,0,2239,16358,18597
2016-08-03 05:00:00-04:00,0,8,5,2,0,2608,20352,22960
2016-08-03 06:00:00-04:00,0,8,6,2,0,2497,21112,23609
2016-08-03 07:00:00-04:00,0,8,7,2,0,2108,21078,23186
2016-08-03 08:00:00-04:00,0,8,8,2,0,2111,21507,23618
2016-08-03 09:00:00-04:00,0,8,9,2,0,2115,19938,22053
2016-08-03 10:00:00-04:00,0,8,10,2,0,1896,14766,16662
2016-08-03 11:00:00-04:00,0,8,11,2,0,1417,9827,11244
2016-08-03 12:00:00-04:00,0,8,12,2,0,878,5904,6782
2016-08-03 13:00:00-04:00,0,8,13,2,0,544,3863,4407
2016-08-03 14:00:00-04:00,0,8,14,2,0,345,2585,2930
2016-08-03 15:00:00-04:00,0,8,15,2,0,370,2562,2932
2016-08-03 16:00:00-04:00,0,8,16,2,0,383,3907,4290
2016-08-03 17:00:00-04:00,0,8,17,2,0,684,9862,10546
2016-08-03 18:00:00-04:00,0,8,18,2,0,1219,14889,16108
2016-08-03 19:00:00-04:00,0,8,19,2,0,1969,18824,20793
2016-08-03 20:00:00-04:00,0,8,20,2,0,1980,17361,19341
2016-08-03 21:00:00-04:00,0,8,21,2,0,1842,15696,17538
2016-08-03 22:00:00-04:00,0,8,22,2,0,1658,15715,17373
2016-08-03 23:00:00-04:00,0,8,23,2,0,1627,16562,18189
2016-08-04 00:00:00-04:00,0,8,0,3,0,1581,16488,18069
2016-08-04 01:00:00-04:00,0,8,1,3,0,1686,16759,18445
2016-08-04 02:00:00-04:00,0,8,2,3,0,1942,15632,17574
2016-08-04 03:00:00-04:00,0,8,3,3,0,2026,13558,15584
2016-08-04 04:00:00-04:00,0,8,4,3,0,2332,16166,18498
2016-08-04 05:00:00-04:00,0,8,5,3,0,2663,20176,22839
2016-08-04 06:00:00-04:00,0,8,6,3,0,2518,21344,23862
2016-08-04 07:00:00-04:00,0,8,7,3,0,2346,21577,23923
2016-08-04 08:00:00-04:00,0,8,8,3,0,2282,22199,24481
2016-08-04 09:00:00-04:00,0,8,9,3,0,2376,20886,23262
2016-08-04 10:00:00-04:00,0,8,10,3,0,2194,17409,19603
2016-08-04 11:00:00-04:00,0,8,11,3,0,1717,11490,13207
2016-08-04 12:00:00-04:00,0,8,12,3,0,1139,6720,7859
2016-08-04 13:00:00-04:00,0,8,13,3,0,724,4142,4866
2016-08-04 14:00:00-04:00,0,8,14,3,0,548,2755,3303
2016-08-04 15:00:00-04:00,0,8,15,3,0,411,2584,2995
2016-08-04 16:00:00-04:00,0,8,16,3,0,395,3948,4343
2016-08-04 17:00:00-04:00,0,8,17,3,0,681,10045,10726
2016-08-04 18:00:00-04:00,0,8,18,3,0,1275,15358,16633
2016-08-04 19:00:00-04:00,0,8,19,3,0,2117,18959,21076
2016-08-04 20:00:00-04:00,0,8,20,3,0,2008,17596,19604
2016-08-04 21:00:00-04:00,0,8,21,3,0,1748,15909,17657
2016-08-04 22:00:00-04:00,0,8,22,3,0,1609,16194,17803
2016-08-04 23:00:00-04:00,0,8,23,3,0,1555,16551,18106
2016-08-05 00:00:00-04:00,0,8,0,4,0,1551,16813,18364
2016-08-05 01:00:00-04:00,0,8,1,4,0,1812,17216,19028
2016-08-05 02:00:00-04:00,0,8,2,4,0,1918,16158,18076
2016-08-05 03:00:00-04:00,0,8,3,4,0,2347,14092,16439
2016-08-05 04:00:00-04:00,0,8,4,4,0,2532,17027,19559
2016-08-05 05:00:00-04:00,0,8,5,4,0,2761,21593,24354
2016-08-05 06:00:00-04:00,0,8,6,4,0,2657,22156,24813
2016-08-05 07:00:00-04:00,0,8,7,4,0,2479,22144,24623
2016-08-05 08:00:00-04:00,0,8,8,4,0,2543,22425,24968
2016-08-05 09:00:00-04:00,0,8,9,4,0,2752,21748,24500
2016-08-05 10:00:00-04:00,0,8,10,4,0,2508,19788,22296
2016-08-05 11:00:00-04:00,0,8,11,4,0,2037,15754,17791
2016-08-05 12:00:00-04:00,0,8,12,4,0,1427,10109,11536
2016-08-05 13:00:00-04:00,0,8,13,4,0,896,6676,7572
2016-08-05 14:00:00-04:00,0,8,14,4,0,601,4488,5089
2016-08-05 15:00:00-04:00,0,8,15,4,0,551,3670,4221
2016-08-05 16:00:00-04:00,0,8,16,4,0,493,4220,4713
2016-08-05 17:00:00-04:00,0,8,17,4,0,742,9104,9846
2016-08-05 18:00:00-04:00,0,8,18,4,0,1229,13173,14402
2016-08-05 19:00:00-04:00,0,8,19,4,0,2032,16605,18637
2016-08-05 20:00:00-04:00,0,8,20,4,0,1966,16158,18124
2016-08-05 21:00:00-04:00,0,8,21,4,0,1648,14756,16404
2016-08-05 22:00:00-04:00,0,8,22,4,0,1683,15186,16869
2016-08-05 23:00:00-04:00,0,8,23,4,0,1574,15829,17403
2016-08-06 00:00:00-04:00,0,8,0,5,0,1543,15921,17464
2016-08-06 01:00:00-04:00,0,8,1,5,0,1851,17034,18885
2016-08-06 02:00:00-04:00,0,8,2,5,0,2208,16114,18322
2016-08-06 03:00:00-04:00,0,8,3,5,0,2489,14333,16822
2016-08-06 04:00:00-04:00,0,8,4,5,0,2820,17071,19891
2016-08-06 05:00:00-04:00,0,8,5,5,0,3240,20393,23633
2016-08-06 06:00:00-04:00,0,8,6,5,0,3206,21018,24224
2016-08-06 07:00:00-04:00,0,8,7,5,0,2871,18527,21398
2016-08-06 08:00:00-04:00,0,8,8,5,0,2921,18323,21244
2016-08-06 09:00:00-04:00,0,8,9,5,0,3105,19160,22265
2016-08-06 10:00:00-04:00,0,8,10,5,0,3263,19854,23117
2016-08-06 11:00:00-04:00,0,8,11,5,0,3255,19284,22539
2016-08-06 12:00:00-04:00,0,8,12,5,0,2840,16353,19193
2016-08-06 13:00:00-04:00,0,8,13,5,0,2353,14137,16490
2016-08-06 14:00:00-04:00,0,8,14,5,0,1997,10878,12875
2016-08-06 15:00:00-04:00,0,8,15,5,0,1443,7051,8494
2016-08-06 16:00:00-04:00,0,8,16,5,0,768,3535,4303
2016-08-06 17:00:00-04:00,0,8,17,5,0,661,4669,5330
2016-08-06 18:00:00-04:00,0,8,18,5,0,791,5659,6450
2016-08-06 19:00:00-04:00,0,8,19,5,0,1002,7625,8627
2016-08-06 20:00:00-04:00,0,8,20,5,0,1330,10506,11836
2016-08-06 21:00:00-04:00,0,8,21,5,0,1573,12317,13890
2016-08-06 22:00:00-04:00,0,8,22,5,0,1820,13954,15774
2016-08-06 23:00:00-04:00,0,8,23,5,0,1971,14853,16824
2016-08-07 00:00:00-04:00,0,8,0,6,0,1999,15780,17779
2016-08-07 01:00:00-04:00,0,8,1,6,0,2271,15661,17932
2016-08-07 02:00:00-04:00,0,8,2,6,0,2510,16599,19109
2016-08-07 03:00:00-04:00,0,8,3,6,0,3132,17521,20653
2016-08-07 04:00:00-04:00,0,8,4,6,0,2618,15722,18340
2016-08-07 05:00:00-04:00,0,8,5,6,0,2754,17076,19830
2016-08-07 06:00:00-04:00,0,8,6,6,0,2919,17698,20617
2016-08-07 07:00:00-04:00,0,8,7,6,0,2896,15922,18818
2016-08-07 08:00:00-04:00,0,8,8,6,0,3176,16223,19399
2016-08-07 09:00:00-04:00,0,8,9,6,0,3258,17215,20473
2016-08-07 10:00:00-04:00,0,8,10,6,0,3356,18164,21520
2016-08-07 11:00:00-04:00,0,8,11,6,0,3394,17595,20989
2016-08-07 12:00:00-04:00,0,8,12,6,0,3043,15422,18465
2016-08-07 13:00:00-04:00,0,8,13,6,0,2655,13204,15859
2016-08-07 14:00:00-04:00,0,8,14,6,0,2138,10475,12613
2016-08-07 15:00:00-04:00,0,8,15,6,0,1559,7142,8701
2016-08-07 16:00:00-04:00,0,8,16,6,0,768,3315,4083
2016-08-07 17:00:00-04:00,0,8,17,6,0,588,3423,4011
2016-08-07 18:00:00-04:00,0,8,18,6,0,618,4545,5163
2016-08-07 19:00:00-04:00,0,8,19,6,0,771,6016,6787
2016-08-07 20:00:00-04:00,0,8,20,6,0,1171,9186,10357
2016-08-07 21:00:00-04:00,0,8,21,6,0,1381,12121,13502
2016-08-07 22:00:00-04:00,0,8,22,6,0,1626,13646,15272
2016-08-07 23:00:00-04:00,0,8,23,6,0,1742,14698,16440
2016-08-08 00:00:00-04:00,0,8,0,0,0,1778,14872,16650
2016-08-08 01:00:00-04:00,0,8,1,0,0,2009,15360,17369
2016-08-08 02:00:00-04:00,0,8,2,0,0,2119,15128,17247
2016-08-08 03:00:00-04:00,0,8,3,0,0,2257,14918,17175
2016-08-08 04:00:00-04:00,0,8,4,0,0,2160,15450,17610
2016-08-08 05:00:00-04:00,0,8,5,0,0,2318,15951,18269
2016-08-08 06:00:00-04:00,0,8,6,0,0,2265,15008,17273
2016-08-08 07:00:00-04:00,0,8,7,0,0,2222,14359,16581
2016-08-08 08:00:00-04:00,0,8,8,0,0,2326,15446,17772
2016-08-08 09:00:00-04:00,0,8,9,0,0,2190,13685,15875
2016-08-08 10:00:00-04:00,0,8,10,0,0,1866,10932,12798
2016-08-08 11:00:00-04:00,0,8,11,0,0,1380,7687,9067
2016-08-08 12:00:00-04:00,0,8,12,0,0,909,4111,5020
2016-08-08 13:00:00-04:00,0,8,13,0,0,523,2445,2968
2016-08-08 14:00:00-04:00,0,8,14,0,0,394,1778,2172
2016-08-08 15:00:00-04:00,0,8,15,0,0,426,2224,2650
2016-08-08 16:00:00-04:00,0,8,16,0,0,352,3364,3716
2016-08-08 17:00:00-04:00,0,8,17,0,0,614,8669,9283
2016-08-08 18:00:00-04:00,0,8,18,0,0,1194,13014,14208
2016-08-08 19:00:00-04:00,0,8,19,0,0,1996,16412,18408
2016-08-08 20:00:00-04:00,0,8,20,0,0,1804,15191,16995
2016-08-08 21:00:00-04:00,0,8,21,0,0,1466,13222,14688
2016-08-08 22:00:00-04:00,0,8,22,0,0,1529,13526,15055
2016-08-08 23:00:00-04:00,0,8,23,0,0,1457,14469,15926
2016-08-09 00:00:00-04:00,0,8,0,1,0,1348,14602,15950
2016-08-09 01:00:00-04:00,0,8,1,1,0,1530,15185,16715
2016-08-09 02:00:00-04:00,0,8,2,1,0,1673,15074,16747
2016-08-09 03:00:00-04:00,0,8,3,1,0,1870,14189,16059
2016-08-09 04:00:00-04:00,0,8,4,1,0,2037,16383,18420
2016-08-09 05:00:00-04:00,0,8,5,1,0,2178,19335,21513
2016-08-09 06:00:00-04:00,0,8,6,1,0,2233,18688,20921
2016-08-09 07:00:00-04:00,0,8,7,1,0,1831,18392,20223
2016-08-09 08:00:00-04:00,0,8,8,1,0,1684,17419,19103
2016-08-09 09:00:00-04:00,0,8,9,1,0,1544,15257,16801
2016-08-09 10:00:00-04:00,0,8,10,1,0,1407,10904,12311
2016-08-09 11:00:00-04:00,0,8,11,1,0,1070,8365,9435
2016-08-09 12:00:00-04:00,0,8,12,1,0,767,4558,5325
2016-08-09 13:00:00-04:00,0,8,13,1,0,483,2939,3422
2016-08-09 14:00:00-04:00,0,8,14,1,0,303,2043,2346
2016-08-09 15:00:00-04:00,0,8,15,1,0,298,1987,2285
2016-08-09 16:00:00-04:00,0,8,16,1,0,334,3525,3859
2016-08-09 17:00:00-04:00,0,8,17,1,0,648,9108,9756
2016-08-09 18:00:00-04:00,0,8,18,1,0,1126,14123,15249
2016-08-09 19:00:00-04:00,0,8,19,1,0,1942,17391,19333
2016-08-09 20:00:00-04:00,0,8,20,1,0,1872,16903,18775
2016-08-09 21:00:00-04:00,0,8,21,1,0,1575,15236,16811
2016-08-09 22:00:00-04:00,0,8,22,1,0,1454,15377,16831
2016-08-09 23:00:00-04:00,0,8,23,1,0,1415,16485,17900
2016-08-10 00:00:00-04:00,0,8,0,2,0,1449,16275,17724
2016-08-10 01:00:00-04:00,0,8,1,2,0,1603,16956,18559
2016-08-10 02:00:00-04:00,0,8,2,2,0,1801,15990,17791
2016-08-10 03:00:00-04:00,0.01,8,3,2,0,1907,14853,16760
2016-08-10 04:00:00-04:00,0,8,4,2,0,2072,17699,19771
2016-08-10 05:00:00-04:00,0,8,5,2,0,2419,21289,23708
2016-08-10 06:00:00-04:00,0,8,6,2,0,2448,21269,23717
2016-08-10 07:00:00-04:00,0,8,7,2,0,2104,20956,23060
2016-08-10 08:00:00-04:00,0,8,8,2,0,2055,20771,22826
2016-08-10 09:00:00-04:00,0,8,9,2,0,2011,18761,20772
2016-08-10 10:00:00-04:00,0,8,10,2,0,1784,14328,16112
2016-08-10 11:00:00-04:00,0,8,11,2,0,1300,8857,10157
2016-08-10 12:00:00-04:00,0,8,12,2,0,823,5459,6282
2016-08-10 13:00:00-04:00,0.05,8,13,2,0,538,3566,4104
2016-08-10 14:00:00-04:00,0,8,14,2,0,356,2370,2726
2016-08-10 15:00:00-04:00,0,8,15,2,0,277,2203,2480
2016-08-10 16:00:00-04:00,0,8,16,2,0,332,3515,3847
2016-08-10 17:00:00-04:00,0,8,17,2,0,616,9457,10073
2016-08-10 18:00:00-04:00,0,8,18,2,0,1119,15176,16295
2016-08-10 19:00:00-04:00,0,8,19,2,0,2026,18698,20724
2016-08-10 20:00:00-04:00,0,8,20,2,0,1966,17793,19759
2016-08-10 21:00:00-04:00,0,8,21,2,0,1597,16157,17754
2016-08-10 22:00:00-04:00,0,8,22,2,0,1533,16006,17539
2016-08-10 23:00:00-04:00,0,8,23,2,0,1680,18908,20588
2016-08-11 00:00:00-04:00,0,8,0,3,0,1800,18129,19929
2016-08-11 01:00:00-04:00,0,8,1,3,0,1760,16621,18381
2016-08-11 02:00:00-04:00,0,8,2,3,0,1839,15803,17642
2016-08-11 03:00:00-04:00,0,8,3,3,0,2102,14557,16659
2016-08-11 04:00:00-04:00,0,8,4,3,0,2517,17208,19725
2016-08-11 05:00:00-04:00,0,8,5,3,0,2847,21705,24552
2016-08-11 06:00:00-04:00,0,8,6,3,0,2528,22588,25116
2016-08-11 07:00:00-04:00,0,8,7,3,0,2230,22261,24491
2016-08-11 08:00:00-04:00,0,8,8,3,0,2230,22043,24273
2016-08-11 09:00:00-04:00,0,8,9,3,0,2080,19843,21923
2016-08-11 10:00:00-04:00,0,8,10,3,0,1948,16312,18260
2016-08-11 11:00:00-04:00,0,8,11,3,0,1537,10556,12093
2016-08-11 12:00:00-04:00,0,8,12,3,0,989,6126,7115
2016-08-11 13:00:00-04:00,0,8,13,3,0,612,3969,4581
2016-08-11 14:00:00-04:00,0,8,14,3,0,457,2559,3016
2016-08-11 15:00:00-04:00,0,8,15,3,0,370,2366,2736
2016-08-11 16:00:00-04:00,0,8,16,3,0,372,3613,3985
2016-08-11 17:00:00-04:00,0,8,17,3,0,696,9737,10433
2016-08-11 18:00:00-04:00,0.33,8,18,3,0,1180,15841,17021
2016-08-11 19:00:00-04:00,0,8,19,3,0,2166,19885,22051
2016-08-11 20:00:00-04:00,0,8,20,3,0,2056,18860,20916
2016-08-11 21:00:00-04:00,0,8,21,3,0,1695,16997,18692
2016-08-11 22:00:00-04:00,0,8,22,3,0,1744,17250,18994
2016-08-11 23:00:00-04:00,0,8,23,3,0,1741,18526,20267
2016-08-12 00:00:00-04:00,0.02,8,0,4,0,1713,18852,20565
2016-08-12 01:00:00-04:00,0.16,8,1,4,0,1927,19435,21362
2016-08-12 02:00:00-04:00,0.05,8,2,4,0,2086,17935,20021
2016-08-12 03:00:00-04:00,0,8,3,4,0,2354,15292,17646
2016-08-12 04:00:00-04:00,0,8,4,4,0,2892,18149,21041
2016-08-12 05:00:00-04:00,0,8,5,4,0,3254,21930,25184
2016-08-12 06:00:00-04:00,0,8,6,4,0,2952,22533,25485
2016-08-12 07:00:00-04:00,0,8,7,4,0,2499,22489,24988
2016-08-12 08:00:00-04:00,0,8,8,4,0,2347,21552,23899
2016-08-12 09:00:00-04:00,0,8,9,4,0,2442,21135,23577
2016-08-12 10:00:00-04:00,0,8,10,4,0,2437,19273,21710
2016-08-12 11:00:00-04:00,0,8,11,4,0,2149,16348,18497
2016-08-12 12:00:00-04:00,0,8,12,4,0,1633,11085,12718
2016-08-12 13:00:00-04:00,0,8,13,4,0,851,6208,7059
2016-08-12 14:00:00-04:00,0,8,14,4,0,578,3989,4567
2016-08-12 15:00:00-04:00,0,8,15,4,0,457,3465,3922
2016-08-12 16:00:00-04:00,0,8,16,4,0,472,4286,4758
2016-08-12 17:00:00-04:00,0,8,17,4,0,695,9130,9825
2016-08-12 18:00:00-04:00,0,8,18,4,0,1247,13986,15233
2016-08-12 19:00:00-04:00,0.07,8,19,4,0,2090,17962,20052
2016-08-12 20:00:00-04:00,0,8,20,4,0,2075,17396,19471
2016-08-12 21:00:00-04:00,0,8,21,4,0,1825,16133,17958
2016-08-12 22:00:00-04:00,0,8,22,4,0,1808,16886,18694
2016-08-12 23:00:00-04:00,0,8,23,4,0,1777,17905,19682
2016-08-13 00:00:00-04:00,0,8,0,5,0,1695,17769,19464
2016-08-13 01:00:00-04:00,0,8,1,5,0,2010,18519,20529
2016-08-13 02:00:00-04:00,0,8,2,5,0,2473,17117,19590
2016-08-13 03:00:00-04:00,0,8,3,5,0,2680,15501,18181
2016-08-13 04:00:00-04:00,0,8,4,5,0,3038,18650,21688
2016-08-13 05:00:00-04:00,0,8,5,5,0,3491,21839,25330
2016-08-13 06:00:00-04:00,0,8,6,5,0,3559,22346,25905
2016-08-13 07:00:00-04:00,0,8,7,5,0,2946,18697,21643
2016-08-13 08:00:00-04:00,0,8,8,5,0,2864,17625,20489
2016-08-13 09:00:00-04:00,0,8,9,5,0,3226,18370,21596
2016-08-13 10:00:00-04:00,0,8,10,5,0,3300,18656,21956
2016-08-13 11:00:00-04:00,0,8,11,5,0,3198,17520,20718
2016-08-13 12:00:00-04:00,0,8,12,5,0,2753,15189,17942
2016-08-13 13:00:00-04:00,0,8,13,5,0,2283,12813,15096
2016-08-13 14:00:00-04:00,0,8,14,5,0,1802,9631,11433
2016-08-13 15:00:00-04:00,0,8,15,5,0,1374,6452,7826
2016-08-13 16:00:00-04:00,0,8,16,5,0,675,3266,3941
2016-08-13 17:00:00-04:00,0,8,17,5,0,679,4518,5197
2016-08-13 18:00:00-04:00,0,8,18,5,0,754,5725,6479
2016-08-13 19:00:00-04:00,0,8,19,5,0,1010,8247,9257
2016-08-13 20:00:00-04:00,0,8,20,5,0,1419,11110,12529
2016-08-13 21:00:00-04:00,0,8,21,5,0,1677,13489,15166
2016-08-13 22:00:00-04:00,0,8,22,5,0,1965,15391,17356
2016-08-13 23:00:00-04:00,0,8,23,5,0,2235,17011,19246
2016-08-14 00:00:00-04:00,0,8,0,6,0,2310,17918,20228
2016-08-14 01:00:00-04:00,0,8,1,6,0,2559,17970,20529
2016-08-14 02:00:00-04:00,0,8,2,6,0,2679,18183,20862
2016-08-14 03:00:00-04:00,0,8,3,6,0,2785,17304,20089
2016-08-14 04:00:00-04:00,0,8,4,6,0,2855,18196,21051
2016-08-14 05:00:00-04:00,0,8,5,6,0,3126,19067,22193
2016-08-14 06:00:00-04:00,0,8,6,6,0,3394,19779,23173
2016-08-14 07:00:00-04:00,0,8,7,6,0,3263,17207,20470
2016-08-14 08:00:00-04:00,0,8,8,6,0,3288,16586,19874
2016-08-14 09:00:00-04:00,0,8,9,6,0,3544,17636,21180
2016-08-14 10:00:00-04:00,0,8,10,6,0,3647,18117,21764
2016-08-14 11:00:00-04:00,0,8,11,6,0,3501,16268,19769
2016-08-14 12:00:00-04:00,0,8,12,6,0,2983,14603,17586
2016-08-14 13:00:00-04:00,0,8,13,6,0,2556,12374,14930
2016-08-14 14:00:00-04:00,0,8,14,6,0,2096,9688,11784
2016-08-14 15:00:00-04:00,0,8,15,6,0,1595,6496,8091
2016-08-14 16:00:00-04:00,0,8,16,6,0,794,3164,3958
2016-08-14 17:00:00-04:00,0,8,17,6,0,616,3352,3968
2016-08-14 18:00:00-04:00,0,8,18,6,0,615,4242,4857
2016-08-14 19:00:00-04:00,0.01,8,19,6,0,734,5873,6607
2016-08-14 20:00:00-04:00,0,8,20,6,0,1120,8842,9962
2016-08-14 21:00:00-04:00,0,8,21,6,0,1397,12263,13660
2016-08-14 22:00:00-04:00,0,8,22,6,0,1677,14082,15759
2016-08-14 23:00:00-04:00,0,8,23,6,0,1956,15582,17538
2016-08-15 00:00:00-04:00,0,8,0,0,0,1949,15997,17946
2016-08-15 01:00:00-04:00,0,8,1,0,0,2153,16217,18370
2016-08-15 02:00:00-04:00,0,8,2,0,0,2227,15888,18115
2016-08-15 03:00:00-04:00,0,8,3,0,0,2274,15359,17633
2016-08-15 04:00:00-04:00,0,8,4,0,0,2278,16169,18447
2016-08-15 05:00:00-04:00,0,8,5,0,0,2401,16611,19012
2016-08-15 06:00:00-04:00,0,8,6,0,0,2369,16153,18522
2016-08-15 07:00:00-04:00,0,8,7,0,0,2143,13808,15951
2016-08-15 08:00:00-04:00,0,8,8,0,0,2065,13218,15283
2016-08-15 09:00:00-04:00,0,8,9,0,0,1905,11752,13657
2016-08-15 10:00:00-04:00,0,8,10,0,0,1638,9667,11305
2016-08-15 11:00:00-04:00,0,8,11,0,0,1291,6595,7886
2016-08-15 12:00:00-04:00,0,8,12,0,0,867,4582,5449
2016-08-15 13:00:00-04:00,0,8,13,0,0,559,3124,3683
2016-08-15 14:00:00-04:00,0,8,14,0,0,427,2150,2577
2016-08-15 15:00:00-04:00,0,8,15,0,0,419,2380,2799
2016-08-15 16:00:00-04:00,0,8,16,0,0,400,3257,3657
2016-08-15 17:00:00-04:00,0,8,17,0,0,690,8733,9423
2016-08-15 18:00:00-04:00,0,8,18,0,0,1280,13523,14803
2016-08-15 19:00:00-04:00,0,8,19,0,0,2099,17017,19116
2016-08-15 20:00:00-04:00,0,8,20,0,0,1988,15951,17939
2016-08-15 21:00:00-04:00,0,8,21,0,0,1622,14636,16258
2016-08-15 22:00:00-04:00,0,8,22,0,0,1554,14633,16187
2016-08-15 23:00:00-04:00,0,8,23,0,0,1553,15699,17252
2016-08-16 00:00:00-04:00,0,8,0,1,0,1599,16325,17924
2016-08-16 01:00:00-04:00,0,8,1,1,0,1717,16497,18214
2016-08-16 02:00:00-04:00,0,8,2,1,0,1804,16184,17988
2016-08-16 03:00:00-04:00,0,8,3,1,0,1938,15110,17048
2016-08-16 04:00:00-04:00,0,8,4,1,0,2154,17828,19982
2016-08-16 05:00:00-04:00,0,8,5,1,0,2278,20261,22539
2016-08-16 06:00:00-04:00,0,8,6,1,0,2234,19438,21672
2016-08-16 07:00:00-04:00,0,8,7,1,0,1977,18975,20952
2016-08-16 08:00:00-04:00,0,8,8,1,0,1777,17244,19021
2016-08-16 09:00:00-04:00,0,8,9,1,0,1679,15011,16690
2016-08-16 10:00:00-04:00,0,8,10,1,0,1436,10947,12383
2016-08-16 11:00:00-04:00,0,8,11,1,0,1112,7603,8715
2016-08-16 12:00:00-04:00,0,8,12,1,0,384,2977,3361
2016-08-16 13:00:00-04:00,0,8,13,1,0,403,2681,3084
2016-08-16 14:00:00-04:00,0,8,14,1,0,321,1953,2274
2016-08-16 15:00:00-04:00,0,8,15,1,0,327,1945,2272
2016-08-16 16:00:00-04:00,0,8,16,1,0,365,3468,3833
2016-08-16 17:00:00-04:00,0,8,17,1,0,651,9158,9809
2016-08-16 18:00:00-04:00,0,8,18,1,0,1196,14322,15518
2016-08-16 19:00:00-04:00,0,8,19,1,0,2008,18181,20189
2016-08-16 20:00:00-04:00,0.13,8,20,1,0,2001,17657,19658
2016-08-16 21:00:00-04:00,0,8,21,1,0,1652,16349,18001
2016-08-16 22:00:00-04:00,0,8,22,1,0,1583,16040,17623
2016-08-16 23:00:00-04:00,0,8,23,1,0,1514,17119,18633
2016-08-17 00:00:00-04:00,0,8,0,2,0,1562,16987,18549
2016-08-17 01:00:00-04:00,0,8,1,2,0,1585,17501,19086
2016-08-17 02:00:00-04:00,0,8,2,2,0,1816,16494,18310
2016-08-17 03:00:00-04:00,0,8,3,2,0,1982,16178,18160
2016-08-17 04:00:00-04:00,0,8,4,2,0,2140,18007,20147
2016-08-17 05:00:00-04:00,0,8,5,2,0,2490,21937,24427
2016-08-17 06:00:00-04:00,0,8,6,2,0,2504,22409,24913
2016-08-17 07:00:00-04:00,0,8,7,2,0,2529,22972,25501
2016-08-17 08:00:00-04:00,0,8,8,2,0,1960,20063,22023
2016-08-17 09:00:00-04:00,0,8,9,2,0,1816,18097,19913
2016-08-17 10:00:00-04:00,0,8,10,2,0,1647,13517,15164
2016-08-17 11:00:00-04:00,0,8,11,2,0,1286,9260,10546
2016-08-17 12:00:00-04:00,0,8,12,2,0,835,6154,6989
2016-08-17 13:00:00-04:00,0,8,13,2,0,516,3458,3974
2016-08-17 14:00:00-04:00,0,8,14,2,0,329,2307,2636
2016-08-17 15:00:00-04:00,0,8,15,2,0,330,2150,2480
2016-08-17 16:00:00-04:00,0,8,16,2,0,345,3305,3650
2016-08-17 17:00:00-04:00,0,8,17,2,0,669,9037,9706
2016-08-17 18:00:00-04:00,0,8,18,2,0,1163,14665,15828
2016-08-17 19:00:00-04:00,0,8,19,2,0,1998,18514,20512
2016-08-17 20:00:00-04:00,0,8,20,2,0,1871,17435,19306
2016-08-17 21:00:00-04:00,0,8,21,2,0,1651,15549,17200
2016-08-17 22:00:00-04:00,0,8,22,2,0,1551,16013,17564
2016-08-17 23:00:00-04:00,0,8,23,2,0,1567,16451,18018
2016-08-18 00:00:00-04:00,0,8,0,3,0,1550,16512,18062
2016-08-18 01:00:00-04:00,0,8,1,3,0,1615,17089,18704
2016-08-18 02:00:00-04:00,0,8,2,3,0,1817,16123,17940
2016-08-18 03:00:00-04:00,0,8,3,3,0,2075,14659,16734
2016-08-18 04:00:00-04:00,0,8,4,3,0,2244,17332,19576
2016-08-18 05:00:00-04:00,0.02,8,5,3,0,2509,20914,23423
2016-08-18 06:00:00-04:00,0,8,6,3,0,2475,21801,24276
2016-08-18 07:00:00-04:00,0,8,7,3,0,2288,21250,23538
2016-08-18 08:00:00-04:00,0,8,8,3,0,2190,20629,22819
2016-08-18 09:00:00-04:00,0,8,9,3,0,2102,19105,21207
2016-08-18 10:00:00-04:00,0,8,10,3,0,1995,15525,17520
2016-08-18 11:00:00-04:00,0,8,11,3,0,1497,10490,11987
2016-08-18 12:00:00-04:00,0,8,12,3,0,1011,6291,7302
2016-08-18 13:00:00-04:00,0,8,13,3,0,593,4037,4630
2016-08-18 14:00:00-04:00,0,8,14,3,0,470,2664,3134
2016-08-18 15:00:00-04:00,0,8,15,3,0,410,2801,3211
2016-08-18 16:00:00-04:00,0,8,16,3,0,376,3598,3974
2016-08-18 17:00:00-04:00,0,8,17,3,0,680,9407,10087
2016-08-18 18:00:00-04:00,0,8,18,3,0,1186,14433,15619
2016-08-18 19:00:00-04:00,0,8,19,3,0,2032,18265,20297
2016-08-18 20:00:00-04:00,0,8,20,3,0,1969,17400,19369
2016-08-18 21:00:00-04:00,0,8,21,3,0,1743,15531,17274
2016-08-18 22:00:00-04:00,0,8,22,3,0,1543,15318,16861
2016-08-18 23:00:00-04:00,0,8,23,3,0,1635,16546,18181
2016-08-19 00:00:00-04:00,0,8,0,4,0,1558,16650,18208
2016-08-19 01:00:00-04:00,0,8,1,4,0,1669,17427,19096
2016-08-19 02:00:00-04:00,0,8,2,4,0,1855,16574,18429
2016-08-19 03:00:00-04:00,0,8,3,4,0,2132,14529,16661
2016-08-19 04:00:00-04:00,0,8,4,4,0,2312,17052,19364
2016-08-19 05:00:00-04:00,0,8,5,4,0,2710,20623,23333
2016-08-19 06:00:00-04:00,0,8,6,4,0,2676,21804,24480
2016-08-19 07:00:00-04:00,0,8,7,4,0,2448,21860,24308
2016-08-19 08:00:00-04:00,0,8,8,4,0,2244,21453,23697
2016-08-19 09:00:00-04:00,0,8,9,4,0,2394,20920,23314
2016-08-19 10:00:00-04:00,0,8,10,4,0,2114,18286,20400
2016-08-19 11:00:00-04:00,0,8,11,4,0,1755,14016,15771
2016-08-19 12:00:00-04:00,0,8,12,4,0,1271,9337,10608
2016-08-19 13:00:00-04:00,0,8,13,4,0,856,6100,6956
2016-08-19 14:00:00-04:00,0,8,14,4,0,560,4049,4609
2016-08-19 15:00:00-04:00,0,8,15,4,0,512,3431,3943
2016-08-19 16:00:00-04:00,0,8,16,4,0,417,3877,4294
2016-08-19 17:00:00-04:00,0,8,17,4,0,738,8683,9421
2016-08-19 18:00:00-04:00,0,8,18,4,0,1220,12230,13450
2016-08-19 19:00:00-04:00,0,8,19,4,0,1971,15979,17950
2016-08-19 20:00:00-04:00,0,8,20,4,0,2304,16695,18999
2016-08-19 21:00:00-04:00,0,8,21,4,0,1955,15120,17075
2016-08-19 22:00:00-04:00,0.02,8,22,4,0,1703,15431,17134
2016-08-19 23:00:00-04:00,0,8,23,4,0,1655,16369,18024
2016-08-20 00:00:00-04:00,0,8,0,5,0,1577,16460,18037
2016-08-20 01:00:00-04:00,0,8,1,5,0,1733,17294,19027
2016-08-20 02:00:00-04:00,0,8,2,5,0,2104,16377,18481
2016-08-20 03:00:00-04:00,0,8,3,5,0,2410,14971,17381
2016-08-20 04:00:00-04:00,0,8,4,5,0,2815,17779,20594
2016-08-20 05:00:00-04:00,0,8,5,5,0,3123,20421,23544
2016-08-20 06:00:00-04:00,0,8,6,5,0,3222,20551,23773
2016-08-20 07:00:00-04:00,0,8,7,5,0,3078,18794,21872
2016-08-20 08:00:00-04:00,0,8,8,5,0,3041,18263,21304
2016-08-20 09:00:00-04:00,0,8,9,5,0,3121,18399,21520
2016-08-20 10:00:00-04:00,0,8,10,5,0,3297,18083,21380
2016-08-20 11:00:00-04:00,0,8,11,5,0,3094,17182,20276
2016-08-20 12:00:00-04:00,0.09,8,12,5,0,2670,14868,17538
2016-08-20 13:00:00-04:00,0,8,13,5,0,2293,12632,14925
2016-08-20 14:00:00-04:00,0.03,8,14,5,0,1889,9465,11354
2016-08-20 15:00:00-04:00,0,8,15,5,0,1429,6269,7698
2016-08-20 16:00:00-04:00,0,8,16,5,0,707,3090,3797
2016-08-20 17:00:00-04:00,0,8,17,5,0,678,4549,5227
2016-08-20 18:00:00-04:00,0,8,18,5,0,789,5773,6562
2016-08-20 19:00:00-04:00,0,8,19,5,0,1026,8164,9190
2016-08-20 20:00:00-04:00,0,8,20,5,0,1432,10859,12291
2016-08-20 21:00:00-04:00,0,8,21,5,0,1670,12403,14073
2016-08-20 22:00:00-04:00,0,8,22,5,0,1845,14374,16219
2016-08-20 23:00:00-04:00,0,8,23,5,0,2030,18188,20218
2016-08-21 00:00:00-04:00,0,8,0,6,0,2193,17347,19540
2016-08-21 01:00:00-04:00,0,8,1,6,0,2290,14836,17126
2016-08-21 02:00:00-04:00,0,8,2,6,0,2290,14590,16880
2016-08-21 03:00:00-04:00,0,8,3,6,0,2430,14489,16919
2016-08-21 04:00:00-04:00,0,8,4,6,0,2521,15970,18491
2016-08-21 05:00:00-04:00,0,8,5,6,0,2798,16894,19692
2016-08-21 06:00:00-04:00,0,8,6,6,0,2988,17102,20090
2016-08-21 07:00:00-04:00,0,8,7,6,0,3046,15752,18798
2016-08-21 08:00:00-04:00,0.03,8,8,6,0,3087,15714,18801
2016-08-21 09:00:00-04:00,0,8,9,6,0,3343,16641,19984
2016-08-21 10:00:00-04:00,0,8,10,6,0,3438,17285,20723
2016-08-21 11:00:00-04:00,0,8,11,6,0,3419,16932,20351
2016-08-21 12:00:00-04:00,0,8,12,6,0,3095,15072,18167
2016-08-21 13:00:00-04:00,0,8,13,6,0,2610,12727,15337
2016-08-21 14:00:00-04:00,0,8,14,6,0,2179,10164,12343
2016-08-21 15:00:00-04:00,0,8,15,6,0,1639,6736,8375
2016-08-21 16:00:00-04:00,0,8,16,6,0,818,3171,3989
2016-08-21 17:00:00-04:00,0,8,17,6,0,633,3410,4043
2016-08-21 18:00:00-04:00,0.03,8,18,6,0,642,4822,5464
2016-08-21 19:00:00-04:00,0.04,8,19,6,0,764,7066,7830
2016-08-21 20:00:00-04:00,0,8,20,6,0,1044,8678,9722
2016-08-21 21:00:00-04:00,0,8,21,6,0,1306,11598,12904
2016-08-21 22:00:00-04:00,0,8,22,6,0,1579,13123,14702
2016-08-21 23:00:00-04:00,0.03,8,23,6,0,1840,14117,15957
2016-08-22 00:00:00-04:00,0,8,0,0,0,1795,14973,16768
2016-08-22 01:00:00-04:00,0,8,1,0,0,1987,15766,17753
2016-08-22 02:00:00-04:00,0,8,2,0,0,2130,15564,17694
2016-08-22 03:00:00-04:00,0,8,3,0,0,2225,15981,18206
2016-08-22 04:00:00-04:00,0,8,4,0,0,2380,17017,19397
2016-08-22 05:00:00-04:00,0,8,5,0,0,3026,19297,22323
2016-08-22 06:00:00-04:00,0,8,6,0,0,2528,16177,18705
2016-08-22 07:00:00-04:00,0,8,7,0,0,2098,13472,15570
2016-08-22 08:00:00-04:00,0,8,8,0,0,1811,13245,15056
2016-08-22 09:00:00-04:00,0,8,9,0,0,1784,11691,13475
2016-08-22 10:00:00-04:00,0,8,10,0,0,1551,9642,11193
2016-08-22 11:00:00-04:00,0,8,11,0,0,1090,6360,7450
2016-08-22 12:00:00-04:00,0,8,12,0,0,661,3839,4500
2016-08-22 13:00:00-04:00,0,8,13,0,0,456,2458,2914
2016-08-22 14:00:00-04:00,0,8,14,0,0,339,1634,1973
2016-08-22 15:00:00-04:00,0,8,15,0,0,452,2192,2644
2016-08-22 16:00:00-04:00,0,8,16,0,0,384,3327,3711
2016-08-22 17:00:00-04:00,0,8,17,0,0,669,8167,8836
2016-08-22 18:00:00-04:00,0,8,18,0,0,1131,12509,13640
2016-08-22 19:00:00-04:00,0,8,19,0,0,1882,15873,17755
2016-08-22 20:00:00-04:00,0,8,20,0,0,1815,15317,17132
2016-08-22 21:00:00-04:00,0,8,21,0,0,1486,13386,14872
2016-08-22 22:00:00-04:00,0,8,22,0,0,1344,12856,14200
2016-08-22 23:00:00-04:00,0,8,23,0,0,1393,13910,15303
2016-08-23 00:00:00-04:00,0,8,0,1,0,1409,14488,15897
2016-08-23 01:00:00-04:00,0,8,1,1,0,1523,14919,16442
2016-08-23 02:00:00-04:00,0,8,2,1,0,1608,14788,16396
2016-08-23 03:00:00-04:00,0,8,3,1,0,1821,14166,15987
2016-08-23 04:00:00-04:00,0,8,4,1,0,1923,15955,17878
2016-08-23 05:00:00-04:00,0,8,5,1,0,2232,18982,21214
2016-08-23 06:00:00-04:00,0,8,6,1,0,2082,18370,20452
2016-08-23 07:00:00-04:00,0,8,7,1,0,1862,17479,19341
2016-08-23 08:00:00-04:00,0,8,8,1,0,1656,16902,18558
2016-08-23 09:00:00-04:00,0,8,9,1,0,1474,14619,16093
2016-08-23 10:00:00-04:00,0,8,10,1,0,1379,10652,12031
2016-08-23 11:00:00-04:00,0,8,11,1,0,1025,7155,8180
2016-08-23 12:00:00-04:00,0,8,12,1,0,682,4175,4857
2016-08-23 13:00:00-04:00,0,8,13,1,0,424,2644,3068
2016-08-23 14:00:00-04:00,0,8,14,1,0,294,1836,2130
2016-08-23 15:00:00-04:00,0,8,15,1,0,291,1923,2214
2016-08-23 16:00:00-04:00,0,8,16,1,0,317,3207,3524
2016-08-23 17:00:00-04:00,0,8,17,1,0,636,8416,9052
2016-08-23 18:00:00-04:00,0,8,18,1,0,993,12894,13887
2016-08-23 19:00:00-04:00,0,8,19,1,0,1769,16483,18252
2016-08-23 20:00:00-04:00,0,8,20,1,0,1724,15764,17488
2016-08-23 21:00:00-04:00,0,8,21,1,0,1517,14065,15582
2016-08-23 22:00:00-04:00,0,8,22,1,0,1419,14009,15428
2016-08-23 23:00:00-04:00,0,8,23,1,0,1403,14606,16009
2016-08-24 00:00:00-04:00,0,8,0,2,0,1380,15050,16430
2016-08-24 01:00:00-04:00,0,8,1,2,0,1512,16108,17620
2016-08-24 02:00:00-04:00,0,8,2,2,0,1728,15393,17121
2016-08-24 03:00:00-04:00,0,8,3,2,0,1810,14495,16305
2016-08-24 04:00:00-04:00,0,8,4,2,0,1977,16560,18537
2016-08-24 05:00:00-04:00,0,8,5,2,0,2344,19992,22336
2016-08-24 06:00:00-04:00,0,8,6,2,0,2173,19858,22031
2016-08-24 07:00:00-04:00,0,8,7,2,0,2067,19948,22015
2016-08-24 08:00:00-04:00,0,8,8,2,0,1798,19770,21568
2016-08-24 09:00:00-04:00,0,8,9,2,0,1663,17817,19480
2016-08-24 10:00:00-04:00,0,8,10,2,0,1453,12900,14353
2016-08-24 11:00:00-04:00,0,8,11,2,0,1072,8766,9838
2016-08-24 12:00:00-04:00,0,8,12,2,0,717,5704,6421
2016-08-24 13:00:00-04:00,0,8,13,2,0,430,3300,3730
2016-08-24 14:00:00-04:00,0,8,14,2,0,325,2228,2553
2016-08-24 15:00:00-04:00,0,8,15,2,0,315,2172,2487
2016-08-24 16:00:00-04:00,0,8,16,2,0,284,3244,3528
2016-08-24 17:00:00-04:00,0,8,17,2,0,599,8340,8939
2016-08-24 18:00:00-04:00,0,8,18,2,0,1109,13042,14151
2016-08-24 19:00:00-04:00,0,8,19,2,0,1785,16930,18715
2016-08-24 20:00:00-04:00,0,8,20,2,0,1817,16338,18155
2016-08-24 21:00:00-04:00,0,8,21,2,0,1565,14825,16390
2016-08-24 22:00:00-04:00,0,8,22,2,0,1450,15011,16461
2016-08-24 23:00:00-04:00,0,8,23,2,0,1516,15941,17457
2016-08-25 00:00:00-04:00,0,8,0,3,0,1553,16186,17739
2016-08-25 01:00:00-04:00,0,8,1,3,0,1550,16804,18354
2016-08-25 02:00:00-04:00,0,8,2,3,0,1699,15940,17639
2016-08-25 03:00:00-04:00,0,8,3,3,0,1831,14750,16581
2016-08-25 04:00:00-04:00,0,8,4,3,0,2152,16947,19099
2016-08-25 05:00:00-04:00,0,8,5,3,0,2415,20078,22493
2016-08-25 06:00:00-04:00,0,8,6,3,0,2450,20984,23434
2016-08-25 07:00:00-04:00,0,8,7,3,0,2276,20807,23083
2016-08-25 08:00:00-04:00,0,8,8,3,0,1991,20298,22289
2016-08-25 09:00:00-04:00,0,8,9,3,0,1938,18450,20388
2016-08-25 10:00:00-04:00,0,8,10,3,0,1605,14405,16010
2016-08-25 11:00:00-04:00,0,8,11,3,0,1239,9349,10588
2016-08-25 12:00:00-04:00,0,8,12,3,0,830,5745,6575
2016-08-25 13:00:00-04:00,0,8,13,3,0,510,3732,4242
2016-08-25 14:00:00-04:00,0,8,14,3,0,351,2486,2837
2016-08-25 15:00:00-04:00,0,8,15,3,0,349,2344,2693
2016-08-25 16:00:00-04:00,0,8,16,3,0,323,3421,3744
2016-08-25 17:00:00-04:00,0.01,8,17,3,0,672,8794,9466
2016-08-25 18:00:00-04:00,0,8,18,3,0,1111,13333,14444
2016-08-25 19:00:00-04:00,0,8,19,3,0,1885,16975,18860
2016-08-25 20:00:00-04:00,0,8,20,3,0,1854,16478,18332
2016-08-25 21:00:00-04:00,0,8,21,3,0,1659,15081,16740
2016-08-25 22:00:00-04:00,0,8,22,3,0,1512,14858,16370
2016-08-25 23:00:00-04:00,0,8,23,3,0,1490,16055,17545
2016-08-26 00:00:00-04:00,0,8,0,4,0,1512,16440,17952
2016-08-26 01:00:00-04:00,0,8,1,4,0,1727,17537,19264
2016-08-26 02:00:00-04:00,0,8,2,4,0,1913,16233,18146
2016-08-26 03:00:00-04:00,0,8,3,4,0,2124,15084,17208
2016-08-26 04:00:00-04:00,0,8,4,4,0,2730,18181,20911
2016-08-26 05:00:00-04:00,0,8,5,4,0,2692,20012,22704
2016-08-26 06:00:00-04:00,0,8,6,4,0,2765,21887,24652
2016-08-26 07:00:00-04:00,0,8,7,4,0,2477,21694,24171
2016-08-26 08:00:00-04:00,0,8,8,4,0,2199,20184,22383
2016-08-26 09:00:00-04:00,0,8,9,4,0,2078,19780,21858
2016-08-26 10:00:00-04:00,0,8,10,4,0,1928,17127,19055
2016-08-26 11:00:00-04:00,0,8,11,4,0,1578,12985,14563
2016-08-26 12:00:00-04:00,0,8,12,4,0,1214,9353,10567
2016-08-26 13:00:00-04:00,0,8,13,4,0,795,5712,6507
2016-08-26 14:00:00-04:00,0,8,14,4,0,548,3678,4226
2016-08-26 15:00:00-04:00,0,8,15,4,0,422,3220,3642
2016-08-26 16:00:00-04:00,0,8,16,4,0,385,3649,4034
2016-08-26 17:00:00-04:00,0,8,17,4,0,744,8170,8914
2016-08-26 18:00:00-04:00,0,8,18,4,0,1164,12070,13234
2016-08-26 19:00:00-04:00,0,8,19,4,0,1915,15538,17453
2016-08-26 20:00:00-04:00,0,8,20,4,0,1949,15258,17207
2016-08-26 21:00:00-04:00,0,8,21,4,0,1681,14386,16067
2016-08-26 22:00:00-04:00,0,8,22,4,0,1539,14695,16234
2016-08-26 23:00:00-04:00,0,8,23,4,0,1512,16177,17689
2016-08-27 00:00:00-04:00,0,8,0,5,0,1431,16195,17626
2016-08-27 01:00:00-04:00,0,8,1,5,0,1713,16460,18173
2016-08-27 02:00:00-04:00,0,8,2,5,0,1955,15385,17340
2016-08-27 03:00:00-04:00,0,8,3,5,0,2284,13958,16242
2016-08-27 04:00:00-04:00,0,8,4,5,0,2533,16607,19140
2016-08-27 05:00:00-04:00,0,8,5,5,0,2876,19744,22620
2016-08-27 06:00:00-04:00,0,8,6,5,0,2915,19984,22899
2016-08-27 07:00:00-04:00,0,8,7,5,0,2843,18250,21093
2016-08-27 08:00:00-04:00,0,8,8,5,0,2703,17599,20302
2016-08-27 09:00:00-04:00,0,8,9,5,0,2802,18594,21396
2016-08-27 10:00:00-04:00,0,8,10,5,0,2757,18045,20802
2016-08-27 11:00:00-04:00,0,8,11,5,0,2660,16626,19286
2016-08-27 12:00:00-04:00,0,8,12,5,0,2454,14969,17423
2016-08-27 13:00:00-04:00,0,8,13,5,0,2135,12561,14696
2016-08-27 14:00:00-04:00,0,8,14,5,0,1693,9231,10924
2016-08-27 15:00:00-04:00,0,8,15,5,0,1285,6112,7397
2016-08-27 16:00:00-04:00,0,8,16,5,0,657,3052,3709
2016-08-27 17:00:00-04:00,0,8,17,5,0,637,4327,4964
2016-08-27 18:00:00-04:00,0,8,18,5,0,702,5916,6618
2016-08-27 19:00:00-04:00,0,8,19,5,0,938,7866,8804
2016-08-27 20:00:00-04:00,0,8,20,5,0,1288,10596,11884
2016-08-27 21:00:00-04:00,0,8,21,5,0,1474,12069,13543
2016-08-27 22:00:00-04:00,0,8,22,5,0,1621,13749,15370
2016-08-27 23:00:00-04:00,0,8,23,5,0,1707,14909,16616
2016-08-28 00:00:00-04:00,0,8,0,6,0,1778,15463,17241
2016-08-28 01:00:00-04:00,0,8,1,6,0,1982,15103,17085
2016-08-28 02:00:00-04:00,0,8,2,6,0,2244,15384,17628
2016-08-28 03:00:00-04:00,0,8,3,6,0,2407,14790,17197
2016-08-28 04:00:00-04:00,0,8,4,6,0,2392,15850,18242
2016-08-28 05:00:00-04:00,0,8,5,6,0,2731,17575,20306
2016-08-28 06:00:00-04:00,0,8,6,6,0,2787,17485,20272
2016-08-28 07:00:00-04:00,0,8,7,6,0,2883,15855,18738
2016-08-28 08:00:00-04:00,0,8,8,6,0,2887,15388,18275
2016-08-28 09:00:00-04:00,0,8,9,6,0,3226,17070,20296
2016-08-28 10:00:00-04:00,0,8,10,6,0,3131,17361,20492
2016-08-28 11:00:00-04:00,0,8,11,6,0,2987,16782,19769
2016-08-28 12:00:00-04:00,0,8,12,6,0,2730,15161,17891
2016-08-28 13:00:00-04:00,0,8,13,6,0,2488,12902,15390
2016-08-28 14:00:00-04:00,0,8,14,6,0,2018,10157,12175
2016-08-28 15:00:00-04:00,0,8,15,6,0,1482,6614,8096
2016-08-28 16:00:00-04:00,0,8,16,6,0,709,3099,3808
2016-08-28 17:00:00-04:00,0,8,17,6,0,492,3427,3919
2016-08-28 18:00:00-04:00,0,8,18,6,0,585,4641,5226
2016-08-28 19:00:00-04:00,0,8,19,6,0,648,6245,6893
2016-08-28 20:00:00-04:00,0,8,20,6,0,965,9014,9979
2016-08-28 21:00:00-04:00,0,8,21,6,0,1235,11714,12949
2016-08-28 22:00:00-04:00,0,8,22,6,0,1382,13421,14803
2016-08-28 23:00:00-04:00,0,8,23,6,0,1585,14552,16137
2016-08-29 00:00:00-04:00,0,8,0,0,0,1638,14781,16419
2016-08-29 01:00:00-04:00,0,8,1,0,0,1784,15652,17436
2016-08-29 02:00:00-04:00,0,8,2,0,0,1978,14958,16936
2016-08-29 03:00:00-04:00,0,8,3,0,0,2076,14509,16585
2016-08-29 04:00:00-04:00,0,8,4,0,0,2040,15280,17320
2016-08-29 05:00:00-04:00,0,8,5,0,0,2156,16008,18164
2016-08-29 06:00:00-04:00,0,8,6,0,0,2170,14895,17065
2016-08-29 07:00:00-04:00,0,8,7,0,0,2124,15183,17307
2016-08-29 08:00:00-04:00,0,8,8,0,0,1984,14059,16043
2016-08-29 09:00:00-04:00,0,8,9,0,0,1847,12586,14433
2016-08-29 10:00:00-04:00,0,8,10,0,0,1599,10412,12011
2016-08-29 11:00:00-04:00,0,8,11,0,0,1236,7816,9052
2016-08-29 12:00:00-04:00,0,8,12,0,0,799,4682,5481
2016-08-29 13:00:00-04:00,0,8,13,0,0,506,3003,3509
2016-08-29 14:00:00-04:00,0,8,14,0,0,375,2150,2525
2016-08-29 15:00:00-04:00,0,8,15,0,0,361,2485,2846
2016-08-29 16:00:00-04:00,0,8,16,0,0,293,3398,3691
2016-08-29 17:00:00-04:00,0,8,17,0,0,603,8048,8651
2016-08-29 18:00:00-04:00,0,8,18,0,0,1012,12629,13641
2016-08-29 19:00:00-04:00,0,8,19,0,0,1661,15885,17546
2016-08-29 20:00:00-04:00,0,8,20,0,0,1673,15707,17380
2016-08-29 21:00:00-04:00,0,8,21,0,0,1389,13994,15383
2016-08-29 22:00:00-04:00,0,8,22,0,0,1347,13618,14965
2016-08-29 23:00:00-04:00,0,8,23,0,0,1324,14404,15728
2016-08-30 00:00:00-04:00,0,8,0,1,0,1294,15109,16403
2016-08-30 01:00:00-04:00,0,8,1,1,0,1462,15920,17382
2016-08-30 02:00:00-04:00,0,8,2,1,0,1519,15204,16723
2016-08-30 03:00:00-04:00,0,8,3,1,0,1716,14311,16027
2016-08-30 04:00:00-04:00,0,8,4,1,0,1985,16373,18358
2016-08-30 05:00:00-04:00,0,8,5,1,0,2157,18746,20903
2016-08-30 06:00:00-04:00,0,8,6,1,0,2038,18307,20345
2016-08-30 07:00:00-04:00,0,8,7,1,0,1702,17206,18908
2016-08-30 08:00:00-04:00,0,8,8,1,0,1627,15315,16942
2016-08-30 09:00:00-04:00,0,8,9,1,0,1433,13242,14675
2016-08-30 10:00:00-04:00,0,8,10,1,0,1192,10174,11366
2016-08-30 11:00:00-04:00,0,8,11,1,0,894,6920,7814
2016-08-30 12:00:00-04:00,0,8,12,1,0,634,4131,4765
2016-08-30 13:00:00-04:00,0,8,13,1,0,421,2509,2930
2016-08-30 14:00:00-04:00,0,8,14,1,0,256,1662,1918
2016-08-30 15:00:00-04:00,0,8,15,1,0,253,1683,1936
2016-08-30 16:00:00-04:00,0,8,16,1,0,248,2909,3157
2016-08-30 17:00:00-04:00,0,8,17,1,0,492,8114,8606
2016-08-30 18:00:00-04:00,0,8,18,1,0,941,12854,13795
2016-08-30 19:00:00-04:00,0,8,19,1,0,1556,16075,17631
2016-08-30 20:00:00-04:00,0,8,20,1,0,1514,15560,17074
2016-08-30 21:00:00-04:00,0,8,21,1,0,1345,14396,15741
2016-08-30 22:00:00-04:00,0,8,22,1,0,1343,14262,15605
2016-08-30 23:00:00-04:00,0,8,23,1,0,1294,15284,16578
2016-08-31 00:00:00-04:00,0,8,0,2,0,1280,15619,16899
2016-08-31 01:00:00-04:00,0,8,1,2,0,1378,16033,17411
2016-08-31 02:00:00-04:00,0,8,2,2,0,1574,15380,16954
2016-08-31 03:00:00-04:00,0,8,3,2,0,1727,14286,16013
2016-08-31 04:00:00-04:00,0,8,4,2,0,1964,16425,18389
2016-08-31 05:00:00-04:00,0,8,5,2,0,2159,19374,21533
2016-08-31 06:00:00-04:00,0,8,6,2,0,2152,19570,21722
2016-08-31 07:00:00-04:00,0,8,7,2,0,1997,19165,21162
2016-08-31 08:00:00-04:00,0,8,8,2,0,1795,18405,20200
2016-08-31 09:00:00-04:00,0,8,9,2,0,1703,16645,18348
2016-08-31 10:00:00-04:00,0,8,10,2,0,1418,13168,14586
2016-08-31 11:00:00-04:00,0,8,11,2,0,990,8674,9664
2016-08-31 12:00:00-04:00,0,8,12,2,0,677,5674,6351
2016-08-31 13:00:00-04:00,0,8,13,2,0,418,3362,3780
2016-08-31 14:00:00-04:00,0,8,14,2,0,302,2164,2466
2016-08-31 15:00:00-04:00,0,8,15,2,0,254,2032,2286
2016-08-31 16:00:00-04:00,0,8,16,2,0,203,3195,3398
2016-08-31 17:00:00-04:00,0,8,17,2,0,538,8374,8912
2016-08-31 18:00:00-04:00,0,8,18,2,0,1011,13312,14323
2016-08-31 19:00:00-04:00,0,8,19,2,0,1643,17170,18813
2016-08-31 20:00:00-04:00,0,8,20,2,0,1606,16515,18121
2016-08-31 21:00:00-04:00,0,8,21,2,0,1530,15323,16853
2016-08-31 22:00:00-04:00,0,8,22,2,0,1425,15364,16789
2016-08-31 23:00:00-04:00,0,8,23,2,0,1476,16007,17483
2016-09-01 00:00:00-04:00,0,9,0,3,0,1432,16260,17692
2016-09-01 01:00:00-04:00,0,9,1,3,0,1579,16590,18169
2016-09-01 02:00:00-04:00,0,9,2,3,0,1754,15987,17741
2016-09-01 03:00:00-04:00,0,9,3,3,0,1893,14728,16621
2016-09-01 04:00:00-04:00,0.01,9,4,3,0,2118,17242,19360
2016-09-01 05:00:00-04:00,0,9,5,3,0,2423,20244,22667
2016-09-01 06:00:00-04:00,0.01,9,6,3,0,2293,20737,23030
2016-09-01 07:00:00-04:00,0.01,9,7,3,0,2076,20175,22251
2016-09-01 08:00:00-04:00,0.01,9,8,3,0,1941,19511,21452
2016-09-01 09:00:00-04:00,0.05,9,9,3,0,1873,18308,20181
2016-09-01 10:00:00-04:00,0.01,9,10,3,0,1569,14003,15572
2016-09-01 11:00:00-04:00,0,9,11,3,0,1219,9807,11026
2016-09-01 12:00:00-04:00,0,9,12,3,0,841,6139,6980
2016-09-01 13:00:00-04:00,0,9,13,3,0,522,3861,4383
2016-09-01 14:00:00-04:00,0.18,9,14,3,0,378,2480,2858
2016-09-01 15:00:00-04:00,0.06,9,15,3,0,298,2256,2554
2016-09-01 16:00:00-04:00,0,9,16,3,0,246,3403,3649
2016-09-01 17:00:00-04:00,0,9,17,3,0,559,9200,9759
2016-09-01 18:00:00-04:00,0,9,18,3,0,1234,14977,16211
2016-09-01 19:00:00-04:00,0,9,19,3,0,1806,18746,20552
2016-09-01 20:00:00-04:00,0,9,20,3,0,2037,18489,20526
2016-09-01 21:00:00-04:00,0,9,21,3,0,1641,15713,17354
2016-09-01 22:00:00-04:00,0,9,22,3,0,1529,14563,16092
2016-09-01 23:00:00-04:00,0,9,23,3,0,1437,15195,16632
2016-09-02 00:00:00-04:00,0,9,0,4,0,1619,15733,17352
2016-09-02 01:00:00-04:00,0,9,1,4,0,2161,21707,23868
2016-09-02 02:00:00-04:00,0,9,2,4,0,2209,16469,18678
2016-09-02 03:00:00-04:00,0,9,3,4,0,2106,13489,15595
2016-09-02 04:00:00-04:00,0,9,4,4,0,2446,16337,18783
2016-09-02 05:00:00-04:00,0,9,5,4,0,2759,20150,22909
2016-09-02 06:00:00-04:00,0,9,6,4,0,2521,19820,22341
2016-09-02 07:00:00-04:00,0,9,7,4,0,2238,19087,21325
2016-09-02 08:00:00-04:00,0,9,8,4,0,1999,17747,19746
2016-09-02 09:00:00-04:00,0,9,9,4,0,1990,17966,19956
2016-09-02 10:00:00-04:00,0,9,10,4,0,1850,15397,17247
2016-09-02 11:00:00-04:00,0,9,11,4,0,1570,12344,13914
2016-09-02 12:00:00-04:00,0,9,12,4,0,1123,8345,9468
2016-09-02 13:00:00-04:00,0,9,13,4,0,765,5759,6524
2016-09-02 14:00:00-04:00,0,9,14,4,0,524,3974,4498
2016-09-02 15:00:00-04:00,0,9,15,4,0,461,3492,3953
2016-09-02 16:00:00-04:00,0,9,16,4,0,295,3959,4254
2016-09-02 17:00:00-04:00,0,9,17,4,0,574,7886,8460
2016-09-02 18:00:00-04:00,0,9,18,4,0,989,10782,11771
2016-09-02 19:00:00-04:00,0,9,19,4,0,1564,13399,14963
2016-09-02 20:00:00-04:00,0,9,20,4,0,1599,13506,15105
2016-09-02 21:00:00-04:00,0,9,21,4,0,1559,12941,14500
2016-09-02 22:00:00-04:00,0,9,22,4,0,1578,13487,15065
2016-09-02 23:00:00-04:00,0,9,23,4,0,1519,14967,16486
2016-09-03 00:00:00-04:00,0,9,0,5,0,1442,15850,17292
2016-09-03 01:00:00-04:00,0,9,1,5,0,1785,16488,18273
2016-09-03 02:00:00-04:00,0,9,2,5,0,2159,15840,17999
2016-09-03 03:00:00-04:00,0,9,3,5,0,2463,14327,16790
2016-09-03 04:00:00-04:00,0,9,4,5,0,2587,16073,18660
2016-09-03 05:00:00-04:00,0,9,5,5,0,2768,17473,20241
2016-09-03 06:00:00-04:00,0,9,6,5,0,2656,17913,20569
2016-09-03 07:00:00-04:00,0,9,7,5,0,2600,16242,18842
2016-09-03 08:00:00-04:00,0,9,8,5,0,2587,15257,17844
2016-09-03 09:00:00-04:00,0,9,9,5,0,2733,16067,18800
2016-09-03 10:00:00-04:00,0,9,10,5,0,2763,15651,18414
2016-09-03 11:00:00-04:00,0,9,11,5,0,2496,14238,16734
2016-09-03 12:00:00-04:00,0,9,12,5,0,2281,12007,14288
2016-09-03 13:00:00-04:00,0,9,13,5,0,1844,10240,12084
2016-09-03 14:00:00-04:00,0,9,14,5,0,1609,8119,9728
2016-09-03 15:00:00-04:00,0,9,15,5,0,1231,5999,7230
2016-09-03 16:00:00-04:00,0,9,16,5,0,583,3163,3746
2016-09-03 17:00:00-04:00,0,9,17,5,0,536,3938,4474
2016-09-03 18:00:00-04:00,0,9,18,5,0,615,4967,5582
2016-09-03 19:00:00-04:00,0,9,19,5,0,713,6603,7316
2016-09-03 20:00:00-04:00,0,9,20,5,0,1021,9232,10253
2016-09-03 21:00:00-04:00,0,9,21,5,0,1228,10905,12133
2016-09-03 22:00:00-04:00,0,9,22,5,0,1314,12172,13486
2016-09-03 23:00:00-04:00,0,9,23,5,0,1531,12794,14325
2016-09-04 00:00:00-04:00,0,9,0,6,0,1606,13467,15073
2016-09-04 01:00:00-04:00,0,9,1,6,0,1779,13312,15091
2016-09-04 02:00:00-04:00,0,9,2,6,0,1939,13418,15357
2016-09-04 03:00:00-04:00,0,9,3,6,0,2072,13499,15571
2016-09-04 04:00:00-04:00,0,9,4,6,0,2088,14340,16428
2016-09-04 05:00:00-04:00,0,9,5,6,0,2322,15114,17436
2016-09-04 06:00:00-04:00,0,9,6,6,0,2272,15652,17924
2016-09-04 07:00:00-04:00,0,9,7,6,0,2460,13700,16160
2016-09-04 08:00:00-04:00,0,9,8,6,0,2435,13433,15868
2016-09-04 09:00:00-04:00,0,9,9,6,0,2686,14868,17554
2016-09-04 10:00:00-04:00,0,9,10,6,0,2799,15219,18018
2016-09-04 11:00:00-04:00,0,9,11,6,0,2656,13650,16306
2016-09-04 12:00:00-04:00,0,9,12,6,0,2326,11561,13887
2016-09-04 13:00:00-04:00,0,9,13,6,0,1961,10067,12028
2016-09-04 14:00:00-04:00,0,9,14,6,0,1672,8010,9682
2016-09-04 15:00:00-04:00,0,9,15,6,0,1310,5782,7092
2016-09-04 16:00:00-04:00,0,9,16,6,0,657,2660,3317
2016-09-04 17:00:00-04:00,0,9,17,6,0,437,2718,3155
2016-09-04 18:00:00-04:00,0,9,18,6,0,442,3478,3920
2016-09-04 19:00:00-04:00,0,9,19,6,0,512,4533,5045
2016-09-04 20:00:00-04:00,0,9,20,6,0,746,7049,7795
2016-09-04 21:00:00-04:00,0,9,21,6,0,963,9645,10608
2016-09-04 22:00:00-04:00,0,9,22,6,0,1165,10667,11832
2016-09-04 23:00:00-04:00,0,9,23,6,0,1224,11878,13102
2016-09-05 00:00:00-04:00,0,9,0,0,1,1387,12497,13884
2016-09-05 01:00:00-04:00,0,9,1,0,1,1610,13407,15017
2016-09-05 02:00:00-04:00,0,9,2,0,1,1798,13368,15166
2016-09-05 03:00:00-04:00,0,9,3,0,1,1840,13081,14921
2016-09-05 04:00:00-04:00,0,9,4,0,1,1939,14168,16107
2016-09-05 05:00:00-04:00,0,9,5,0,1,2011,14496,16507
2016-09-05 06:00:00-04:00,0,9,6,0,1,1990,13778,15768
2016-09-05 07:00:00-04:00,0,9,7,0,1,1907,12699,14606
2016-09-05 08:00:00-04:00,0,9,8,0,1,1900,12296,14196
2016-09-05 09:00:00-04:00,0,9,9,0,1,2204,12403,14607
2016-09-05 10:00:00-04:00,0,9,10,0,1,2269,12799,15068
2016-09-05 11:00:00-04:00,0,9,11,0,1,2034,11689,13723
2016-09-05 12:00:00-04:00,0,9,12,0,1,1526,8779,10305
2016-09-05 13:00:00-04:00,0,9,13,0,1,1176,6502,7678
2016-09-05 14:00:00-04:00,0,9,14,0,1,872,5116,5988
2016-09-05 15:00:00-04:00,0,9,15,0,1,710,3781,4491
2016-09-05 16:00:00-04:00,0,9,16,0,1,453,2664,3117
2016-09-05 17:00:00-04:00,0,9,17,0,1,444,3242,3686
2016-09-05 18:00:00-04:00,0,9,18,0,1,433,3805,4238
2016-09-05 19:00:00-04:00,0,9,19,0,1,457,4662,5119
2016-09-05 20:00:00-04:00,0,9,20,0,1,601,6414,7015
2016-09-05 21:00:00-04:00,0,9,21,0,1,725,8751,9476
2016-09-05 22:00:00-04:00,0,9,22,0,1,891,10076,10967
2016-09-05 23:00:00-04:00,0,9,23,0,1,1091,11826,12917
2016-09-06 00:00:00-04:00,0,9,0,1,0,1076,12586,13662
2016-09-06 01:00:00-04:00,0,9,1,1,0,1367,13572,14939
2016-09-06 02:00:00-04:00,0,9,2,1,0,1562,13623,15185
2016-09-06 03:00:00-04:00,0,9,3,1,0,1696,13737,15433
2016-09-06 04:00:00-04:00,0,9,4,1,0,1779,14660,16439
2016-09-06 05:00:00-04:00,0,9,5,1,0,1894,15504,17398
2016-09-06 06:00:00-04:00,0,9,6,1,0,1824,14579,16403
2016-09-06 07:00:00-04:00,0,9,7,1,0,1762,13576,15338
2016-09-06 08:00:00-04:00,0,9,8,1,0,1695,12843,14538
2016-09-06 09:00:00-04:00,0,9,9,1,0,1607,12096,13703
2016-09-06 10:00:00-04:00,0,9,10,1,0,1302,10203,11505
2016-09-06 11:00:00-04:00,0,9,11,1,0,903,5873,6776
2016-09-06 12:00:00-04:00,0,9,12,1,0,525,3116,3641
2016-09-06 13:00:00-04:00,0,9,13,1,0,369,2142,2511
2016-09-06 14:00:00-04:00,0,9,14,1,0,259,1466,1725
2016-09-06 15:00:00-04:00,0,9,15,1,0,276,1792,2068
2016-09-06 16:00:00-04:00,0,9,16,1,0,283,3902,4185
2016-09-06 17:00:00-04:00,0,9,17,1,0,579,9720,10299
2016-09-06 18:00:00-04:00,0,9,18,1,0,1240,15484,16724
2016-09-06 19:00:00-04:00,0,9,19,1,0,1867,18891,20758
2016-09-06 20:00:00-04:00,0,9,20,1,0,1693,17087,18780
2016-09-06 21:00:00-04:00,0,9,21,1,0,1482,15532,17014
2016-09-06 22:00:00-04:00,0,9,22,1,0,1347,15136,16483
2016-09-06 23:00:00-04:00,0.01,9,23,1,0,1384,15715,17099
2016-09-07 00:00:00-04:00,0,9,0,2,0,1296,16425,17721
2016-09-07 01:00:00-04:00,0,9,1,2,0,1535,17470,19005
2016-09-07 02:00:00-04:00,0,9,2,2,0,1838,17930,19768
2016-09-07 03:00:00-04:00,0,9,3,2,0,1955,15550,17505
2016-09-07 04:00:00-04:00,0,9,4,2,0,2170,17869,20039
2016-09-07 05:00:00-04:00,0,9,5,2,0,2479,21026,23505
2016-09-07 06:00:00-04:00,0,9,6,2,0,2220,21191,23411
2016-09-07 07:00:00-04:00,0,9,7,2,0,1875,19661,21536
2016-09-07 08:00:00-04:00,0,9,8,2,0,1717,18375,20092
2016-09-07 09:00:00-04:00,0,9,9,2,0,1636,15606,17242
2016-09-07 10:00:00-04:00,0,9,10,2,0,1361,13648,15009
2016-09-07 11:00:00-04:00,0,9,11,2,0,945,7625,8570
2016-09-07 12:00:00-04:00,0,9,12,2,0,580,4377,4957
2016-09-07 13:00:00-04:00,0,9,13,2,0,328,2718,3046
2016-09-07 14:00:00-04:00,0,9,14,2,0,236,1847,2083
2016-09-07 15:00:00-04:00,0,9,15,2,0,240,1874,2114
2016-09-07 16:00:00-04:00,0,9,16,2,0,256,3452,3708
2016-09-07 17:00:00-04:00,0,9,17,2,0,542,9793,10335
2016-09-07 18:00:00-04:00,0,9,18,2,0,1231,17096,18327
2016-09-07 19:00:00-04:00,0,9,19,2,0,1791,20211,22002
2016-09-07 20:00:00-04:00,0,9,20,2,0,1760,19268,21028
2016-09-07 21:00:00-04:00,0,9,21,2,0,1598,17503,19101
2016-09-07 22:00:00-04:00,0,9,22,2,0,1474,17117,18591
2016-09-07 23:00:00-04:00,0,9,23,2,0,1538,17701,19239
2016-09-08 00:00:00-04:00,0,9,0,3,0,1538,18142,19680
2016-09-08 01:00:00-04:00,0,9,1,3,0,1647,18971,20618
2016-09-08 02:00:00-04:00,0,9,2,3,0,1859,17748,19607
2016-09-08 03:00:00-04:00,0,9,3,3,0,1907,15553,17460
2016-09-08 04:00:00-04:00,0,9,4,3,0,2231,18502,20733
2016-09-08 05:00:00-04:00,0,9,5,3,0,2551,22209,24760
2016-09-08 06:00:00-04:00,0,9,6,3,0,2583,22818,25401
2016-09-08 07:00:00-04:00,0,9,7,3,0,2183,22256,24439
2016-09-08 08:00:00-04:00,0,9,8,3,0,1939,20978,22917
2016-09-08 09:00:00-04:00,0,9,9,3,0,1834,19209,21043
2016-09-08 10:00:00-04:00,0,9,10,3,0,1571,15142,16713
2016-09-08 11:00:00-04:00,0,9,11,3,0,1184,10131,11315
2016-09-08 12:00:00-04:00,0,9,12,3,0,800,6340,7140
2016-09-08 13:00:00-04:00,0,9,13,3,0,463,4141,4604
2016-09-08 14:00:00-04:00,0,9,14,3,0,317,2426,2743
2016-09-08 15:00:00-04:00,0,9,15,3,0,291,2382,2673
2016-09-08 16:00:00-04:00,0,9,16,3,0,293,3719,4012
2016-09-08 17:00:00-04:00,0,9,17,3,0,607,10303,10910
2016-09-08 18:00:00-04:00,0,9,18,3,0,1535,18393,19928
2016-09-08 19:00:00-04:00,0,9,19,3,0,2116,19988,22104
2016-09-08 20:00:00-04:00,0,9,20,3,0,1830,18607,20437
2016-09-08 21:00:00-04:00,0,9,21,3,0,1667,17532,19199
2016-09-08 22:00:00-04:00,0,9,22,3,0,1606,17739,19345
2016-09-08 23:00:00-04:00,0,9,23,3,0,1538,18520,20058
2016-09-09 00:00:00-04:00,0,9,0,4,0,1571,18772,20343
2016-09-09 01:00:00-04:00,0,9,1,4,0,1870,20351,22221
2016-09-09 02:00:00-04:00,0,9,2,4,0,2047,18834,20881
2016-09-09 03:00:00-04:00,0,9,3,4,0,2182,15393,17575
2016-09-09 04:00:00-04:00,0,9,4,4,0,2382,17841,20223
2016-09-09 05:00:00-04:00,0,9,5,4,0,2637,21969,24606
2016-09-09 06:00:00-04:00,0,9,6,4,0,2606,23305,25911
2016-09-09 07:00:00-04:00,0,9,7,4,0,2438,23809,26247
2016-09-09 08:00:00-04:00,0,9,8,4,0,2248,22570,24818
2016-09-09 09:00:00-04:00,0,9,9,4,0,2074,21603,23677
2016-09-09 10:00:00-04:00,0,9,10,4,0,1935,19432,21367
2016-09-09 11:00:00-04:00,0,9,11,4,0,1378,14619,15997
2016-09-09 12:00:00-04:00,0,9,12,4,0,996,8895,9891
2016-09-09 13:00:00-04:00,0,9,13,4,0,645,5937,6582
2016-09-09 14:00:00-04:00,0,9,14,4,0,448,4011,4459
2016-09-09 15:00:00-04:00,0,9,15,4,0,401,3287,3688
2016-09-09 16:00:00-04:00,0,9,16,4,0,315,4084,4399
2016-09-09 17:00:00-04:00,0,9,17,4,0,646,10491,11137
2016-09-09 18:00:00-04:00,0,9,18,4,0,1442,18030,19472
2016-09-09 19:00:00-04:00,0,9,19,4,0,2063,19536,21599
2016-09-09 20:00:00-04:00,0,9,20,4,0,1919,18557,20476
2016-09-09 21:00:00-04:00,0,9,21,4,0,1740,17688,19428
2016-09-09 22:00:00-04:00,0,9,22,4,0,1622,17793,19415
2016-09-09 23:00:00-04:00,0.04,9,23,4,0,1633,17882,19515
2016-09-10 00:00:00-04:00,0.01,9,0,5,0,1517,17403,18920
2016-09-10 01:00:00-04:00,0,9,1,5,0,1955,18812,20767
2016-09-10 02:00:00-04:00,0,9,2,5,0,2224,17247,19471
2016-09-10 03:00:00-04:00,0,9,3,5,0,2466,15275,17741
2016-09-10 04:00:00-04:00,0,9,4,5,0,2748,18228,20976
2016-09-10 05:00:00-04:00,0,9,5,5,0,3185,22303,25488
2016-09-10 06:00:00-04:00,0,9,6,5,0,3086,24155,27241
2016-09-10 07:00:00-04:00,0,9,7,5,0,3173,23509,26682
2016-09-10 08:00:00-04:00,0,9,8,5,0,2963,22225,25188
2016-09-10 09:00:00-04:00,0,9,9,5,0,2963,21809,24772
2016-09-10 10:00:00-04:00,0,9,10,5,0,2917,21748,24665
2016-09-10 11:00:00-04:00,0,9,11,5,0,2790,19898,22688
2016-09-10 12:00:00-04:00,0,9,12,5,0,2486,17390,19876
2016-09-10 13:00:00-04:00,0,9,13,5,0,2126,14433,16559
2016-09-10 14:00:00-04:00,0,9,14,5,0,1649,10697,12346
2016-09-10 15:00:00-04:00,0,9,15,5,0,1183,6753,7936
2016-09-10 16:00:00-04:00,0,9,16,5,0,577,3388,3965
2016-09-10 17:00:00-04:00,0,9,17,5,0,595,5014,5609
2016-09-10 18:00:00-04:00,0,9,18,5,0,731,7412,8143
2016-09-10 19:00:00-04:00,0,9,19,5,0,1123,11738,12861
2016-09-10 20:00:00-04:00,0,9,20,5,0,1416,15017,16433
2016-09-10 21:00:00-04:00,0,9,21,5,0,1570,16624,18194
2016-09-10 22:00:00-04:00,0,9,22,5,0,1846,18807,20653
2016-09-10 23:00:00-04:00,0,9,23,5,0,2054,19980,22034
2016-09-11 00:00:00-04:00,0,9,0,6,0,2170,20372,22542
2016-09-11 01:00:00-04:00,0,9,1,6,0,2333,20494,22827
2016-09-11 02:00:00-04:00,0,9,2,6,0,2587,20788,23375
2016-09-11 03:00:00-04:00,0,9,3,6,0,2468,18187,20655
2016-09-11 04:00:00-04:00,0,9,4,6,0,2703,19896,22599
2016-09-11 05:00:00-04:00,0,9,5,6,0,3135,22315,25450
2016-09-11 06:00:00-04:00,0,9,6,6,0,3113,22671,25784
2016-09-11 07:00:00-04:00,0,9,7,6,0,2991,19786,22777
2016-09-11 08:00:00-04:00,0,9,8,6,0,2936,18788,21724
2016-09-11 09:00:00-04:00,0,9,9,6,0,3099,20485,23584
2016-09-11 10:00:00-04:00,0,9,10,6,0,3101,20676,23777
2016-09-11 11:00:00-04:00,0,9,11,6,0,3026,19851,22877
2016-09-11 12:00:00-04:00,0,9,12,6,0,2973,18330,21303
2016-09-11 13:00:00-04:00,0,9,13,6,0,2454,15874,18328
2016-09-11 14:00:00-04:00,0,9,14,6,0,1982,12318,14300
2016-09-11 15:00:00-04:00,0,9,15,6,0,1434,7728,9162
2016-09-11 16:00:00-04:00,0,9,16,6,0,694,3654,4348
2016-09-11 17:00:00-04:00,0,9,17,6,0,573,3587,4160
2016-09-11 18:00:00-04:00,0,9,18,6,0,535,5119,5654
2016-09-11 19:00:00-04:00,0,9,19,6,0,703,7605,8308
2016-09-11 20:00:00-04:00,0,9,20,6,0,1062,11456,12518
2016-09-11 21:00:00-04:00,0,9,21,6,0,1333,15392,16725
2016-09-11 22:00:00-04:00,0,9,22,6,0,1553,17319,18872
2016-09-11 23:00:00-04:00,0,9,23,6,0,1712,18821,20533
2016-09-12 00:00:00-04:00,0,9,0,0,0,1658,17605,19263
2016-09-12 01:00:00-04:00,0,9,1,0,0,1903,18046,19949
2016-09-12 02:00:00-04:00,0,9,2,0,0,2069,17147,19216
2016-09-12 03:00:00-04:00,0,9,3,0,0,2124,17546,19670
2016-09-12 04:00:00-04:00,0,9,4,0,0,2119,17901,20020
2016-09-12 05:00:00-04:00,0,9,5,0,0,2175,18633,20808
2016-09-12 06:00:00-04:00,0,9,6,0,0,2059,17757,19816
2016-09-12 07:00:00-04:00,0,9,7,0,0,2121,17117,19238
2016-09-12 08:00:00-04:00,0,9,8,0,0,1885,15950,17835
2016-09-12 09:00:00-04:00,0,9,9,0,0,1701,13900,15601
2016-09-12 10:00:00-04:00,0,9,10,0,0,1418,11316,12734
2016-09-12 11:00:00-04:00,0,9,11,0,0,1037,7328,8365
2016-09-12 12:00:00-04:00,0,9,12,0,0,683,4564,5247
2016-09-12 13:00:00-04:00,0,9,13,0,0,439,2924,3363
2016-09-12 14:00:00-04:00,0,9,14,0,0,326,2086,2412
2016-09-12 15:00:00-04:00,0,9,15,0,0,339,2615,2954
2016-09-12 16:00:00-04:00,0,9,16,0,0,320,4166,4486
2016-09-12 17:00:00-04:00,0,9,17,0,0,518,8442,8960
2016-09-12 18:00:00-04:00,0,9,18,0,0,904,12486,13390
2016-09-12 19:00:00-04:00,0,9,19,0,0,1290,13359,14649
2016-09-12 20:00:00-04:00,0,9,20,0,0,1348,13795,15143
2016-09-12 21:00:00-04:00,0,9,21,0,0,1271,13981,15252
2016-09-12 22:00:00-04:00,0,9,22,0,0,1213,14745,15958
2016-09-12 23:00:00-04:00,0,9,23,0,0,1293,15689,16982
2016-09-13 00:00:00-04:00,0,9,0,1,0,1219,16187,17406
2016-09-13 01:00:00-04:00,0,9,1,1,0,1323,16797,18120
2016-09-13 02:00:00-04:00,0,9,2,1,0,1443,16634,18077
2016-09-13 03:00:00-04:00,0,9,3,1,0,1469,15738,17207
2016-09-13 04:00:00-04:00,0,9,4,1,0,1595,17770,19365
2016-09-13 05:00:00-04:00,0,9,5,1,0,1740,20465,22205
2016-09-13 06:00:00-04:00,0,9,6,1,0,1657,20638,22295
2016-09-13 07:00:00-04:00,0,9,7,1,0,1481,19244,20725
2016-09-13 08:00:00-04:00,0,9,8,1,0,1305,17522,18827
2016-09-13 09:00:00-04:00,0,9,9,1,0,1154,15849,17003
2016-09-13 10:00:00-04:00,0,9,10,1,0,937,13063,14000
2016-09-13 11:00:00-04:00,0,9,11,1,0,742,8714,9456
2016-09-13 12:00:00-04:00,0,9,12,1,0,470,5252,5722
2016-09-13 13:00:00-04:00,0,9,13,1,0,290,3439,3729
2016-09-13 14:00:00-04:00,0,9,14,1,0,219,2210,2429
2016-09-13 15:00:00-04:00,0,9,15,1,0,242,2548,2790
2016-09-13 16:00:00-04:00,0,9,16,1,0,262,3957,4219
2016-09-13 17:00:00-04:00,0,9,17,1,0,548,9988,10536
2016-09-13 18:00:00-04:00,0,9,18,1,0,1204,16789,17993
2016-09-13 19:00:00-04:00,0,9,19,1,0,1807,18232,20039
2016-09-13 20:00:00-04:00,0,9,20,1,0,1727,17269,18996
2016-09-13 21:00:00-04:00,0,9,21,1,0,1449,16036,17485
2016-09-13 22:00:00-04:00,0,9,22,1,0,1362,16538,17900
2016-09-13 23:00:00-04:00,0,9,23,1,0,1355,16723,18078
2016-09-14 00:00:00-04:00,0,9,0,2,0,1403,17035,18438
2016-09-14 01:00:00-04:00,0,9,1,2,0,1616,18531,20147
2016-09-14 02:00:00-04:00,0,9,2,2,0,1777,17430,19207
2016-09-14 03:00:00-04:00,0,9,3,2,0,1805,15506,17311
2016-09-14 04:00:00-04:00,0,9,4,2,0,2100,17835,19935
2016-09-14 05:00:00-04:00,0,9,5,2,0,2481,20467,22948
2016-09-14 06:00:00-04:00,0,9,6,2,0,2258,22008,24266
2016-09-14 07:00:00-04:00,0,9,7,2,0,2019,21250,23269
2016-09-14 08:00:00-04:00,0,9,8,2,0,1868,20868,22736
2016-09-14 09:00:00-04:00,0,9,9,2,0,1611,19565,21176
2016-09-14 10:00:00-04:00,0,9,10,2,0,1323,14753,16076
2016-09-14 11:00:00-04:00,0,9,11,2,0,964,9169,10133
2016-09-14 12:00:00-04:00,0,9,12,2,0,676,5736,6412
2016-09-14 13:00:00-04:00,0,9,13,2,0,400,3707,4107
2016-09-14 14:00:00-04:00,0,9,14,2,0,267,2370,2637
2016-09-14 15:00:00-04:00,0,9,15,2,0,247,2391,2638
2016-09-14 16:00:00-04:00,0,9,16,2,0,262,3790,4052
2016-09-14 17:00:00-04:00,0.23,9,17,2,0,567,9981,10548
2016-09-14 18:00:00-04:00,0.14,9,18,2,0,1285,17696,18981
2016-09-14 19:00:00-04:00,0,9,19,2,0,1902,19527,21429
2016-09-14 20:00:00-04:00,0,9,20,2,0,1812,18006,19818
2016-09-14 21:00:00-04:00,0,9,21,2,0,1490,16975,18465
2016-09-14 22:00:00-04:00,0,9,22,2,0,1446,16896,18342
2016-09-14 23:00:00-04:00,0,9,23,2,0,1447,17615,19062
2016-09-15 00:00:00-04:00,0,9,0,3,0,1480,17553,19033
2016-09-15 01:00:00-04:00,0,9,1,3,0,1769,19147,20916
2016-09-15 02:00:00-04:00,0,9,2,3,0,1920,18059,19979
2016-09-15 03:00:00-04:00,0,9,3,3,0,2078,15620,17698
2016-09-15 04:00:00-04:00,0,9,4,3,0,3324,19323,22647
2016-09-15 05:00:00-04:00,0,9,5,3,0,2988,19965,22953
2016-09-15 06:00:00-04:00,0,9,6,3,0,2661,20753,23414
2016-09-15 07:00:00-04:00,0,9,7,3,0,2334,21494,23828
2016-09-15 08:00:00-04:00,0,9,8,3,0,2078,21285,23363
2016-09-15 09:00:00-04:00,0,9,9,3,0,1813,20818,22631
2016-09-15 10:00:00-04:00,0,9,10,3,0,1609,16845,18454
2016-09-15 11:00:00-04:00,0,9,11,3,0,1198,11082,12280
2016-09-15 12:00:00-04:00,0,9,12,3,0,792,6415,7207
2016-09-15 13:00:00-04:00,0,9,13,3,0,486,4237,4723
2016-09-15 14:00:00-04:00,0,9,14,3,0,339,2789,3128
2016-09-15 15:00:00-04:00,0,9,15,3,0,274,2658,2932
2016-09-15 16:00:00-04:00,0,9,16,3,0,284,4120,4404
2016-09-15 17:00:00-04:00,0,9,17,3,0,619,10320,10939
2016-09-15 18:00:00-04:00,0,9,18,3,0,1425,18592,20017
2016-09-15 19:00:00-04:00,0,9,19,3,0,1967,20076,22043
2016-09-15 20:00:00-04:00,0,9,20,3,0,1782,17804,19586
2016-09-15 21:00:00-04:00,0,9,21,3,0,1563,16669,18232
2016-09-15 22:00:00-04:00,0,9,22,3,0,1517,16666,18183
2016-09-15 23:00:00-04:00,0,9,23,3,0,1472,17267,18739
2016-09-16 00:00:00-04:00,0,9,0,4,0,1488,17275,18763
2016-09-16 01:00:00-04:00,0,9,1,4,0,1826,18457,20283
2016-09-16 02:00:00-04:00,0,9,2,4,0,1951,17193,19144
2016-09-16 03:00:00-04:00,0,9,3,4,0,2119,14673,16792
2016-09-16 04:00:00-04:00,0,9,4,4,0,2591,17441,20032
2016-09-16 05:00:00-04:00,0,9,5,4,0,2826,21093,23919
2016-09-16 06:00:00-04:00,0,9,6,4,0,2856,22817,25673
2016-09-16 07:00:00-04:00,0,9,7,4,0,2550,23253,25803
2016-09-16 08:00:00-04:00,0,9,8,4,0,2398,22792,25190
2016-09-16 09:00:00-04:00,0,9,9,4,0,2272,21885,24157
2016-09-16 10:00:00-04:00,0,9,10,4,0,2006,19574,21580
2016-09-16 11:00:00-04:00,0,9,11,4,0,1595,15323,16918
2016-09-16 12:00:00-04:00,0,9,12,4,0,1145,9670,10815
2016-09-16 13:00:00-04:00,0,9,13,4,0,739,6390,7129
2016-09-16 14:00:00-04:00,0,9,14,4,0,546,4332,4878
2016-09-16 15:00:00-04:00,0,9,15,4,0,462,3706,4168
2016-09-16 16:00:00-04:00,0,9,16,4,0,351,4539,4890
2016-09-16 17:00:00-04:00,0,9,17,4,0,611,10148,10759
2016-09-16 18:00:00-04:00,0,9,18,4,0,1375,17233,18608
2016-09-16 19:00:00-04:00,0,9,19,4,0,1919,18776,20695
2016-09-16 20:00:00-04:00,0,9,20,4,0,1767,17230,18997
2016-09-16 21:00:00-04:00,0,9,21,4,0,1579,16157,17736
2016-09-16 22:00:00-04:00,0,9,22,4,0,1499,16663,18162
2016-09-16 23:00:00-04:00,0,9,23,4,0,1447,16969,18416
2016-09-17 00:00:00-04:00,0,9,0,5,0,1380,16667,18047
2016-09-17 01:00:00-04:00,0,9,1,5,0,1763,18006,19769
2016-09-17 02:00:00-04:00,0,9,2,5,0,2100,16261,18361
2016-09-17 03:00:00-04:00,0,9,3,5,0,2240,14248,16488
2016-09-17 04:00:00-04:00,0,9,4,5,0,2727,17825,20552
2016-09-17 05:00:00-04:00,0,9,5,5,0,3191,21661,24852
2016-09-17 06:00:00-04:00,0,9,6,5,0,3102,23604,26706
2016-09-17 07:00:00-04:00,0,9,7,5,0,2985,22443,25428
2016-09-17 08:00:00-04:00,0,9,8,5,0,2955,21455,24410
2016-09-17 09:00:00-04:00,0,9,9,5,0,2885,21657,24542
2016-09-17 10:00:00-04:00,0,9,10,5,0,2817,20775,23592
2016-09-17 11:00:00-04:00,0,9,11,5,0,2781,19090,21871
2016-09-17 12:00:00-04:00,0,9,12,5,0,2374,17076,19450
2016-09-17 13:00:00-04:00,0,9,13,5,0,2163,14349,16512
2016-09-17 14:00:00-04:00,0,9,14,5,0,1662,10952,12614
2016-09-17 15:00:00-04:00,0,9,15,5,0,1196,7197,8393
2016-09-17 16:00:00-04:00,0,9,16,5,0,643,3500,4143
2016-09-17 17:00:00-04:00,0,9,17,5,0,554,4878,5432
2016-09-17 18:00:00-04:00,0,9,18,5,0,726,7176,7902
2016-09-17 19:00:00-04:00,0,9,19,5,0,1079,11299,12378
2016-09-17 20:00:00-04:00,0,9,20,5,0,1427,14729,16156
2016-09-17 21:00:00-04:00,0,9,21,5,0,1547,16183,17730
2016-09-17 22:00:00-04:00,0,9,22,5,0,1849,17813,19662
2016-09-17 23:00:00-04:00,0,9,23,5,0,1893,18353,20246
2016-09-18 00:00:00-04:00,0,9,0,6,0,1886,18578,20464
2016-09-18 01:00:00-04:00,0,9,1,6,0,2128,18470,20598
2016-09-18 02:00:00-04:00,0,9,2,6,0,2333,18609,20942
2016-09-18 03:00:00-04:00,0,9,3,6,0,2493,16573,19066
2016-09-18 04:00:00-04:00,0,9,4,6,0,2643,18799,21442
2016-09-18 05:00:00-04:00,0,9,5,6,0,2953,21330,24283
2016-09-18 06:00:00-04:00,0,9,6,6,0,3114,22107,25221
2016-09-18 07:00:00-04:00,0,9,7,6,0,3028,20266,23294
2016-09-18 08:00:00-04:00,0,9,8,6,0,3321,19544,22865
2016-09-18 09:00:00-04:00,0,9,9,6,0,3235,19808,23043
2016-09-18 10:00:00-04:00,0,9,10,6,0,3567,18940,22507
2016-09-18 11:00:00-04:00,0,9,11,6,0,3310,18081,21391
2016-09-18 12:00:00-04:00,0,9,12,6,0,3029,16293,19322
2016-09-18 13:00:00-04:00,0,9,13,6,0,2568,14380,16948
2016-09-18 14:00:00-04:00,0,9,14,6,0,2067,11207,13274
2016-09-18 15:00:00-04:00,0,9,15,6,0,1588,7569,9157
2016-09-18 16:00:00-04:00,0,9,16,6,0,740,3705,4445
2016-09-18 17:00:00-04:00,0,9,17,6,0,605,4986,5591
2016-09-18 18:00:00-04:00,0,9,18,6,0,547,5678,6225
2016-09-18 19:00:00-04:00,0,9,19,6,0,723,9356,10079
2016-09-18 20:00:00-04:00,0,9,20,6,0,1053,12821,13874
2016-09-18 21:00:00-04:00,0,9,21,6,0,1329,15817,17146
2016-09-18 22:00:00-04:00,0,9,22,6,0,1591,17636,19227
2016-09-18 23:00:00-04:00,0,9,23,6,0,1689,18565,20254
2016-09-19 00:00:00-04:00,0,9,0,0,0,1684,18060,19744
2016-09-19 01:00:00-04:00,0,9,1,0,0,1849,17889,19738
2016-09-19 02:00:00-04:00,0,9,2,0,0,1985,17642,19627
2016-09-19 03:00:00-04:00,0,9,3,0,0,2070,17423,19493
2016-09-19 04:00:00-04:00,0,9,4,0,0,2151,17624,19775
2016-09-19 05:00:00-04:00,0.02,9,5,0,0,2228,17732,19960
2016-09-19 06:00:00-04:00,0.13,9,6,0,0,2125,16925,19050
2016-09-19 07:00:00-04:00,0.16,9,7,0,0,1990,15360,17350
2016-09-19 08:00:00-04:00,0.03,9,8,0,0,1752,14631,16383
2016-09-19 09:00:00-04:00,0.13,9,9,0,0,1630,12861,14491
2016-09-19 10:00:00-04:00,0.23,9,10,0,0,1270,10050,11320
2016-09-19 11:00:00-04:00,0.07,9,11,0,0,986,6393,7379
2016-09-19 12:00:00-04:00,0.01,9,12,0,0,636,3721,4357
2016-09-19 13:00:00-04:00,0,9,13,0,0,411,2423,2834
2016-09-19 14:00:00-04:00,0,9,14,0,0,305,1780,2085
2016-09-19 15:00:00-04:00,0,9,15,0,0,348,2378,2726
2016-09-19 16:00:00-04:00,0,9,16,0,0,356,4600,4956
2016-09-19 17:00:00-04:00,0,9,17,0,0,657,10479,11136
2016-09-19 18:00:00-04:00,0,9,18,0,0,1458,15618,17076
2016-09-19 19:00:00-04:00,0,9,19,0,0,2155,15656,17811
2016-09-19 20:00:00-04:00,0,9,20,0,0,2198,14464,16662
2016-09-19 21:00:00-04:00,0,9,21,0,0,1886,13743,15629
2016-09-19 22:00:00-04:00,0,9,22,0,0,1561,13597,15158
2016-09-19 23:00:00-04:00,0,9,23,0,0,1366,12873,14239
2016-09-20 00:00:00-04:00,0,9,0,1,0,1387,13032,14419
2016-09-20 01:00:00-04:00,0,9,1,1,0,1583,15504,17087
2016-09-20 02:00:00-04:00,0,9,2,1,0,1909,15789,17698
2016-09-20 03:00:00-04:00,0,9,3,1,0,2037,13822,15859
2016-09-20 04:00:00-04:00,0,9,4,1,0,2316,16275,18591
2016-09-20 05:00:00-04:00,0,9,5,1,0,2351,18986,21337
2016-09-20 06:00:00-04:00,0,9,6,1,0,2164,18748,20912
2016-09-20 07:00:00-04:00,0,9,7,1,0,1872,18291,20163
2016-09-20 08:00:00-04:00,0,9,8,1,0,1597,17486,19083
2016-09-20 09:00:00-04:00,0,9,9,1,0,1392,16293,17685
2016-09-20 10:00:00-04:00,0,9,10,1,0,1103,11966,13069
2016-09-20 11:00:00-04:00,0,9,11,1,0,802,7299,8101
2016-09-20 12:00:00-04:00,0,9,12,1,0,527,4340,4867
2016-09-20 13:00:00-04:00,0,9,13,1,0,351,2527,2878
2016-09-20 14:00:00-04:00,0,9,14,1,0,252,1724,1976
2016-09-20 15:00:00-04:00,0,9,15,1,0,258,1930,2188
2016-09-20 16:00:00-04:00,0,9,16,1,0,259,3693,3952
2016-09-20 17:00:00-04:00,0,9,17,1,0,576,10064,10640
2016-09-20 18:00:00-04:00,0,9,18,1,0,1393,16659,18052
2016-09-20 19:00:00-04:00,0,9,19,1,0,1975,17605,19580
2016-09-20 20:00:00-04:00,0,9,20,1,0,1824,16010,17834
2016-09-20 21:00:00-04:00,0,9,21,1,0,1507,13996,15503
2016-09-20 22:00:00-04:00,0,9,22,1,0,1384,14268,15652
2016-09-20 23:00:00-04:00,0,9,23,1,0,1369,14833,16202
2016-09-21 00:00:00-04:00,0,9,0,2,0,1385,15120,16505
2016-09-21 01:00:00-04:00,0,9,1,2,0,1673,17223,18896
2016-09-21 02:00:00-04:00,0,9,2,2,0,1801,15071,16872
2016-09-21 03:00:00-04:00,0,9,3,2,0,1883,12769,14652
2016-09-21 04:00:00-04:00,0,9,4,2,0,2201,15758,17959
2016-09-21 05:00:00-04:00,0,9,5,2,0,2536,18770,21306
2016-09-21 06:00:00-04:00,0,9,6,2,0,2504,19843,22347
2016-09-21 07:00:00-04:00,0,9,7,2,0,2099,20341,22440
2016-09-21 08:00:00-04:00,0,9,8,2,0,1967,20572,22539
2016-09-21 09:00:00-04:00,0,9,9,2,0,1690,19540,21230
2016-09-21 10:00:00-04:00,0,9,10,2,0,1468,15094,16562
2016-09-21 11:00:00-04:00,0,9,11,2,0,980,8973,9953
2016-09-21 12:00:00-04:00,0,9,12,2,0,653,5228,5881
2016-09-21 13:00:00-04:00,0,9,13,2,0,402,3396,3798
2016-09-21 14:00:00-04:00,0,9,14,2,0,276,2282,2558
2016-09-21 15:00:00-04:00,0,9,15,2,0,284,2256,2540
2016-09-21 16:00:00-04:00,0,9,16,2,0,268,3966,4234
2016-09-21 17:00:00-04:00,0,9,17,2,0,578,10404,10982
2016-09-21 18:00:00-04:00,0,9,18,2,0,1309,16697,18006
2016-09-21 19:00:00-04:00,0,9,19,2,0,1814,17456,19270
2016-09-21 20:00:00-04:00,0,9,20,2,0,1733,15439,17172
2016-09-21 21:00:00-04:00,0,9,21,2,0,1457,14434,15891
2016-09-21 22:00:00-04:00,0,9,22,2,0,1459,14097,15556
2016-09-21 23:00:00-04:00,0,9,23,2,0,1442,14558,16000
2016-09-22 00:00:00-04:00,0,9,0,3,0,1438,14715,16153
2016-09-22 01:00:00-04:00,0,9,1,3,0,1624,15268,16892
2016-09-22 02:00:00-04:00,0,9,2,3,0,1879,14539,16418
2016-09-22 03:00:00-04:00,0,9,3,3,0,1998,12711,14709
2016-09-22 04:00:00-04:00,0,9,4,3,0,2364,16558,18922
2016-09-22 05:00:00-04:00,0,9,5,3,0,2616,20323,22939
2016-09-22 06:00:00-04:00,0,9,6,3,0,2487,21431,23918
2016-09-22 07:00:00-04:00,0,9,7,3,0,2318,21972,24290
2016-09-22 08:00:00-04:00,0,9,8,3,0,2202,22026,24228
2016-09-22 09:00:00-04:00,0,9,9,3,0,1895,20416,22311
2016-09-22 10:00:00-04:00,0,9,10,3,0,1608,16433,18041
2016-09-22 11:00:00-04:00,0,9,11,3,0,1146,10642,11788
2016-09-22 12:00:00-04:00,0,9,12,3,0,748,6382,7130
2016-09-22 13:00:00-04:00,0,9,13,3,0,496,4486,4982
2016-09-22 14:00:00-04:00,0,9,14,3,0,334,2788,3122
2016-09-22 15:00:00-04:00,0,9,15,3,0,296,2587,2883
2016-09-22 16:00:00-04:00,0,9,16,3,0,299,4133,4432
2016-09-22 17:00:00-04:00,0,9,17,3,0,598,10283,10881
2016-09-22 18:00:00-04:00,0,9,18,3,0,1392,17409,18801
2016-09-22 19:00:00-04:00,0,9,19,3,0,1888,18484,20372
2016-09-22 20:00:00-04:00,0,9,20,3,0,1800,16377,18177
2016-09-22 21:00:00-04:00,0,9,21,3,0,1541,15398,16939
2016-09-22 22:00:00-04:00,0,9,22,3,0,1636,15541,17177
2016-09-22 23:00:00-04:00,0,9,23,3,0,1505,15921,17426
2016-09-23 00:00:00-04:00,0,9,0,4,0,1510,15754,17264
2016-09-23 01:00:00-04:00,0,9,1,4,0,1750,17044,18794
2016-09-23 02:00:00-04:00,0,9,2,4,0,2032,15865,17897
2016-09-23 03:00:00-04:00,0,9,3,4,0,2237,14130,16367
2016-09-23 04:00:00-04:00,0,9,4,4,0,2582,17761,20343
2016-09-23 05:00:00-04:00,0,9,5,4,0,2842,21245,24087
2016-09-23 06:00:00-04:00,0,9,6,4,0,2830,22038,24868
2016-09-23 07:00:00-04:00,0,9,7,4,0,2464,22073,24537
2016-09-23 08:00:00-04:00,0,9,8,4,0,2272,21959,24231
2016-09-23 09:00:00-04:00,0,9,9,4,0,2189,21683,23872
2016-09-23 10:00:00-04:00,0,9,10,4,0,2004,19733,21737
2016-09-23 11:00:00-04:00,0,9,11,4,0,1538,14206,15744
2016-09-23 12:00:00-04:00,0,9,12,4,0,1086,9267,10353
2016-09-23 13:00:00-04:00,0,9,13,4,0,740,6143,6883
2016-09-23 14:00:00-04:00,0,9,14,4,0,499,4123,4622
2016-09-23 15:00:00-04:00,0,9,15,4,0,409,3628,4037
2016-09-23 16:00:00-04:00,0,9,16,4,0,311,4328,4639
2016-09-23 17:00:00-04:00,0,9,17,4,0,608,10008,10616
2016-09-23 18:00:00-04:00,0,9,18,4,0,1376,16375,17751
2016-09-23 19:00:00-04:00,0,9,19,4,0,1913,17588,19501
2016-09-23 20:00:00-04:00,0,9,20,4,0,1724,16164,17888
2016-09-23 21:00:00-04:00,0,9,21,4,0,1571,15006,16577
2016-09-23 22:00:00-04:00,0,9,22,4,0,1451,15761,17212
2016-09-23 23:00:00-04:00,0,9,23,4,0,1430,16278,17708
2016-09-24 00:00:00-04:00,0.15,9,0,5,0,1448,16319,17767
2016-09-24 01:00:00-04:00,0.25,9,1,5,0,1819,17539,19358
2016-09-24 02:00:00-04:00,0.02,9,2,5,0,2129,15694,17823
2016-09-24 03:00:00-04:00,0,9,3,5,0,2358,13544,15902
2016-09-24 04:00:00-04:00,0,9,4,5,0,2868,16862,19730
2016-09-24 05:00:00-04:00,0.02,9,5,5,0,3282,20948,24230
2016-09-24 06:00:00-04:00,0,9,6,5,0,3471,23316,26787
2016-09-24 07:00:00-04:00,0,9,7,5,0,3095,21957,25052
2016-09-24 08:00:00-04:00,0,9,8,5,0,2976,20982,23958
2016-09-24 09:00:00-04:00,0,9,9,5,0,3096,22029,25125
2016-09-24 10:00:00-04:00,0,9,10,5,0,3143,21580,24723
2016-09-24 11:00:00-04:00,0,9,11,5,0,3264,20712,23976
2016-09-24 12:00:00-04:00,0,9,12,5,0,2994,18430,21424
2016-09-24 13:00:00-04:00,0,9,13,5,0,2197,14168,16365
2016-09-24 14:00:00-04:00,0,9,14,5,0,1755,10414,12169
2016-09-24 15:00:00-04:00,0,9,15,5,0,1332,6847,8179
2016-09-24 16:00:00-04:00,0,9,16,5,0,729,3526,4255
2016-09-24 17:00:00-04:00,0,9,17,5,0,579,4716,5295
2016-09-24 18:00:00-04:00,0,9,18,5,0,784,7647,8431
2016-09-24 19:00:00-04:00,0,9,19,5,0,1034,11167,12201
2016-09-24 20:00:00-04:00,0,9,20,5,0,1384,14485,15869
2016-09-24 21:00:00-04:00,0,9,21,5,0,1567,16798,18365
2016-09-24 22:00:00-04:00,0,9,22,5,0,1687,18026,19713
2016-09-24 23:00:00-04:00,0,9,23,5,0,1830,18959,20789
2016-09-25 00:00:00-04:00,0,9,0,6,0,1762,18550,20312
2016-09-25 01:00:00-04:00,0,9,1,6,0,2024,18340,20364
2016-09-25 02:00:00-04:00,0,9,2,6,0,2292,17821,20113
2016-09-25 03:00:00-04:00,0,9,3,6,0,2363,15483,17846
2016-09-25 04:00:00-04:00,0,9,4,6,0,2578,17378,19956
2016-09-25 05:00:00-04:00,0,9,5,6,0,2918,20150,23068
2016-09-25 06:00:00-04:00,0,9,6,6,0,3156,21855,25011
2016-09-25 07:00:00-04:00,0,9,7,6,0,2948,19601,22549
2016-09-25 08:00:00-04:00,0,9,8,6,0,3036,19468,22504
2016-09-25 09:00:00-04:00,0,9,9,6,0,3196,21385,24581
2016-09-25 10:00:00-04:00,0,9,10,6,0,3432,22255,25687
2016-09-25 11:00:00-04:00,0,9,11,6,0,3215,20559,23774
2016-09-25 12:00:00-04:00,0,9,12,6,0,2906,18701,21607
2016-09-25 13:00:00-04:00,0,9,13,6,0,2515,16104,18619
2016-09-25 14:00:00-04:00,0,9,14,6,0,2039,12478,14517
2016-09-25 15:00:00-04:00,0,9,15,6,0,1520,7861,9381
2016-09-25 16:00:00-04:00,0,9,16,6,0,800,3694,4494
2016-09-25 17:00:00-04:00,0,9,17,6,0,573,4417,4990
2016-09-25 18:00:00-04:00,0,9,18,6,0,627,6153,6780
2016-09-25 19:00:00-04:00,0,9,19,6,0,748,8142,8890
2016-09-25 20:00:00-04:00,0,9,20,6,0,1061,11472,12533
2016-09-25 21:00:00-04:00,0,9,21,6,0,1354,15174,16528
2016-09-25 22:00:00-04:00,0,9,22,6,0,1549,17136,18685
2016-09-25 23:00:00-04:00,0,9,23,6,0,1633,18358,19991
2016-09-26 00:00:00-04:00,0,9,0,0,0,1636,17994,19630
2016-09-26 01:00:00-04:00,0,9,1,0,0,1763,17579,19342
2016-09-26 02:00:00-04:00,0,9,2,0,0,1879,17291,19170
2016-09-26 03:00:00-04:00,0,9,3,0,0,1990,17048,19038
2016-09-26 04:00:00-04:00,0,9,4,0,0,2053,18043,20096
2016-09-26 05:00:00-04:00,0,9,5,0,0,2126,18100,20226
2016-09-26 06:00:00-04:00,0,9,6,0,0,2151,18053,20204
2016-09-26 07:00:00-04:00,0,9,7,0,0,1979,15730,17709
2016-09-26 08:00:00-04:00,0,9,8,0,0,1885,14696,16581
2016-09-26 09:00:00-04:00,0,9,9,0,0,1627,13316,14943
2016-09-26 10:00:00-04:00,0,9,10,0,0,1327,9692,11019
2016-09-26 11:00:00-04:00,0,9,11,0,0,991,6104,7095
2016-09-26 12:00:00-04:00,0,9,12,0,0,638,3641,4279
2016-09-26 13:00:00-04:00,0,9,13,0,0,460,2426,2886
2016-09-26 14:00:00-04:00,0,9,14,0,0,334,1728,2062
2016-09-26 15:00:00-04:00,0,9,15,0,0,369,2314,2683
2016-09-26 16:00:00-04:00,0,9,16,0,0,365,4414,4779
2016-09-26 17:00:00-04:00,0,9,17,0,0,570,9801,10371
2016-09-26 18:00:00-04:00,0,9,18,0,0,1441,16217,17658
2016-09-26 19:00:00-04:00,0,9,19,0,0,1877,17431,19308
2016-09-26 20:00:00-04:00,0,9,20,0,0,1701,15873,17574
2016-09-26 21:00:00-04:00,0,9,21,0,0,1537,14502,16039
2016-09-26 22:00:00-04:00,0,9,22,0,0,1414,14678,16092
2016-09-26 23:00:00-04:00,0,9,23,0,0,1378,15179,16557
2016-09-27 00:00:00-04:00,0,9,0,1,0,1352,15231,16583
2016-09-27 01:00:00-04:00,0,9,1,1,0,1576,17096,18672
2016-09-27 02:00:00-04:00,0.04,9,2,1,0,1848,17197,19045
2016-09-27 03:00:00-04:00,0.07,9,3,1,0,1887,15835,17722
2016-09-27 04:00:00-04:00,0.02,9,4,1,0,2098,19106,21204
2016-09-27 05:00:00-04:00,0.01,9,5,1,0,2344,21869,24213
2016-09-27 06:00:00-04:00,0.0001,9,6,1,0,2151,22216,24367
2016-09-27 07:00:00-04:00,0.01,9,7,1,0,1996,23157,25153
2016-09-27 08:00:00-04:00,0,9,8,1,0,1444,15714,17158
2016-09-27 09:00:00-04:00,0,9,9,1,0,1253,15374,16627
2016-09-27 10:00:00-04:00,0,9,10,1,0,1141,13896,15037
2016-09-27 11:00:00-04:00,0,9,11,1,0,823,7228,8051
2016-09-27 12:00:00-04:00,0,9,12,1,0,549,4174,4723
2016-09-27 13:00:00-04:00,0,9,13,1,0,399,2661,3060
2016-09-27 14:00:00-04:00,0,9,14,1,0,240,1676,1916
2016-09-27 15:00:00-04:00,0,9,15,1,0,234,1683,1917
2016-09-27 16:00:00-04:00,0,9,16,1,0,240,3663,3903
2016-09-27 17:00:00-04:00,0,9,17,1,0,544,10509,11053
2016-09-27 18:00:00-04:00,0,9,18,1,0,1251,17584,18835
2016-09-27 19:00:00-04:00,0,9,19,1,0,1861,19391,21252
2016-09-27 20:00:00-04:00,0,9,20,1,0,1647,17747,19394
2016-09-27 21:00:00-04:00,0,9,21,1,0,1519,16030,17549
2016-09-27 22:00:00-04:00,0,9,22,1,0,1332,15795,17127
2016-09-27 23:00:00-04:00,0,9,23,1,0,1317,16246,17563
2016-09-28 00:00:00-04:00,0,9,0,2,0,1380,16176,17556
2016-09-28 01:00:00-04:00,0,9,1,2,0,1586,17187,18773
2016-09-28 02:00:00-04:00,0,9,2,2,0,1711,17009,18720
2016-09-28 03:00:00-04:00,0,9,3,2,0,1758,15278,17036
2016-09-28 04:00:00-04:00,0,9,4,2,0,2157,18991,21148
2016-09-28 05:00:00-04:00,0,9,5,2,0,2596,22839,25435
2016-09-28 06:00:00-04:00,0,9,6,2,0,2396,22962,25358
2016-09-28 07:00:00-04:00,0,9,7,2,0,2036,22427,24463
2016-09-28 08:00:00-04:00,0,9,8,2,0,1883,22162,24045
2016-09-28 09:00:00-04:00,0,9,9,2,0,1640,18867,20507
2016-09-28 10:00:00-04:00,0,9,10,2,0,1311,13727,15038
2016-09-28 11:00:00-04:00,0,9,11,2,0,922,8395,9317
2016-09-28 12:00:00-04:00,0,9,12,2,0,658,4923,5581
2016-09-28 13:00:00-04:00,0,9,13,2,0,375,3129,3504
2016-09-28 14:00:00-04:00,0,9,14,2,0,287,2171,2458
2016-09-28 15:00:00-04:00,0,9,15,2,0,264,2049,2313
2016-09-28 16:00:00-04:00,0,9,16,2,0,253,3625,3878
2016-09-28 17:00:00-04:00,0,9,17,2,0,560,10074,10634
2016-09-28 18:00:00-04:00,0,9,18,2,0,1237,17672,18909
2016-09-28 19:00:00-04:00,0,9,19,2,0,1860,19841,21701
2016-09-28 20:00:00-04:00,0,9,20,2,0,1683,18144,19827
2016-09-28 21:00:00-04:00,0,9,21,2,0,1470,16461,17931
2016-09-28 22:00:00-04:00,0,9,22,2,0,1463,16566,18029
2016-09-28 23:00:00-04:00,0,9,23,2,0,1458,17312,18770
2016-09-29 00:00:00-04:00,0,9,0,3,0,1453,16770,18223
2016-09-29 01:00:00-04:00,0,9,1,3,0,1699,18070,19769
2016-09-29 02:00:00-04:00,0,9,2,3,0,1840,17146,18986
2016-09-29 03:00:00-04:00,0,9,3,3,0,2094,15138,17232
2016-09-29 04:00:00-04:00,0,9,4,3,0,2523,19204,21727
2016-09-29 05:00:00-04:00,0,9,5,3,0,2792,23202,25994
2016-09-29 06:00:00-04:00,0,9,6,3,0,3085,25350,28435
2016-09-29 07:00:00-04:00,0,9,7,3,0,2640,24291,26931
2016-09-29 08:00:00-04:00,0,9,8,3,0,2441,24112,26553
2016-09-29 09:00:00-04:00,0,9,9,3,0,2084,21164,23248
2016-09-29 10:00:00-04:00,0,9,10,3,0,1671,15880,17551
2016-09-29 11:00:00-04:00,0,9,11,3,0,1173,10227,11400
2016-09-29 12:00:00-04:00,0,9,12,3,0,749,5942,6691
2016-09-29 13:00:00-04:00,0,9,13,3,0,449,3623,4072
2016-09-29 14:00:00-04:00,0,9,14,3,0,322,2413,2735
2016-09-29 15:00:00-04:00,0,9,15,3,0,284,2231,2515
2016-09-29 16:00:00-04:00,0,9,16,3,0,263,3692,3955
2016-09-29 17:00:00-04:00,0,9,17,3,0,585,10160,10745
2016-09-29 18:00:00-04:00,0,9,18,3,0,1451,17758,19209
2016-09-29 19:00:00-04:00,0,9,19,3,0,1993,20342,22335
2016-09-29 20:00:00-04:00,0,9,20,3,0,1863,18295,20158
2016-09-29 21:00:00-04:00,0,9,21,3,0,1568,16842,18410
2016-09-29 22:00:00-04:00,0,9,22,3,0,1514,17156,18670
2016-09-29 23:00:00-04:00,0,9,23,3,0,1532,17578,19110
2016-09-30 00:00:00-04:00,0,9,0,4,0,1544,17380,18924
2016-09-30 01:00:00-04:00,0,9,1,4,0,1789,18418,20207
2016-09-30 02:00:00-04:00,0,9,2,4,0,1911,17730,19641
2016-09-30 03:00:00-04:00,0,9,3,4,0,2260,15098,17358
2016-09-30 04:00:00-04:00,0,9,4,4,0,2643,18693,21336
2016-09-30 05:00:00-04:00,0,9,5,4,0,2833,21963,24796
2016-09-30 06:00:00-04:00,0,9,6,4,0,2853,23265,26118
2016-09-30 07:00:00-04:00,0,9,7,4,0,2501,24039,26540
2016-09-30 08:00:00-04:00,0,9,8,4,0,2390,23661,26051
2016-09-30 09:00:00-04:00,0,9,9,4,0,2247,22542,24789
2016-09-30 10:00:00-04:00,0.01,9,10,4,0,1896,18842,20738
2016-09-30 11:00:00-04:00,0.01,9,11,4,0,1518,13765,15283
2016-09-30 12:00:00-04:00,0.05,9,12,4,0,1069,9120,10189
2016-09-30 13:00:00-04:00,0.07,9,13,4,0,707,5771,6478
2016-09-30 14:00:00-04:00,0.08,9,14,4,0,524,3929,4453
2016-09-30 15:00:00-04:00,0.04,9,15,4,0,398,3406,3804
2016-09-30 16:00:00-04:00,0,9,16,4,0,322,4517,4839
2016-09-30 17:00:00-04:00,0,9,17,4,0,691,10648,11339
2016-09-30 18:00:00-04:00,0.01,9,18,4,0,1538,18142,19680
2016-09-30 19:00:00-04:00,0.03,9,19,4,0,2101,20336,22437
2016-09-30 20:00:00-04:00,0.03,9,20,4,0,2166,18580,20746
2016-09-30 21:00:00-04:00,0.02,9,21,4,0,1880,17384,19264
2016-09-30 22:00:00-04:00,0.04,9,22,4,0,1797,17279,19076
2016-09-30 23:00:00-04:00,0,9,23,4,0,1752,17506,19258
2016-10-01 00:00:00-04:00,0,10,0,5,0,1804,17050,18854
2016-10-01 01:00:00-04:00,0,10,1,5,0,2291,19397,21688
2016-10-01 02:00:00-04:00,0,10,2,5,0,2596,16100,18696
2016-10-01 03:00:00-04:00,0,10,3,5,0,2727,13737,16464
2016-10-01 04:00:00-04:00,0,10,4,5,0,3352,17223,20575
2016-10-01 05:00:00-04:00,0,10,5,5,0,3617,20648,24265
2016-10-01 06:00:00-04:00,0,10,6,5,0,3730,22487,26217
2016-10-01 07:00:00-04:00,0,10,7,5,0,3492,21991,25483
2016-10-01 08:00:00-04:00,0,10,8,5,0,2997,20989,23986
2016-10-01 09:00:00-04:00,0,10,9,5,0,3047,21353,24400
2016-10-01 10:00:00-04:00,0,10,10,5,0,2864,20596,23460
2016-10-01 11:00:00-04:00,0,10,11,5,0,2562,19057,21619
2016-10-01 12:00:00-04:00,0,10,12,5,0,2649,18357,21006
2016-10-01 13:00:00-04:00,0,10,13,5,0,1921,13038,14959
2016-10-01 14:00:00-04:00,0,10,14,5,0,1583,10394,11977
2016-10-01 15:00:00-04:00,0,10,15,5,0,1167,6521,7688
2016-10-01 16:00:00-04:00,0,10,16,5,0,605,3329,3934
2016-10-01 17:00:00-04:00,0,10,17,5,0,597,4671,5268
2016-10-01 18:00:00-04:00,0,10,18,5,0,717,7155,7872
2016-10-01 19:00:00-04:00,0,10,19,5,0,1053,10405,11458
2016-10-01 20:00:00-04:00,0,10,20,5,0,1507,14308,15815
2016-10-01 21:00:00-04:00,0,10,21,5,0,1664,16190,17854
2016-10-01 22:00:00-04:00,0,10,22,5,0,1922,17610,19532
2016-10-01 23:00:00-04:00,0,10,23,5,0,2116,18409,20525
2016-10-02 00:00:00-04:00,0,10,0,6,0,2076,18517,20593
2016-10-02 01:00:00-04:00,0,10,1,6,0,2342,18369,20711
2016-10-02 02:00:00-04:00,0,10,2,6,0,2553,18084,20637
2016-10-02 03:00:00-04:00,0,10,3,6,0,2597,16109,18706
2016-10-02 04:00:00-04:00,0,10,4,6,0,2780,18308,21088
2016-10-02 05:00:00-04:00,0,10,5,6,0,2871,19598,22469
2016-10-02 06:00:00-04:00,0,10,6,6,0,3070,20973,24043
2016-10-02 07:00:00-04:00,0,10,7,6,0,2896,18365,21261
2016-10-02 08:00:00-04:00,0,10,8,6,0,3050,17726,20776
2016-10-02 09:00:00-04:00,0,10,9,6,0,3331,21131,24462
2016-10-02 10:00:00-04:00,0,10,10,6,0,3244,21462,24706
2016-10-02 11:00:00-04:00,0,10,11,6,0,3079,20153,23232
2016-10-02 12:00:00-04:00,0,10,12,6,0,2832,17662,20494
2016-10-02 13:00:00-04:00,0,10,13,6,0,2343,14910,17253
2016-10-02 14:00:00-04:00,0,10,14,6,0,2030,11656,13686
2016-10-02 15:00:00-04:00,0,10,15,6,0,1551,7609,9160
2016-10-02 16:00:00-04:00,0,10,16,6,0,780,3318,4098
2016-10-02 17:00:00-04:00,0,10,17,6,0,580,3882,4462
2016-10-02 18:00:00-04:00,0,10,18,6,0,547,5430,5977
2016-10-02 19:00:00-04:00,0,10,19,6,0,741,7336,8077
2016-10-02 20:00:00-04:00,0,10,20,6,0,1025,11360,12385
2016-10-02 21:00:00-04:00,0,10,21,6,0,1386,15499,16885
2016-10-02 22:00:00-04:00,0,10,22,6,0,1518,17112,18630
2016-10-02 23:00:00-04:00,0,10,23,6,0,1675,17809,19484
2016-10-03 00:00:00-04:00,0,10,0,0,0,1760,17369,19129
2016-10-03 01:00:00-04:00,0,10,1,0,0,2025,17444,19469
2016-10-03 02:00:00-04:00,0,10,2,0,0,2109,16392,18501
2016-10-03 03:00:00-04:00,0,10,3,0,0,2164,15533,17697
2016-10-03 04:00:00-04:00,0,10,4,0,0,2190,17184,19374
2016-10-03 05:00:00-04:00,0,10,5,0,0,2160,17351,19511
2016-10-03 06:00:00-04:00,0,10,6,0,0,2074,16245,18319
2016-10-03 07:00:00-04:00,0,10,7,0,0,1959,14352,16311
2016-10-03 08:00:00-04:00,0,10,8,0,0,1824,14641,16465
2016-10-03 09:00:00-04:00,0,10,9,0,0,1770,13703,15473
2016-10-03 10:00:00-04:00,0,10,10,0,0,1515,10885,12400
2016-10-03 11:00:00-04:00,0,10,11,0,0,1078,6272,7350
2016-10-03 12:00:00-04:00,0,10,12,0,0,713,3460,4173
2016-10-03 13:00:00-04:00,0,10,13,0,0,487,2309,2796
2016-10-03 14:00:00-04:00,0,10,14,0,0,358,1754,2112
2016-10-03 15:00:00-04:00,0,10,15,0,0,384,2239,2623
2016-10-03 16:00:00-04:00,0,10,16,0,0,358,3952,4310
2016-10-03 17:00:00-04:00,0,10,17,0,0,493,8086,8579
2016-10-03 18:00:00-04:00,0,10,18,0,0,982,12286,13268
2016-10-03 19:00:00-04:00,0,10,19,0,0,1661,14950,16611
2016-10-03 20:00:00-04:00,0,10,20,0,0,1762,15722,17484
2016-10-03 21:00:00-04:00,0,10,21,0,0,1556,14867,16423
2016-10-03 22:00:00-04:00,0,10,22,0,0,1439,14077,15516
2016-10-03 23:00:00-04:00,0,10,23,0,0,1323,14519,15842
2016-10-04 00:00:00-04:00,0,10,0,1,0,1353,15409,16762
2016-10-04 01:00:00-04:00,0,10,1,1,0,1512,15776,17288
2016-10-04 02:00:00-04:00,0,10,2,1,0,1713,15573,17286
2016-10-04 03:00:00-04:00,0,10,3,1,0,1789,14814,16603
2016-10-04 04:00:00-04:00,0,10,4,1,0,2019,16916,18935
2016-10-04 05:00:00-04:00,0,10,5,1,0,2078,19332,21410
2016-10-04 06:00:00-04:00,0,10,6,1,0,2102,18677,20779
2016-10-04 07:00:00-04:00,0,10,7,1,0,1724,17085,18809
2016-10-04 08:00:00-04:00,0,10,8,1,0,1559,15715,17274
2016-10-04 09:00:00-04:00,0,10,9,1,0,1353,13924,15277
2016-10-04 10:00:00-04:00,0,10,10,1,0,1187,10843,12030
2016-10-04 11:00:00-04:00,0,10,11,1,0,800,6354,7154
2016-10-04 12:00:00-04:00,0,10,12,1,0,545,3784,4329
2016-10-04 13:00:00-04:00,0,10,13,1,0,382,2400,2782
2016-10-04 14:00:00-04:00,0,10,14,1,0,249,1659,1908
2016-10-04 15:00:00-04:00,0,10,15,1,0,227,1734,1961
2016-10-04 16:00:00-04:00,0,10,16,1,0,240,3365,3605
2016-10-04 17:00:00-04:00,0,10,17,1,0,505,8836,9341
2016-10-04 18:00:00-04:00,0,10,18,1,0,977,14591,15568
2016-10-04 19:00:00-04:00,0,10,19,1,0,1580,16671,18251
2016-10-04 20:00:00-04:00,0,10,20,1,0,1619,16674,18293
2016-10-04 21:00:00-04:00,0,10,21,1,0,1485,15573,17058
2016-10-04 22:00:00-04:00,0,10,22,1,0,1381,15468,16849
2016-10-04 23:00:00-04:00,0,10,23,1,0,1349,15626,16975
2016-10-05 00:00:00-04:00,0,10,0,2,0,1398,15930,17328
2016-10-05 01:00:00-04:00,0,10,1,2,0,1471,16728,18199
2016-10-05 02:00:00-04:00,0,10,2,2,0,1662,16751,18413
2016-10-05 03:00:00-04:00,0,10,3,2,0,1874,15293,17167
2016-10-05 04:00:00-04:00,0,10,4,2,0,2104,18261,20365
2016-10-05 05:00:00-04:00,0,10,5,2,0,2366,21494,23860
2016-10-05 06:00:00-04:00,0,10,6,2,0,2287,21680,23967
2016-10-05 07:00:00-04:00,0,10,7,2,0,2057,21013,23070
2016-10-05 08:00:00-04:00,0,10,8,2,0,1748,19546,21294
2016-10-05 09:00:00-04:00,0,10,9,2,0,1476,17226,18702
2016-10-05 10:00:00-04:00,0,10,10,2,0,1258,12898,14156
2016-10-05 11:00:00-04:00,0,10,11,2,0,894,8201,9095
2016-10-05 12:00:00-04:00,0,10,12,2,0,615,4571,5186
2016-10-05 13:00:00-04:00,0,10,13,2,0,394,3009,3403
2016-10-05 14:00:00-04:00,0,10,14,2,0,294,2007,2301
2016-10-05 15:00:00-04:00,0,10,15,2,0,256,2010,2266
2016-10-05 16:00:00-04:00,0,10,16,2,0,249,3723,3972
2016-10-05 17:00:00-04:00,0,10,17,2,0,571,9893,10464
2016-10-05 18:00:00-04:00,0,10,18,2,0,1317,18020,19337
2016-10-05 19:00:00-04:00,0,10,19,2,0,1918,19972,21890
2016-10-05 20:00:00-04:00,0,10,20,2,0,1827,18341,20168
2016-10-05 21:00:00-04:00,0,10,21,2,0,1545,16378,17923
2016-10-05 22:00:00-04:00,0,10,22,2,0,1501,16911,18412
2016-10-05 23:00:00-04:00,0,10,23,2,0,1477,16999,18476
2016-10-06 00:00:00-04:00,0,10,0,3,0,1513,16969,18482
2016-10-06 01:00:00-04:00,0,10,1,3,0,1698,18018,19716
2016-10-06 02:00:00-04:00,0,10,2,3,0,1757,17914,19671
2016-10-06 03:00:00-04:00,0,10,3,3,0,2049,15522,17571
2016-10-06 04:00:00-04:00,0,10,4,3,0,2480,19291,21771
2016-10-06 05:00:00-04:00,0,10,5,3,0,2765,22898,25663
2016-10-06 06:00:00-04:00,0,10,6,3,0,2740,23649,26389
2016-10-06 07:00:00-04:00,0,10,7,3,0,2462,23514,25976
2016-10-06 08:00:00-04:00,0,10,8,3,0,2053,22570,24623
2016-10-06 09:00:00-04:00,0,10,9,3,0,1831,20304,22135
2016-10-06 10:00:00-04:00,0,10,10,3,0,1743,17406,19149
2016-10-06 11:00:00-04:00,0,10,11,3,0,1260,10767,12027
2016-10-06 12:00:00-04:00,0,10,12,3,0,794,5976,6770
2016-10-06 13:00:00-04:00,0,10,13,3,0,499,3705,4204
2016-10-06 14:00:00-04:00,0,10,14,3,0,349,2395,2744
2016-10-06 15:00:00-04:00,0,10,15,3,0,302,2381,2683
2016-10-06 16:00:00-04:00,0,10,16,3,0,309,3881,4190
2016-10-06 17:00:00-04:00,0,10,17,3,0,567,10214,10781
2016-10-06 18:00:00-04:00,0,10,18,3,0,1357,18233,19590
2016-10-06 19:00:00-04:00,0,10,19,3,0,1892,20123,22015
2016-10-06 20:00:00-04:00,0,10,20,3,0,1821,18578,20399
2016-10-06 21:00:00-04:00,0,10,21,3,0,1644,17364,19008
2016-10-06 22:00:00-04:00,0,10,22,3,0,1525,17249,18774
2016-10-06 23:00:00-04:00,0,10,23,3,0,1592,17980,19572
2016-10-07 00:00:00-04:00,0,10,0,4,0,1584,17791,19375
2016-10-07 01:00:00-04:00,0,10,1,4,0,1779,18999,20778
2016-10-07 02:00:00-04:00,0,10,2,4,0,1976,18140,20116
2016-10-07 03:00:00-04:00,0,10,3,4,0,2214,15302,17516
2016-10-07 04:00:00-04:00,0,10,4,4,0,2597,18383,20980
2016-10-07 05:00:00-04:00,0,10,5,4,0,2869,22002,24871
2016-10-07 06:00:00-04:00,0,10,6,4,0,2921,23422,26343
2016-10-07 07:00:00-04:00,0,10,7,4,0,2492,23729,26221
2016-10-07 08:00:00-04:00,0,10,8,4,0,2423,23098,25521
2016-10-07 09:00:00-04:00,0,10,9,4,0,2156,21665,23821
2016-10-07 10:00:00-04:00,0,10,10,4,0,1903,19162,21065
2016-10-07 11:00:00-04:00,0,10,11,4,0,1523,13684,15207
2016-10-07 12:00:00-04:00,0,10,12,4,0,1145,8828,9973
2016-10-07 13:00:00-04:00,0,10,13,4,0,738,6046,6784
2016-10-07 14:00:00-04:00,0,10,14,4,0,457,4017,4474
2016-10-07 15:00:00-04:00,0,10,15,4,0,395,3592,3987
2016-10-07 16:00:00-04:00,0,10,16,4,0,310,4344,4654
2016-10-07 17:00:00-04:00,0,10,17,4,0,589,10143,10732
2016-10-07 18:00:00-04:00,0,10,18,4,0,1324,17663,18987
2016-10-07 19:00:00-04:00,0,10,19,4,0,1911,19595,21506
2016-10-07 20:00:00-04:00,0,10,20,4,0,1895,18493,20388
2016-10-07 21:00:00-04:00,0,10,21,4,0,1618,16805,18423
2016-10-07 22:00:00-04:00,0,10,22,4,0,1574,16938,18512
2016-10-07 23:00:00-04:00,0,10,23,4,0,1555,17521,19076
2016-10-08 00:00:00-04:00,0,10,0,5,0,1593,16906,18499
2016-10-08 01:00:00-04:00,0,10,1,5,0,1970,18271,20241
2016-10-08 02:00:00-04:00,0,10,2,5,0,2229,16686,18915
2016-10-08 03:00:00-04:00,0,10,3,5,0,2494,14187,16681
2016-10-08 04:00:00-04:00,0,10,4,5,0,2870,17791,20661
2016-10-08 05:00:00-04:00,0,10,5,5,0,3162,20459,23621
2016-10-08 06:00:00-04:00,0,10,6,5,0,3270,21610,24880
2016-10-08 07:00:00-04:00,0,10,7,5,0,3088,20225,23313
2016-10-08 08:00:00-04:00,0,10,8,5,0,2946,20265,23211
2016-10-08 09:00:00-04:00,0,10,9,5,0,2946,21147,24093
2016-10-08 10:00:00-04:00,0,10,10,5,0,3011,21160,24171
2016-10-08 11:00:00-04:00,0,10,11,5,0,2833,19788,22621
2016-10-08 12:00:00-04:00,0,10,12,5,0,2509,17718,20227
2016-10-08 13:00:00-04:00,0,10,13,5,0,2162,14735,16897
2016-10-08 14:00:00-04:00,0.01,10,14,5,0,1807,10606,12413
2016-10-08 15:00:00-04:00,0,10,15,5,0,1382,7076,8458
2016-10-08 16:00:00-04:00,0,10,16,5,0,766,3935,4701
2016-10-08 17:00:00-04:00,0,10,17,5,0,690,5380,6070
2016-10-08 18:00:00-04:00,0.07,10,18,5,0,798,7006,7804
2016-10-08 19:00:00-04:00,0.02,10,19,5,0,1204,10724,11928
2016-10-08 20:00:00-04:00,0.02,10,20,5,0,1519,14464,15983
2016-10-08 21:00:00-04:00,0.02,10,21,5,0,1786,16129,17915
2016-10-08 22:00:00-04:00,0,10,22,5,0,1923,18054,19977
2016-10-08 23:00:00-04:00,0,10,23,5,0,2027,18801,20828
2016-10-09 00:00:00-04:00,0,10,0,6,0,2206,21173,23379
2016-10-09 01:00:00-04:00,0,10,1,6,0,2528,21765,24293
2016-10-09 02:00:00-04:00,0.02,10,2,6,0,2673,18568,21241
2016-10-09 03:00:00-04:00,0.01,10,3,6,0,2510,15939,18449
2016-10-09 04:00:00-04:00,0.03,10,4,6,0,2941,18197,21138
2016-10-09 05:00:00-04:00,0.03,10,5,6,0,3320,22030,25350
2016-10-09 06:00:00-04:00,0.04,10,6,6,0,3573,21822,25395
2016-10-09 07:00:00-04:00,0.03,10,7,6,0,3128,17803,20931
2016-10-09 08:00:00-04:00,0.02,10,8,6,0,2902,17171,20073
2016-10-09 09:00:00-04:00,0.02,10,9,6,0,2947,19303,22250
2016-10-09 10:00:00-04:00,0.02,10,10,6,0,3027,19901,22928
2016-10-09 11:00:00-04:00,0.06,10,11,6,0,2893,19620,22513
2016-10-09 12:00:00-04:00,0.12,10,12,6,0,2652,17658,20310
2016-10-09 13:00:00-04:00,0.08,10,13,6,0,2252,15181,17433
2016-10-09 14:00:00-04:00,0,10,14,6,0,1886,11754,13640
2016-10-09 15:00:00-04:00,0,10,15,6,0,1482,7422,8904
2016-10-09 16:00:00-04:00,0,10,16,6,0,707,3404,4111
2016-10-09 17:00:00-04:00,0,10,17,6,0,606,4509,5115
2016-10-09 18:00:00-04:00,0,10,18,6,0,600,5206,5806
2016-10-09 19:00:00-04:00,0,10,19,6,0,833,8304,9137
2016-10-09 20:00:00-04:00,0,10,20,6,0,1247,12766,14013
2016-10-09 21:00:00-04:00,0,10,21,6,0,1599,17026,18625
2016-10-09 22:00:00-04:00,0,10,22,6,0,1971,19626,21597
2016-10-09 23:00:00-04:00,0,10,23,6,0,2320,20503,22823
2016-10-10 00:00:00-04:00,0,10,0,0,1,1979,17492,19471
2016-10-10 01:00:00-04:00,0,10,1,0,1,1996,16247,18243
2016-10-10 02:00:00-04:00,0,10,2,0,1,2101,15419,17520
2016-10-10 03:00:00-04:00,0,10,3,0,1,2021,15241,17262
2016-10-10 04:00:00-04:00,0,10,4,0,1,2041,15800,17841
2016-10-10 05:00:00-04:00,0,10,5,0,1,2107,17375,19482
2016-10-10 06:00:00-04:00,0,10,6,0,1,2262,16959,19221
2016-10-10 07:00:00-04:00,0,10,7,0,1,2161,16594,18755
2016-10-10 08:00:00-04:00,0,10,8,0,1,1731,12958,14689
2016-10-10 09:00:00-04:00,0,10,9,0,1,1761,13251,15012
2016-10-10 10:00:00-04:00,0,10,10,0,1,1708,13311,15019
2016-10-10 11:00:00-04:00,0,10,11,0,1,1270,7652,8922
2016-10-10 12:00:00-04:00,0,10,12,0,1,842,4819,5661
2016-10-10 13:00:00-04:00,0,10,13,0,1,637,3251,3888
2016-10-10 14:00:00-04:00,0,10,14,0,1,443,2392,2835
2016-10-10 15:00:00-04:00,0,10,15,0,1,437,2726,3163
2016-10-10 16:00:00-04:00,0,10,16,0,1,343,3466,3809
2016-10-10 17:00:00-04:00,0,10,17,0,1,439,7015,7454
2016-10-10 18:00:00-04:00,0,10,18,0,1,720,10839,11559
2016-10-10 19:00:00-04:00,0,10,19,0,1,1182,14232,15414
2016-10-10 20:00:00-04:00,0,10,20,0,1,1248,14845,16093
2016-10-10 21:00:00-04:00,0,10,21,0,1,1276,13710,14986
2016-10-10 22:00:00-04:00,0,10,22,0,1,1221,13915,15136
2016-10-10 23:00:00-04:00,0,10,23,0,1,1230,14624,15854
2016-10-11 00:00:00-04:00,0,10,0,1,0,1242,14934,16176
2016-10-11 01:00:00-04:00,0,10,1,1,0,1472,15744,17216
2016-10-11 02:00:00-04:00,0,10,2,1,0,1577,15826,17403
2016-10-11 03:00:00-04:00,0,10,3,1,0,1693,15134,16827
2016-10-11 04:00:00-04:00,0,10,4,1,0,1763,17479,19242
2016-10-11 05:00:00-04:00,0,10,5,1,0,2087,20096,22183
2016-10-11 06:00:00-04:00,0,10,6,1,0,2047,19433,21480
2016-10-11 07:00:00-04:00,0,10,7,1,0,1703,17959,19662
2016-10-11 08:00:00-04:00,0,10,8,1,0,1529,16770,18299
2016-10-11 09:00:00-04:00,0,10,9,1,0,1252,14573,15825
2016-10-11 10:00:00-04:00,0,10,10,1,0,1042,10357,11399
2016-10-11 11:00:00-04:00,0,10,11,1,0,860,6647,7507
2016-10-11 12:00:00-04:00,0,10,12,1,0,584,3921,4505
2016-10-11 13:00:00-04:00,0,10,13,1,0,358,2457,2815
2016-10-11 14:00:00-04:00,0,10,14,1,0,291,1698,1989
2016-10-11 15:00:00-04:00,0,10,15,1,0,254,1746,2000
2016-10-11 16:00:00-04:00,0,10,16,1,0,270,3567,3837
2016-10-11 17:00:00-04:00,0,10,17,1,0,543,9950,10493
2016-10-11 18:00:00-04:00,0,10,18,1,0,1235,16441,17676
2016-10-11 19:00:00-04:00,0,10,19,1,0,1858,18629,20487
2016-10-11 20:00:00-04:00,0,10,20,1,0,1683,17153,18836
2016-10-11 21:00:00-04:00,0,10,21,1,0,1573,15839,17412
2016-10-11 22:00:00-04:00,0,10,22,1,0,1463,15504,16967
2016-10-11 23:00:00-04:00,0,10,23,1,0,1467,15687,17154
2016-10-12 00:00:00-04:00,0,10,0,2,0,1460,16162,17622
2016-10-12 01:00:00-04:00,0,10,1,2,0,1678,17628,19306
2016-10-12 02:00:00-04:00,0,10,2,2,0,1838,16923,18761
2016-10-12 03:00:00-04:00,0,10,3,2,0,2015,14927,16942
2016-10-12 04:00:00-04:00,0,10,4,2,0,2257,18638,20895
2016-10-12 05:00:00-04:00,0,10,5,2,0,2389,21279,23668
2016-10-12 06:00:00-04:00,0,10,6,2,0,2407,20650,23057
2016-10-12 07:00:00-04:00,0,10,7,2,0,2027,19932,21959
2016-10-12 08:00:00-04:00,0,10,8,2,0,1849,19078,20927
2016-10-12 09:00:00-04:00,0,10,9,2,0,1569,15924,17493
2016-10-12 10:00:00-04:00,0,10,10,2,0,1301,11314,12615
2016-10-12 11:00:00-04:00,0,10,11,2,0,959,7300,8259
2016-10-12 12:00:00-04:00,0,10,12,2,0,668,4261,4929
2016-10-12 13:00:00-04:00,0,10,13,2,0,424,2805,3229
2016-10-12 14:00:00-04:00,0,10,14,2,0,286,1891,2177
2016-10-12 15:00:00-04:00,0,10,15,2,0,274,1899,2173
2016-10-12 16:00:00-04:00,0,10,16,2,0,242,3154,3396
2016-10-12 17:00:00-04:00,0,10,17,2,0,436,7679,8115
2016-10-12 18:00:00-04:00,0,10,18,2,0,934,12267,13201
2016-10-12 19:00:00-04:00,0,10,19,2,0,1480,15154,16634
2016-10-12 20:00:00-04:00,0,10,20,2,0,1634,15870,17504
2016-10-12 21:00:00-04:00,0,10,21,2,0,1445,15893,17338
2016-10-12 22:00:00-04:00,0,10,22,2,0,1419,15346,16765
2016-10-12 23:00:00-04:00,0,10,23,2,0,1357,15511,16868
2016-10-13 00:00:00-04:00,0,10,0,3,0,1398,16523,17921
2016-10-13 01:00:00-04:00,0,10,1,3,0,1502,16505,18007
2016-10-13 02:00:00-04:00,0,10,2,3,0,1685,15861,17546
2016-10-13 03:00:00-04:00,0,10,3,3,0,1825,15225,17050
2016-10-13 04:00:00-04:00,0,10,4,3,0,2110,18641,20751
2016-10-13 05:00:00-04:00,0,10,5,3,0,2339,21690,24029
2016-10-13 06:00:00-04:00,0,10,6,3,0,2406,23513,25919
2016-10-13 07:00:00-04:00,0,10,7,3,0,2096,21704,23800
2016-10-13 08:00:00-04:00,0,10,8,3,0,1891,20964,22855
2016-10-13 09:00:00-04:00,0,10,9,3,0,1621,17629,19250
2016-10-13 10:00:00-04:00,0,10,10,3,0,1353,12892,14245
2016-10-13 11:00:00-04:00,0,10,11,3,0,1079,8164,9243
2016-10-13 12:00:00-04:00,0,10,12,3,0,740,4860,5600
2016-10-13 13:00:00-04:00,0,10,13,3,0,455,3117,3572
2016-10-13 14:00:00-04:00,0,10,14,3,0,317,2252,2569
2016-10-13 15:00:00-04:00,0,10,15,3,0,301,2167,2468
2016-10-13 16:00:00-04:00,0,10,16,3,0,311,4084,4395
2016-10-13 17:00:00-04:00,0,10,17,3,0,582,10293,10875
2016-10-13 18:00:00-04:00,0,10,18,3,0,1297,17907,19204
2016-10-13 19:00:00-04:00,0,10,19,3,0,2010,19971,21981
2016-10-13 20:00:00-04:00,0,10,20,3,0,1816,18491,20307
2016-10-13 21:00:00-04:00,0,10,21,3,0,1719,17087,18806
2016-10-13 22:00:00-04:00,0,10,22,3,0,1527,16862,18389
2016-10-13 23:00:00-04:00,0,10,23,3,0,1600,17466,19066
2016-10-14 00:00:00-04:00,0,10,0,4,0,1599,17656,19255
2016-10-14 01:00:00-04:00,0,10,1,4,0,1968,19918,21886
2016-10-14 02:00:00-04:00,0,10,2,4,0,2050,17926,19976
2016-10-14 03:00:00-04:00,0,10,3,4,0,2228,14887,17115
2016-10-14 04:00:00-04:00,0,10,4,4,0,2547,18250,20797
2016-10-14 05:00:00-04:00,0,10,5,4,0,2646,22164,24810
2016-10-14 06:00:00-04:00,0,10,6,4,0,2847,23656,26503
2016-10-14 07:00:00-04:00,0,10,7,4,0,2451,24052,26503
2016-10-14 08:00:00-04:00,0,10,8,4,0,2416,23813,26229
2016-10-14 09:00:00-04:00,0,10,9,4,0,2175,22656,24831
2016-10-14 10:00:00-04:00,0,10,10,4,0,1861,20260,22121
2016-10-14 11:00:00-04:00,0,10,11,4,0,1486,13999,15485
2016-10-14 12:00:00-04:00,0,10,12,4,0,1056,8770,9826
2016-10-14 13:00:00-04:00,0,10,13,4,0,674,5839,6513
2016-10-14 14:00:00-04:00,0,10,14,4,0,469,3847,4316
2016-10-14 15:00:00-04:00,0,10,15,4,0,386,3289,3675
2016-10-14 16:00:00-04:00,0,10,16,4,0,324,4228,4552
2016-10-14 17:00:00-04:00,0,10,17,4,0,586,10147,10733
2016-10-14 18:00:00-04:00,0,10,18,4,0,1410,17765,19175
2016-10-14 19:00:00-04:00,0,10,19,4,0,2041,19845,21886
2016-10-14 20:00:00-04:00,0,10,20,4,0,1923,18374,20297
2016-10-14 21:00:00-04:00,0,10,21,4,0,1636,16816,18452
2016-10-14 22:00:00-04:00,0,10,22,4,0,1588,17269,18857
2016-10-14 23:00:00-04:00,0,10,23,4,0,1478,17651,19129
2016-10-15 00:00:00-04:00,0,10,0,5,0,1472,17114,18586
2016-10-15 01:00:00-04:00,0,10,1,5,0,1836,18618,20454
2016-10-15 02:00:00-04:00,0,10,2,5,0,2136,17409,19545
2016-10-15 03:00:00-04:00,0,10,3,5,0,2521,14906,17427
2016-10-15 04:00:00-04:00,0,10,4,5,0,3035,18510,21545
2016-10-15 05:00:00-04:00,0,10,5,5,0,3236,21930,25166
2016-10-15 06:00:00-04:00,0,10,6,5,0,3430,23738,27168
2016-10-15 07:00:00-04:00,0,10,7,5,0,3205,22939,26144
2016-10-15 08:00:00-04:00,0,10,8,5,0,3063,22264,25327
2016-10-15 09:00:00-04:00,0,10,9,5,0,2921,22723,25644
2016-10-15 10:00:00-04:00,0,10,10,5,0,3054,22523,25577
2016-10-15 11:00:00-04:00,0,10,11,5,0,2870,19557,22427
2016-10-15 12:00:00-04:00,0,10,12,5,0,2570,17009,19579
2016-10-15 13:00:00-04:00,0,10,13,5,0,2109,13927,16036
2016-10-15 14:00:00-04:00,0,10,14,5,0,1769,10422,12191
2016-10-15 15:00:00-04:00,0,10,15,5,0,1368,6609,7977
2016-10-15 16:00:00-04:00,0,10,16,5,0,705,3547,4252
2016-10-15 17:00:00-04:00,0,10,17,5,0,568,4821,5389
2016-10-15 18:00:00-04:00,0,10,18,5,0,774,7796,8570
2016-10-15 19:00:00-04:00,0,10,19,5,0,1094,11750,12844
2016-10-15 20:00:00-04:00,0,10,20,5,0,1446,15107,16553
2016-10-15 21:00:00-04:00,0,10,21,5,0,1576,16915,18491
2016-10-15 22:00:00-04:00,0,10,22,5,0,1834,18120,19954
2016-10-15 23:00:00-04:00,0,10,23,5,0,1919,19165,21084
2016-10-16 00:00:00-04:00,0,10,0,6,0,2004,19740,21744
2016-10-16 01:00:00-04:00,0,10,1,6,0,2232,18799,21031
2016-10-16 02:00:00-04:00,0,10,2,6,0,2456,19128,21584
2016-10-16 03:00:00-04:00,0,10,3,6,0,2517,16886,19403
2016-10-16 04:00:00-04:00,0,10,4,6,0,2830,19051,21881
2016-10-16 05:00:00-04:00,0,10,5,6,0,3049,21608,24657
2016-10-16 06:00:00-04:00,0,10,6,6,0,3365,22744,26109
2016-10-16 07:00:00-04:00,0,10,7,6,0,3080,19581,22661
2016-10-16 08:00:00-04:00,0,10,8,6,0,3073,18429,21502
2016-10-16 09:00:00-04:00,0,10,9,6,0,3153,20354,23507
2016-10-16 10:00:00-04:00,0,10,10,6,0,3303,20472,23775
2016-10-16 11:00:00-04:00,0,10,11,6,0,3151,19659,22810
2016-10-16 12:00:00-04:00,0,10,12,6,0,2905,18338,21243
2016-10-16 13:00:00-04:00,0,10,13,6,0,2536,15656,18192
2016-10-16 14:00:00-04:00,0,10,14,6,0,2045,11852,13897
2016-10-16 15:00:00-04:00,0,10,15,6,0,1510,7493,9003
2016-10-16 16:00:00-04:00,0,10,16,6,0,716,3444,4160
2016-10-16 17:00:00-04:00,0,10,17,6,0,516,3860,4376
2016-10-16 18:00:00-04:00,0,10,18,6,0,538,5596,6134
2016-10-16 19:00:00-04:00,0,10,19,6,0,727,8358,9085
2016-10-16 20:00:00-04:00,0,10,20,6,0,1057,12289,13346
2016-10-16 21:00:00-04:00,0,10,21,6,0,1327,15651,16978
2016-10-16 22:00:00-04:00,0,10,22,6,0,1592,17459,19051
2016-10-16 23:00:00-04:00,0,10,23,6,0,1775,19207,20982
2016-10-17 00:00:00-04:00,0,10,0,0,0,1798,18967,20765
2016-10-17 01:00:00-04:00,0,10,1,0,0,1978,18218,20196
2016-10-17 02:00:00-04:00,0,10,2,0,0,2096,17663,19759
2016-10-17 03:00:00-04:00,0,10,3,0,0,2147,17194,19341
2016-10-17 04:00:00-04:00,0,10,4,0,0,2367,17981,20348
2016-10-17 05:00:00-04:00,0,10,5,0,0,2282,18710,20992
2016-10-17 06:00:00-04:00,0,10,6,0,0,2236,16766,19002
2016-10-17 07:00:00-04:00,0,10,7,0,0,2035,15304,17339
2016-10-17 08:00:00-04:00,0,10,8,0,0,1841,14577,16418
2016-10-17 09:00:00-04:00,0,10,9,0,0,1581,11823,13404
2016-10-17 10:00:00-04:00,0,10,10,0,0,1335,9524,10859
2016-10-17 11:00:00-04:00,0,10,11,0,0,918,6000,6918
2016-10-17 12:00:00-04:00,0,10,12,0,0,649,3539,4188
2016-10-17 13:00:00-04:00,0,10,13,0,0,402,2375,2777
2016-10-17 14:00:00-04:00,0,10,14,0,0,323,1565,1888
2016-10-17 15:00:00-04:00,0,10,15,0,0,313,2125,2438
2016-10-17 16:00:00-04:00,0,10,16,0,0,331,4102,4433
2016-10-17 17:00:00-04:00,0,10,17,0,0,532,9434,9966
2016-10-17 18:00:00-04:00,0,10,18,0,0,1379,16178,17557
2016-10-17 19:00:00-04:00,0,10,19,0,0,1895,17868,19763
2016-10-17 20:00:00-04:00,0,10,20,0,0,1711,16109,17820
2016-10-17 21:00:00-04:00,0,10,21,0,0,1454,14621,16075
2016-10-17 22:00:00-04:00,0,10,22,0,0,1354,14858,16212
2016-10-17 23:00:00-04:00,0,10,23,0,0,1296,15183,16479
2016-10-18 00:00:00-04:00,0,10,0,1,0,1365,15908,17273
2016-10-18 01:00:00-04:00,0,10,1,1,0,1542,16963,18505
2016-10-18 02:00:00-04:00,0,10,2,1,0,1734,17000,18734
2016-10-18 03:00:00-04:00,0,10,3,1,0,1880,15923,17803
2016-10-18 04:00:00-04:00,0,10,4,1,0,2225,19052,21277
2016-10-18 05:00:00-04:00,0,10,5,1,0,2291,21962,24253
2016-10-18 06:00:00-04:00,0,10,6,1,0,2205,20865,23070
2016-10-18 07:00:00-04:00,0,10,7,1,0,1862,19408,21270
2016-10-18 08:00:00-04:00,0,10,8,1,0,1605,18331,19936
2016-10-18 09:00:00-04:00,0,10,9,1,0,1354,15169,16523
2016-10-18 10:00:00-04:00,0,10,10,1,0,1179,11323,12502
2016-10-18 11:00:00-04:00,0,10,11,1,0,804,6767,7571
2016-10-18 12:00:00-04:00,0,10,12,1,0,501,3973,4474
2016-10-18 13:00:00-04:00,0,10,13,1,0,321,2489,2810
2016-10-18 14:00:00-04:00,0,10,14,1,0,245,1644,1889
2016-10-18 15:00:00-04:00,0,10,15,1,0,220,1785,2005
2016-10-18 16:00:00-04:00,0,10,16,1,0,254,3569,3823
2016-10-18 17:00:00-04:00,0,10,17,1,0,540,9790,10330
2016-10-18 18:00:00-04:00,0,10,18,1,0,1242,17147,18389
2016-10-18 19:00:00-04:00,0,10,19,1,0,2065,19030,21095
2016-10-18 20:00:00-04:00,0,10,20,1,0,1820,17525,19345
2016-10-18 21:00:00-04:00,0,10,21,1,0,1504,15827,17331
2016-10-18 22:00:00-04:00,0,10,22,1,0,1430,15736,17166
2016-10-18 23:00:00-04:00,0,10,23,1,0,1408,16231,17639
2016-10-19 00:00:00-04:00,0,10,0,2,0,1428,16615,18043
2016-10-19 01:00:00-04:00,0,10,1,2,0,1613,18383,19996
2016-10-19 02:00:00-04:00,0,10,2,2,0,1752,17586,19338
2016-10-19 03:00:00-04:00,0,10,3,2,0,1901,15640,17541
2016-10-19 04:00:00-04:00,0,10,4,2,0,2300,18947,21247
2016-10-19 05:00:00-04:00,0,10,5,2,0,2556,21935,24491
2016-10-19 06:00:00-04:00,0,10,6,2,0,2381,22512,24893
2016-10-19 07:00:00-04:00,0,10,7,2,0,2174,21888,24062
2016-10-19 08:00:00-04:00,0,10,8,2,0,1921,21313,23234
2016-10-19 09:00:00-04:00,0,10,9,2,0,1681,19332,21013
2016-10-19 10:00:00-04:00,0,10,10,2,0,1350,13668,15018
2016-10-19 11:00:00-04:00,0,10,11,2,0,971,8729,9700
2016-10-19 12:00:00-04:00,0,10,12,2,0,613,4937,5550
2016-10-19 13:00:00-04:00,0,10,13,2,0,427,3159,3586
2016-10-19 14:00:00-04:00,0,10,14,2,0,302,2162,2464
2016-10-19 15:00:00-04:00,0,10,15,2,0,258,2122,2380
2016-10-19 16:00:00-04:00,0,10,16,2,0,269,3746,4015
2016-10-19 17:00:00-04:00,0,10,17,2,0,530,9808,10338
2016-10-19 18:00:00-04:00,0,10,18,2,0,1248,18111,19359
2016-10-19 19:00:00-04:00,0,10,19,2,0,1891,19777,21668
2016-10-19 20:00:00-04:00,0,10,20,2,0,1831,18470,20301
2016-10-19 21:00:00-04:00,0,10,21,2,0,1569,16723,18292
2016-10-19 22:00:00-04:00,0,10,22,2,0,1544,16598,18142
2016-10-19 23:00:00-04:00,0,10,23,2,0,1519,16956,18475
2016-10-20 00:00:00-04:00,0,10,0,3,0,1430,17145,18575
2016-10-20 01:00:00-04:00,0,10,1,3,0,1694,18529,20223
2016-10-20 02:00:00-04:00,0,10,2,3,0,1901,17391,19292
2016-10-20 03:00:00-04:00,0,10,3,3,0,2198,15196,17394
2016-10-20 04:00:00-04:00,0,10,4,3,0,2430,18673,21103
2016-10-20 05:00:00-04:00,0,10,5,3,0,2712,22136,24848
2016-10-20 06:00:00-04:00,0,10,6,3,0,2718,23224,25942
2016-10-20 07:00:00-04:00,0,10,7,3,0,2440,24645,27085
2016-10-20 08:00:00-04:00,0,10,8,3,0,1994,20360,22354
2016-10-20 09:00:00-04:00,0,10,9,3,0,1755,19322,21077
2016-10-20 10:00:00-04:00,0,10,10,3,0,1667,17101,18768
2016-10-20 11:00:00-04:00,0,10,11,3,0,1151,10090,11241
2016-10-20 12:00:00-04:00,0,10,12,3,0,771,5581,6352
2016-10-20 13:00:00-04:00,0,10,13,3,0,450,3784,4234
2016-10-20 14:00:00-04:00,0,10,14,3,0,333,2330,2663
2016-10-20 15:00:00-04:00,0,10,15,3,0,311,2310,2621
2016-10-20 16:00:00-04:00,0,10,16,3,0,274,3873,4147
2016-10-20 17:00:00-04:00,0,10,17,3,0,594,10307,10901
2016-10-20 18:00:00-04:00,0,10,18,3,0,1432,18165,19597
2016-10-20 19:00:00-04:00,0,10,19,3,0,1926,20208,22134
2016-10-20 20:00:00-04:00,0,10,20,3,0,1856,18535,20391
2016-10-20 21:00:00-04:00,0,10,21,3,0,1557,16726,18283
2016-10-20 22:00:00-04:00,0,10,22,3,0,1489,16943,18432
2016-10-20 23:00:00-04:00,0,10,23,3,0,1694,17555,19249
2016-10-21 00:00:00-04:00,0,10,0,4,0,1809,17597,19406
2016-10-21 01:00:00-04:00,0,10,1,4,0,1989,18493,20482
2016-10-21 02:00:00-04:00,0,10,2,4,0,2066,17260,19326
2016-10-21 03:00:00-04:00,0,10,3,4,0,2232,14643,16875
2016-10-21 04:00:00-04:00,0,10,4,4,0,2765,18216,20981
2016-10-21 05:00:00-04:00,0,10,5,4,0,2828,22001,24829
2016-10-21 06:00:00-04:00,0,10,6,4,0,2799,23121,25920
2016-10-21 07:00:00-04:00,0,10,7,4,0,2457,23103,25560
2016-10-21 08:00:00-04:00,0.01,10,8,4,0,2287,23221,25508
2016-10-21 09:00:00-04:00,0.79,10,9,4,0,2248,22628,24876
2016-10-21 10:00:00-04:00,0.49,10,10,4,0,1887,19494,21381
2016-10-21 11:00:00-04:00,0.16,10,11,4,0,1502,14215,15717
2016-10-21 12:00:00-04:00,0.08,10,12,4,0,1061,8631,9692
2016-10-21 13:00:00-04:00,0.18,10,13,4,0,717,5867,6584
2016-10-21 14:00:00-04:00,0.1,10,14,4,0,482,3845,4327
2016-10-21 15:00:00-04:00,0,10,15,4,0,391,3303,3694
2016-10-21 16:00:00-04:00,0,10,16,4,0,344,4373,4717
2016-10-21 17:00:00-04:00,0,10,17,4,0,597,10047,10644
2016-10-21 18:00:00-04:00,0,10,18,4,0,1426,17838,19264
2016-10-21 19:00:00-04:00,0,10,19,4,0,2113,20895,23008
2016-10-21 20:00:00-04:00,0,10,20,4,0,2623,21061,23684
2016-10-21 21:00:00-04:00,0,10,21,4,0,1988,18268,20256
2016-10-21 22:00:00-04:00,0,10,22,4,0,1883,17927,19810
2016-10-21 23:00:00-04:00,0,10,23,4,0,1766,17510,19276
2016-10-22 00:00:00-04:00,0,10,0,5,0,1706,16276,17982
2016-10-22 01:00:00-04:00,0,10,1,5,0,1992,17105,19097
2016-10-22 02:00:00-04:00,0,10,2,5,0,2047,15602,17649
2016-10-22 03:00:00-04:00,0,10,3,5,0,2371,14007,16378
2016-10-22 04:00:00-04:00,0.1,10,4,5,0,2839,17916,20755
2016-10-22 05:00:00-04:00,0.16,10,5,5,0,3117,21698,24815
2016-10-22 06:00:00-04:00,0.01,10,6,5,0,3289,23010,26299
2016-10-22 07:00:00-04:00,0.04,10,7,5,0,3014,21295,24309
2016-10-22 08:00:00-04:00,0.06,10,8,5,0,2934,20490,23424
2016-10-22 09:00:00-04:00,0,10,9,5,0,2904,21793,24697
2016-10-22 10:00:00-04:00,0,10,10,5,0,3170,23397,26567
2016-10-22 11:00:00-04:00,0,10,11,5,0,2822,19812,22634
2016-10-22 12:00:00-04:00,0,10,12,5,0,2594,17374,19968
2016-10-22 13:00:00-04:00,0.01,10,13,5,0,2071,14666,16737
2016-10-22 14:00:00-04:00,0,10,14,5,0,1778,11250,13028
2016-10-22 15:00:00-04:00,0,10,15,5,0,1326,7197,8523
2016-10-22 16:00:00-04:00,0,10,16,5,0,635,3514,4149
2016-10-22 17:00:00-04:00,0,10,17,5,0,545,4848,5393
2016-10-22 18:00:00-04:00,0,10,18,5,0,785,7820,8605
2016-10-22 19:00:00-04:00,0,10,19,5,0,1102,12146,13248
2016-10-22 20:00:00-04:00,0,10,20,5,0,1418,15713,17131
2016-10-22 21:00:00-04:00,0,10,21,5,0,1762,17707,19469
2016-10-22 22:00:00-04:00,0,10,22,5,0,2032,20924,22956
2016-10-22 23:00:00-04:00,0,10,23,5,0,2186,22791,24977
2016-10-23 00:00:00-04:00,0,10,0,6,0,2075,21916,23991
2016-10-23 01:00:00-04:00,0,10,1,6,0,2209,19812,22021
2016-10-23 02:00:00-04:00,0,10,2,6,0,2481,19854,22335
2016-10-23 03:00:00-04:00,0,10,3,6,0,2667,17976,20643
2016-10-23 04:00:00-04:00,0,10,4,6,0,2908,20194,23102
2016-10-23 05:00:00-04:00,0,10,5,6,0,3055,22078,25133
2016-10-23 06:00:00-04:00,0,10,6,6,0,3188,22777,25965
2016-10-23 07:00:00-04:00,0,10,7,6,0,3070,19198,22268
2016-10-23 08:00:00-04:00,0,10,8,6,0,3024,18796,21820
2016-10-23 09:00:00-04:00,0,10,9,6,0,3065,21037,24102
2016-10-23 10:00:00-04:00,0,10,10,6,0,3362,22455,25817
2016-10-23 11:00:00-04:00,0,10,11,6,0,3170,20565,23735
2016-10-23 12:00:00-04:00,0,10,12,6,0,2764,18706,21470
2016-10-23 13:00:00-04:00,0,10,13,6,0,2418,16155,18573
2016-10-23 14:00:00-04:00,0,10,14,6,0,1848,11669,13517
2016-10-23 15:00:00-04:00,0,10,15,6,0,1435,7879,9314
2016-10-23 16:00:00-04:00,0,10,16,6,0,684,3513,4197
2016-10-23 17:00:00-04:00,0,10,17,6,0,427,3959,4386
2016-10-23 18:00:00-04:00,0,10,18,6,0,581,5661,6242
2016-10-23 19:00:00-04:00,0,10,19,6,0,704,8544,9248
2016-10-23 20:00:00-04:00,0,10,20,6,0,1070,12848,13918
2016-10-23 21:00:00-04:00,0,10,21,6,0,1352,16151,17503
2016-10-23 22:00:00-04:00,0,10,22,6,0,1568,17557,19125
2016-10-23 23:00:00-04:00,0,10,23,6,0,1767,19054,20821
2016-10-24 00:00:00-04:00,0,10,0,0,0,1785,19149,20934
2016-10-24 01:00:00-04:00,0,10,1,0,0,1899,18382,20281
2016-10-24 02:00:00-04:00,0,10,2,0,0,2072,18283,20355
2016-10-24 03:00:00-04:00,0,10,3,0,0,2107,17310,19417
2016-10-24 04:00:00-04:00,0,10,4,0,0,2326,18471,20797
2016-10-24 05:00:00-04:00,0,10,5,0,0,2272,18930,21202
2016-10-24 06:00:00-04:00,0,10,6,0,0,2214,17353,19567
2016-10-24 07:00:00-04:00,0,10,7,0,0,2051,15748,17799
2016-10-24 08:00:00-04:00,0,10,8,0,0,1743,14870,16613
2016-10-24 09:00:00-04:00,0,10,9,0,0,1647,12793,14440
2016-10-24 10:00:00-04:00,0,10,10,0,0,1356,9966,11322
2016-10-24 11:00:00-04:00,0,10,11,0,0,997,6355,7352
2016-10-24 12:00:00-04:00,0,10,12,0,0,655,3513,4168
2016-10-24 13:00:00-04:00,0,10,13,0,0,432,2415,2847
2016-10-24 14:00:00-04:00,0,10,14,0,0,334,1658,1992
2016-10-24 15:00:00-04:00,0,10,15,0,0,351,2052,2403
2016-10-24 16:00:00-04:00,0,10,16,0,0,311,3862,4173
2016-10-24 17:00:00-04:00,0,10,17,0,0,581,9619,10200
2016-10-24 18:00:00-04:00,0,10,18,0,0,1331,16202,17533
2016-10-24 19:00:00-04:00,0,10,19,0,0,1909,18200,20109
2016-10-24 20:00:00-04:00,0,10,20,0,0,1734,16494,18228
2016-10-24 21:00:00-04:00,0,10,21,0,0,1497,15042,16539
2016-10-24 22:00:00-04:00,0,10,22,0,0,1319,14736,16055
2016-10-24 23:00:00-04:00,0,10,23,0,0,1337,15551,16888
2016-10-25 00:00:00-04:00,0,10,0,1,0,1325,15371,16696
2016-10-25 01:00:00-04:00,0,10,1,1,0,1517,16839,18356
2016-10-25 02:00:00-04:00,0,10,2,1,0,1750,17081,18831
2016-10-25 03:00:00-04:00,0,10,3,1,0,1886,16301,18187
2016-10-25 04:00:00-04:00,0,10,4,1,0,2263,19543,21806
2016-10-25 05:00:00-04:00,0,10,5,1,0,2534,22442,24976
2016-10-25 06:00:00-04:00,0,10,6,1,0,2397,22624,25021
2016-10-25 07:00:00-04:00,0,10,7,1,0,1991,21144,23135
2016-10-25 08:00:00-04:00,0,10,8,1,0,1800,19991,21791
2016-10-25 09:00:00-04:00,0,10,9,1,0,1450,17163,18613
2016-10-25 10:00:00-04:00,0,10,10,1,0,1142,12471,13613
2016-10-25 11:00:00-04:00,0,10,11,1,0,840,7422,8262
2016-10-25 12:00:00-04:00,0,10,12,1,0,521,4113,4634
2016-10-25 13:00:00-04:00,0,10,13,1,0,314,2565,2879
2016-10-25 14:00:00-04:00,0,10,14,1,0,234,1667,1901
2016-10-25 15:00:00-04:00,0,10,15,1,0,205,1775,1980
2016-10-25 16:00:00-04:00,0,10,16,1,0,255,3552,3807
2016-10-25 17:00:00-04:00,0,10,17,1,0,516,10167,10683
2016-10-25 18:00:00-04:00,0,10,18,1,0,1264,17005,18269
2016-10-25 19:00:00-04:00,0,10,19,1,0,1994,19911,21905
2016-10-25 20:00:00-04:00,0,10,20,1,0,1855,18435,20290
2016-10-25 21:00:00-04:00,0,10,21,1,0,1643,17159,18802
2016-10-25 22:00:00-04:00,0,10,22,1,0,1554,16570,18124
2016-10-25 23:00:00-04:00,0,10,23,1,0,1481,17237,18718
2016-10-26 00:00:00-04:00,0,10,0,2,0,1517,17129,18646
2016-10-26 01:00:00-04:00,0,10,1,2,0,1629,18307,19936
2016-10-26 02:00:00-04:00,0,10,2,2,0,1831,17942,19773
2016-10-26 03:00:00-04:00,0,10,3,2,0,2128,15853,17981
2016-10-26 04:00:00-04:00,0,10,4,2,0,2454,19908,22362
2016-10-26 05:00:00-04:00,0,10,5,2,0,2835,24106,26941
2016-10-26 06:00:00-04:00,0,10,6,2,0,2826,24401,27227
2016-10-26 07:00:00-04:00,0,10,7,2,0,2389,24297,26686
2016-10-26 08:00:00-04:00,0,10,8,2,0,2138,23447,25585
2016-10-26 09:00:00-04:00,0,10,9,2,0,1846,21167,23013
2016-10-26 10:00:00-04:00,0,10,10,2,0,1465,15783,17248
2016-10-26 11:00:00-04:00,0,10,11,2,0,967,8769,9736
2016-10-26 12:00:00-04:00,0,10,12,2,0,680,4827,5507
2016-10-26 13:00:00-04:00,0,10,13,2,0,422,2888,3310
2016-10-26 14:00:00-04:00,0,10,14,2,0,254,1957,2211
2016-10-26 15:00:00-04:00,0,10,15,2,0,270,2037,2307
2016-10-26 16:00:00-04:00,0,10,16,2,0,254,3529,3783
2016-10-26 17:00:00-04:00,0,10,17,2,0,527,10357,10884
2016-10-26 18:00:00-04:00,0,10,18,2,0,1315,18480,19795
2016-10-26 19:00:00-04:00,0,10,19,2,0,1978,20714,22692
2016-10-26 20:00:00-04:00,0,10,20,2,0,1805,19093,20898
2016-10-26 21:00:00-04:00,0,10,21,2,0,1638,17019,18657
2016-10-26 22:00:00-04:00,0,10,22,2,0,1500,17339,18839
2016-10-26 23:00:00-04:00,0,10,23,2,0,1545,17690,19235
2016-10-27 00:00:00-04:00,0,10,0,3,0,1535,17441,18976
2016-10-27 01:00:00-04:00,0,10,1,3,0,1716,18152,19868
2016-10-27 02:00:00-04:00,0,10,2,3,0,1897,17669,19566
2016-10-27 03:00:00-04:00,0,10,3,3,0,2144,15199,17343
2016-10-27 04:00:00-04:00,0,10,4,3,0,2541,19278,21819
2016-10-27 05:00:00-04:00,0,10,5,3,0,3003,23041,26044
2016-10-27 06:00:00-04:00,0,10,6,3,0,2902,23922,26824
2016-10-27 07:00:00-04:00,0,10,7,3,0,2426,24037,26463
2016-10-27 08:00:00-04:00,0,10,8,3,0,2363,23794,26157
2016-10-27 09:00:00-04:00,0,10,9,3,0,1973,22206,24179
2016-10-27 10:00:00-04:00,0.01,10,10,3,0,1692,17222,18914
2016-10-27 11:00:00-04:00,0.05,10,11,3,0,1250,10300,11550
2016-10-27 12:00:00-04:00,0.01,10,12,3,0,802,5958,6760
2016-10-27 13:00:00-04:00,0.01,10,13,3,0,492,3759,4251
2016-10-27 14:00:00-04:00,0.03,10,14,3,0,340,2317,2657
2016-10-27 15:00:00-04:00,0,10,15,3,0,308,2194,2502
2016-10-27 16:00:00-04:00,0.01,10,16,3,0,263,3929,4192
2016-10-27 17:00:00-04:00,0.11,10,17,3,0,566,10626,11192
2016-10-27 18:00:00-04:00,0.14,10,18,3,0,1381,18459,19840
2016-10-27 19:00:00-04:00,0.32,10,19,3,0,2088,21956,24044
2016-10-27 20:00:00-04:00,0.31,10,20,3,0,2059,19942,22001
2016-10-27 21:00:00-04:00,0.25,10,21,3,0,1835,18858,20693
2016-10-27 22:00:00-04:00,0.07,10,22,3,0,1704,18612,20316
2016-10-27 23:00:00-04:00,0,10,23,3,0,1635,17892,19527
2016-10-28 00:00:00-04:00,0,10,0,4,0,1761,18134,19895
2016-10-28 01:00:00-04:00,0,10,1,4,0,2021,18556,20577
2016-10-28 02:00:00-04:00,0,10,2,4,0,2226,16308,18534
2016-10-28 03:00:00-04:00,0,10,3,4,0,2443,13958,16401
2016-10-28 04:00:00-04:00,0,10,4,4,0,3229,17626,20855
2016-10-28 05:00:00-04:00,0,10,5,4,0,3493,20551,24044
2016-10-28 06:00:00-04:00,0,10,6,4,0,3511,21527,25038
2016-10-28 07:00:00-04:00,0,10,7,4,0,3184,21778,24962
2016-10-28 08:00:00-04:00,0,10,8,4,0,2595,21673,24268
2016-10-28 09:00:00-04:00,0,10,9,4,0,2016,20118,22134
2016-10-28 10:00:00-04:00,0,10,10,4,0,1726,18241,19967
2016-10-28 11:00:00-04:00,0,10,11,4,0,1377,13742,15119
2016-10-28 12:00:00-04:00,0,10,12,4,0,977,8736,9713
2016-10-28 13:00:00-04:00,0,10,13,4,0,640,6423,7063
2016-10-28 14:00:00-04:00,0,10,14,4,0,446,4123,4569
2016-10-28 15:00:00-04:00,0,10,15,4,0,372,3448,3820
2016-10-28 16:00:00-04:00,0,10,16,4,0,337,4537,4874
2016-10-28 17:00:00-04:00,0,10,17,4,0,529,10455,10984
2016-10-28 18:00:00-04:00,0,10,18,4,0,1374,17812,19186
2016-10-28 19:00:00-04:00,0,10,19,4,0,2015,19788,21803
2016-10-28 20:00:00-04:00,0,10,20,4,0,1941,18460,20401
2016-10-28 21:00:00-04:00,0,10,21,4,0,1721,17299,19020
2016-10-28 22:00:00-04:00,0,10,22,4,0,1677,17695,19372
2016-10-28 23:00:00-04:00,0,10,23,4,0,1619,18332,19951
2016-10-29 00:00:00-04:00,0,10,0,5,0,1559,17703,19262
2016-10-29 01:00:00-04:00,0,10,1,5,0,1973,18840,20813
2016-10-29 02:00:00-04:00,0,10,2,5,0,2271,16627,18898
2016-10-29 03:00:00-04:00,0,10,3,5,0,2541,14168,16709
2016-10-29 04:00:00-04:00,0,10,4,5,0,3209,18298,21507
2016-10-29 05:00:00-04:00,0,10,5,5,0,3498,22570,26068
2016-10-29 06:00:00-04:00,0,10,6,5,0,3518,25194,28712
2016-10-29 07:00:00-04:00,0,10,7,5,0,3301,23252,26553
2016-10-29 08:00:00-04:00,0,10,8,5,0,3404,23054,26458
2016-10-29 09:00:00-04:00,0,10,9,5,0,3318,23648,26966
2016-10-29 10:00:00-04:00,0,10,10,5,0,3293,23157,26450
2016-10-29 11:00:00-04:00,0,10,11,5,0,2986,21105,24091
2016-10-29 12:00:00-04:00,0,10,12,5,0,2639,18966,21605
2016-10-29 13:00:00-04:00,0,10,13,5,0,2217,16357,18574
2016-10-29 14:00:00-04:00,0,10,14,5,0,1883,12735,14618
2016-10-29 15:00:00-04:00,0,10,15,5,0,1447,8339,9786
2016-10-29 16:00:00-04:00,0,10,16,5,0,807,4151,4958
2016-10-29 17:00:00-04:00,0,10,17,5,0,573,4656,5229
2016-10-29 18:00:00-04:00,0,10,18,5,0,711,6742,7453
2016-10-29 19:00:00-04:00,0,10,19,5,0,1012,10209,11221
2016-10-29 20:00:00-04:00,0,10,20,5,0,1360,14416,15776
2016-10-29 21:00:00-04:00,0,10,21,5,0,1500,16576,18076
2016-10-29 22:00:00-04:00,0,10,22,5,0,1755,18148,19903
2016-10-29 23:00:00-04:00,0,10,23,5,0,1813,19027,20840
2016-10-30 00:00:00-04:00,0,10,0,6,0,1957,19289,21246
2016-10-30 01:00:00-04:00,0,10,1,6,0,2174,18749,20923
2016-10-30 02:00:00-04:00,0,10,2,6,0,2312,18574,20886
2016-10-30 03:00:00-04:00,0,10,3,6,0,2527,16789,19316
2016-10-30 04:00:00-04:00,0,10,4,6,0,2794,18896,21690
2016-10-30 05:00:00-04:00,0,10,5,6,0,3059,21116,24175
2016-10-30 06:00:00-04:00,0,10,6,6,0,3247,22250,25497
2016-10-30 07:00:00-04:00,0,10,7,6,0,3326,19702,23028
2016-10-30 08:00:00-04:00,0,10,8,6,0,3283,19867,23150
2016-10-30 09:00:00-04:00,0,10,9,6,0,3441,21506,24947
2016-10-30 10:00:00-04:00,0,10,10,6,0,3563,22319,25882
2016-10-30 11:00:00-04:00,0,10,11,6,0,3687,21679,25366
2016-10-30 12:00:00-04:00,0,10,12,6,0,3618,21698,25316
2016-10-30 13:00:00-04:00,0,10,13,6,0,3244,19625,22869
2016-10-30 14:00:00-04:00,0,10,14,6,0,2946,16580,19526
2016-10-30 15:00:00-04:00,0,10,15,6,0,2251,11313,13564
2016-10-30 16:00:00-04:00,0.33,10,16,6,0,1219,5349,6568
2016-10-30 17:00:00-04:00,0.02,10,17,6,0,810,4266,5076
2016-10-30 18:00:00-04:00,0.35,10,18,6,0,720,5545,6265
2016-10-30 19:00:00-04:00,0.05,10,19,6,0,810,7656,8466
2016-10-30 20:00:00-04:00,0,10,20,6,0,1049,11666,12715
2016-10-30 21:00:00-04:00,0,10,21,6,0,1262,14973,16235
2016-10-30 22:00:00-04:00,0,10,22,6,0,1600,16862,18462
2016-10-30 23:00:00-04:00,0,10,23,6,0,1671,18614,20285
2016-10-31 00:00:00-04:00,0,10,0,0,0,1729,18819,20548
2016-10-31 01:00:00-04:00,0,10,1,0,0,1969,18361,20330
2016-10-31 02:00:00-04:00,0,10,2,0,0,2007,17317,19324
2016-10-31 03:00:00-04:00,0,10,3,0,0,2780,17928,20708
2016-10-31 04:00:00-04:00,0,10,4,0,0,2708,16090,18798
2016-10-31 05:00:00-04:00,0,10,5,0,0,2614,17066,19680
2016-10-31 06:00:00-04:00,0,10,6,0,0,2584,15638,18222
2016-10-31 07:00:00-04:00,0,10,7,0,0,2024,13282,15306
2016-10-31 08:00:00-04:00,0,10,8,0,0,1731,13144,14875
2016-10-31 09:00:00-04:00,0,10,9,0,0,1484,11846,13330
2016-10-31 10:00:00-04:00,0,10,10,0,0,1190,9316,10506
2016-10-31 11:00:00-04:00,0,10,11,0,0,987,6894,7881
2016-10-31 12:00:00-04:00,0,10,12,0,0,663,4235,4898
2016-10-31 13:00:00-04:00,0,10,13,0,0,447,2644,3091
2016-10-31 14:00:00-04:00,0,10,14,0,0,342,2105,2447
2016-10-31 15:00:00-04:00,0,10,15,0,0,353,2418,2771
2016-10-31 16:00:00-04:00,0,10,16,0,0,302,3753,4055
2016-10-31 17:00:00-04:00,0,10,17,0,0,571,9392,9963
2016-10-31 18:00:00-04:00,0,10,18,0,0,1319,16580,17899
2016-10-31 19:00:00-04:00,0,10,19,0,0,2010,18845,20855
2016-10-31 20:00:00-04:00,0,10,20,0,0,1796,16872,18668
2016-10-31 21:00:00-04:00,0,10,21,0,0,1519,14508,16027
2016-10-31 22:00:00-04:00,0,10,22,0,0,1342,14172,15514
2016-10-31 23:00:00-04:00,0,10,23,0,0,1315,14713,16028
2016-11-01 00:00:00-04:00,0,11,0,1,0,1415,14917,16332
2016-11-01 01:00:00-04:00,0,11,1,1,0,1661,16732,18393
2016-11-01 02:00:00-04:00,0,11,2,1,0,1960,17354,19314
2016-11-01 03:00:00-04:00,0,11,3,1,0,2191,15558,17749
2016-11-01 04:00:00-04:00,0,11,4,1,0,2484,17719,20203
2016-11-01 05:00:00-04:00,0,11,5,1,0,2585,19411,21996
2016-11-01 06:00:00-04:00,0,11,6,1,0,2530,18903,21433
2016-11-01 07:00:00-04:00,0,11,7,1,0,2434,18461,20895
2016-11-01 08:00:00-04:00,0,11,8,1,0,2122,16854,18976
2016-11-01 09:00:00-04:00,0,11,9,1,0,1834,14680,16514
2016-11-01 10:00:00-04:00,0,11,10,1,0,1545,12760,14305
2016-11-01 11:00:00-04:00,0,11,11,1,0,1279,9810,11089
2016-11-01 12:00:00-04:00,0,11,12,1,0,938,7440,8378
2016-11-01 13:00:00-04:00,0,11,13,1,0,707,5623,6330
2016-11-01 14:00:00-04:00,0,11,14,1,0,514,4272,4786
2016-11-01 15:00:00-04:00,0,11,15,1,0,435,3666,4101
2016-11-01 16:00:00-04:00,0,11,16,1,0,369,4691,5060
2016-11-01 17:00:00-04:00,0,11,17,1,0,559,10207,10766
2016-11-01 18:00:00-04:00,0,11,18,1,0,1330,17461,18791
2016-11-01 19:00:00-04:00,0,11,19,1,0,2000,19922,21922
2016-11-01 20:00:00-04:00,0,11,20,1,0,1863,18083,19946
2016-11-01 21:00:00-04:00,0,11,21,1,0,1618,16176,17794
2016-11-01 22:00:00-04:00,0,11,22,1,0,1562,15775,17337
2016-11-01 23:00:00-04:00,0,11,23,1,0,1581,16100,17681
2016-11-02 00:00:00-04:00,0,11,0,2,0,1578,16485,18063
2016-11-02 01:00:00-04:00,0,11,1,2,0,1750,17460,19210
2016-11-02 02:00:00-04:00,0,11,2,2,0,1840,17336,19176
2016-11-02 03:00:00-04:00,0,11,3,2,0,2029,15089,17118
2016-11-02 04:00:00-04:00,0,11,4,2,0,2342,18604,20946
2016-11-02 05:00:00-04:00,0,11,5,2,0,2596,22035,24631
2016-11-02 06:00:00-04:00,0,11,6,2,0,2432,22342,24774
2016-11-02 07:00:00-04:00,0,11,7,2,0,2095,21966,24061
2016-11-02 08:00:00-04:00,0,11,8,2,0,1919,21754,23673
2016-11-02 09:00:00-04:00,0,11,9,2,0,1591,19216,20807
2016-11-02 10:00:00-04:00,0,11,10,2,0,1228,13911,15139
2016-11-02 11:00:00-04:00,0,11,11,2,0,914,7987,8901
2016-11-02 12:00:00-04:00,0,11,12,2,0,546,4330,4876
2016-11-02 13:00:00-04:00,0,11,13,2,0,349,2619,2968
2016-11-02 14:00:00-04:00,0,11,14,2,0,238,1786,2024
2016-11-02 15:00:00-04:00,0,11,15,2,0,223,1795,2018
2016-11-02 16:00:00-04:00,0,11,16,2,0,240,3660,3900
2016-11-02 17:00:00-04:00,0,11,17,2,0,509,9796,10305
2016-11-02 18:00:00-04:00,0,11,18,2,0,1188,17531,18719
2016-11-02 19:00:00-04:00,0,11,19,2,0,1964,20301,22265
2016-11-02 20:00:00-04:00,0,11,20,2,0,1860,17963,19823
2016-11-02 21:00:00-04:00,0,11,21,2,0,1640,16307,17947
2016-11-02 22:00:00-04:00,0,11,22,2,0,1508,16132,17640
2016-11-02 23:00:00-04:00,0,11,23,2,0,1475,16684,18159
2016-11-03 00:00:00-04:00,0,11,0,3,0,1450,16609,18059
2016-11-03 01:00:00-04:00,0,11,1,3,0,1819,17921,19740
2016-11-03 02:00:00-04:00,0,11,2,3,0,1880,17345,19225
2016-11-03 03:00:00-04:00,0,11,3,3,0,2066,15116,17182
2016-11-03 04:00:00-04:00,0,11,4,3,0,2431,18626,21057
2016-11-03 05:00:00-04:00,0,11,5,3,0,2867,21842,24709
2016-11-03 06:00:00-04:00,0,11,6,3,0,2603,22594,25197
2016-11-03 07:00:00-04:00,0,11,7,3,0,2236,22663,24899
2016-11-03 08:00:00-04:00,0,11,8,3,0,1992,22269,24261
2016-11-03 09:00:00-04:00,0,11,9,3,0,1801,19812,21613
2016-11-03 10:00:00-04:00,0,11,10,3,0,1589,14982,16571
2016-11-03 11:00:00-04:00,0,11,11,3,0,1338,12364,13702
2016-11-03 12:00:00-04:00,0,11,12,3,0,964,8622,9586
2016-11-03 13:00:00-04:00,0,11,13,3,0,517,3948,4465
2016-11-03 14:00:00-04:00,0,11,14,3,0,334,2498,2832
2016-11-03 15:00:00-04:00,0,11,15,3,0,293,2314,2607
2016-11-03 16:00:00-04:00,0,11,16,3,0,305,3752,4057
2016-11-03 17:00:00-04:00,0,11,17,3,0,575,9942,10517
2016-11-03 18:00:00-04:00,0,11,18,3,0,1355,18049,19404
2016-11-03 19:00:00-04:00,0,11,19,3,0,1990,20215,22205
2016-11-03 20:00:00-04:00,0,11,20,3,0,1986,18296,20282
2016-11-03 21:00:00-04:00,0,11,21,3,0,1711,17134,18845
2016-11-03 22:00:00-04:00,0,11,22,3,0,1709,16804,18513
2016-11-03 23:00:00-04:00,0,11,23,3,0,1687,17844,19531
2016-11-04 00:00:00-04:00,0,11,0,4,0,1629,17476,19105
2016-11-04 01:00:00-04:00,0,11,1,4,0,1766,18098,19864
2016-11-04 02:00:00-04:00,0,11,2,4,0,1978,17492,19470
2016-11-04 03:00:00-04:00,0,11,3,4,0,2238,15327,17565
2016-11-04 04:00:00-04:00,0,11,4,4,0,2695,19004,21699
2016-11-04 05:00:00-04:00,0,11,5,4,0,2885,23064,25949
2016-11-04 06:00:00-04:00,0,11,6,4,0,2815,23679,26494
2016-11-04 07:00:00-04:00,0,11,7,4,0,2487,23229,25716
2016-11-04 08:00:00-04:00,0,11,8,4,0,2340,23638,25978
2016-11-04 09:00:00-04:00,0,11,9,4,0,2077,22125,24202
2016-11-04 10:00:00-04:00,0,11,10,4,0,1785,18879,20664
2016-11-04 11:00:00-04:00,0,11,11,4,0,1394,13308,14702
2016-11-04 12:00:00-04:00,0,11,12,4,0,936,8418,9354
2016-11-04 13:00:00-04:00,0,11,13,4,0,648,5457,6105
2016-11-04 14:00:00-04:00,0,11,14,4,0,496,3668,4164
2016-11-04 15:00:00-04:00,0,11,15,4,0,411,3221,3632
2016-11-04 16:00:00-04:00,0,11,16,4,0,316,4113,4429
2016-11-04 17:00:00-04:00,0,11,17,4,0,581,10277,10858
2016-11-04 18:00:00-04:00,0,11,18,4,0,1331,17447,18778
2016-11-04 19:00:00-04:00,0,11,19,4,0,2059,19681,21740
2016-11-04 20:00:00-04:00,0,11,20,4,0,1905,18160,20065
2016-11-04 21:00:00-04:00,0,11,21,4,0,1678,16718,18396
2016-11-04 22:00:00-04:00,0,11,22,4,0,1565,17080,18645
2016-11-04 23:00:00-04:00,0,11,23,4,0,1553,17695,19248
2016-11-05 00:00:00-04:00,0,11,0,5,0,1466,16954,18420
2016-11-05 01:00:00-04:00,0,11,1,5,0,1846,18276,20122
2016-11-05 02:00:00-04:00,0,11,2,5,0,2170,17187,19357
2016-11-05 03:00:00-04:00,0,11,3,5,0,2490,14592,17082
2016-11-05 04:00:00-04:00,0,11,4,5,0,3023,18513,21536
2016-11-05 05:00:00-04:00,0,11,5,5,0,3366,22616,25982
2016-11-05 06:00:00-04:00,0,11,6,5,0,3383,24084,27467
2016-11-05 07:00:00-04:00,0,11,7,5,0,3195,22925,26120
2016-11-05 08:00:00-04:00,0,11,8,5,0,3135,22234,25369
2016-11-05 09:00:00-04:00,0,11,9,5,0,3182,23463,26645
2016-11-05 10:00:00-04:00,0,11,10,5,0,3166,22583,25749
2016-11-05 11:00:00-04:00,0,11,11,5,0,2905,20798,23703
2016-11-05 12:00:00-04:00,0,11,12,5,0,2425,17445,19870
2016-11-05 13:00:00-04:00,0,11,13,5,0,2109,13870,15979
2016-11-05 14:00:00-04:00,0,11,14,5,0,1701,10233,11934
2016-11-05 15:00:00-04:00,0,11,15,5,0,1235,6552,7787
2016-11-05 16:00:00-04:00,0,11,16,5,0,591,3206,3797
2016-11-05 17:00:00-04:00,0,11,17,5,0,462,4519,4981
2016-11-05 18:00:00-04:00,0,11,18,5,0,748,7932,8680
2016-11-05 19:00:00-04:00,0,11,19,5,0,1056,11726,12782
2016-11-05 20:00:00-04:00,0,11,20,5,0,1435,15147,16582
2016-11-05 21:00:00-04:00,0,11,21,5,0,1515,17390,18905
2016-11-05 22:00:00-04:00,0,11,22,5,0,1732,18968,20700
2016-11-05 23:00:00-04:00,0,11,23,5,0,1914,20046,21960
2016-11-06 00:00:00-04:00,0,11,0,6,0,1961,19989,21950
2016-11-06 01:00:00-04:00,0,11,1,6,0,2141,19449,21590
2016-11-06 01:00:00-05:00,0,11,1,6,0,2338,19718,22056
2016-11-06 02:00:00-05:00,0,11,2,6,0,2496,17874,20370
2016-11-06 03:00:00-05:00,0,11,3,6,0,2673,20153,22826
2016-11-06 04:00:00-05:00,0,11,4,6,0,3068,22885,25953
2016-11-06 05:00:00-05:00,0,11,5,6,0,3105,23177,26282
2016-11-06 06:00:00-05:00,0,11,6,6,0,2916,19560,22476
2016-11-06 07:00:00-05:00,0,11,7,6,0,2920,19187,22107
2016-11-06 08:00:00-05:00,0,11,8,6,0,3082,20639,23721
2016-11-06 09:00:00-05:00,0,11,9,6,0,3163,21832,24995
2016-11-06 10:00:00-05:00,0,11,10,6,0,3073,21093,24166
2016-11-06 11:00:00-05:00,0,11,11,6,0,5159,33898,39057
2016-11-06 12:00:00-05:00,0,11,12,6,0,1880,11615,13495
2016-11-06 13:00:00-05:00,0,11,13,6,0,1497,7656,9153
2016-11-06 14:00:00-05:00,0,11,14,6,0,1027,5060,6087
2016-11-06 15:00:00-05:00,0,11,15,6,0,539,4892,5431
2016-11-06 16:00:00-05:00,0,11,16,6,0,469,4752,5221
2016-11-06 17:00:00-05:00,0,11,17,6,0,532,5735,6267
2016-11-06 18:00:00-05:00,0,11,18,6,0,757,7637,8394
2016-11-06 19:00:00-05:00,0,11,19,6,0,970,11386,12356
2016-11-06 20:00:00-05:00,0,11,20,6,0,1198,14512,15710
2016-11-06 21:00:00-05:00,0,11,21,6,0,1372,16269,17641
2016-11-06 22:00:00-05:00,0,11,22,6,0,1411,16787,18198
2016-11-06 23:00:00-05:00,0,11,23,6,0,1614,16982,18596
2016-11-07 00:00:00-05:00,0,11,0,0,0,1703,17783,19486
2016-11-07 01:00:00-05:00,0,11,1,0,0,1918,17021,18939
2016-11-07 02:00:00-05:00,0,11,2,0,0,2187,16057,18244
2016-11-07 03:00:00-05:00,0,11,3,0,0,2314,16874,19188
2016-11-07 04:00:00-05:00,0,11,4,0,0,2198,18235,20433
2016-11-07 05:00:00-05:00,0,11,5,0,0,2194,17778,19972
2016-11-07 06:00:00-05:00,0,11,6,0,0,2095,16583,18678
2016-11-07 07:00:00-05:00,0,11,7,0,0,1770,15868,17638
2016-11-07 08:00:00-05:00,0,11,8,0,0,1556,12843,14399
2016-11-07 09:00:00-05:00,0,11,9,0,0,1258,9414,10672
2016-11-07 10:00:00-05:00,0,11,10,0,0,873,5809,6682
2016-11-07 11:00:00-05:00,0,11,11,0,0,553,3527,4080
2016-11-07 12:00:00-05:00,0,11,12,0,0,331,2203,2534
2016-11-07 13:00:00-05:00,0,11,13,0,0,256,1683,1939
2016-11-07 14:00:00-05:00,0,11,14,0,0,263,2050,2313
2016-11-07 15:00:00-05:00,0,11,15,0,0,277,3837,4114
2016-11-07 16:00:00-05:00,0,11,16,0,0,663,10287,10950
2016-11-07 17:00:00-05:00,0,11,17,0,0,1410,16661,18071
2016-11-07 18:00:00-05:00,0,11,18,0,0,2017,18370,20387
2016-11-07 19:00:00-05:00,0,11,19,0,0,1732,16218,17950
2016-11-07 20:00:00-05:00,0,11,20,0,0,1514,15280,16794
2016-11-07 21:00:00-05:00,0,11,21,0,0,1332,15405,16737
2016-11-07 22:00:00-05:00,0,11,22,0,0,1355,15584,16939
2016-11-07 23:00:00-05:00,0,11,23,0,0,1480,16520,18000
2016-11-08 00:00:00-05:00,0,11,0,1,0,1749,18729,20478
2016-11-08 01:00:00-05:00,0,11,1,1,0,1815,17743,19558
2016-11-08 02:00:00-05:00,0,11,2,1,0,1967,15757,17724
2016-11-08 03:00:00-05:00,0,11,3,1,0,2290,19064,21354
2016-11-08 04:00:00-05:00,0,11,4,1,0,2437,21390,23827
2016-11-08 05:00:00-05:00,0,11,5,1,0,2235,21079,23314
2016-11-08 06:00:00-05:00,0,11,6,1,0,1920,19473,21393
2016-11-08 07:00:00-05:00,0,11,7,1,0,1643,18707,20350
2016-11-08 08:00:00-05:00,0,11,8,1,0,1329,15838,17167
2016-11-08 09:00:00-05:00,0,11,9,1,0,1066,11452,12518
2016-11-08 10:00:00-05:00,0,11,10,1,0,777,7317,8094
2016-11-08 11:00:00-05:00,0,11,11,1,0,465,4243,4708
2016-11-08 12:00:00-05:00,0,11,12,1,0,315,2594,2909
2016-11-08 13:00:00-05:00,0,11,13,1,0,198,1703,1901
2016-11-08 14:00:00-05:00,0,11,14,1,0,233,2099,2332
2016-11-08 15:00:00-05:00,0,11,15,1,0,236,3444,3680
2016-11-08 16:00:00-05:00,0,11,16,1,0,587,10381,10968
2016-11-08 17:00:00-05:00,0,11,17,1,0,1078,15741,16819
2016-11-08 18:00:00-05:00,0,11,18,1,0,1502,17254,18756
2016-11-08 19:00:00-05:00,0,11,19,1,0,1503,16280,17783
2016-11-08 20:00:00-05:00,0,11,20,1,0,1430,15945,17375
2016-11-08 21:00:00-05:00,0,11,21,1,0,1302,15393,16695
2016-11-08 22:00:00-05:00,0,11,22,1,0,1353,15795,17148
2016-11-08 23:00:00-05:00,0,11,23,1,0,1398,15771,17169
2016-11-09 00:00:00-05:00,0,11,0,2,0,1501,17082,18583
2016-11-09 01:00:00-05:00,0,11,1,2,0,1728,17213,18941
2016-11-09 02:00:00-05:00,0,11,2,2,0,1944,14889,16833
2016-11-09 03:00:00-05:00,0,11,3,2,0,2097,16979,19076
2016-11-09 04:00:00-05:00,0,11,4,2,0,2321,20268,22589
2016-11-09 05:00:00-05:00,0,11,5,2,0,2225,20805,23030
2016-11-09 06:00:00-05:00,0,11,6,2,0,1809,18172,19981
2016-11-09 07:00:00-05:00,0,11,7,2,0,1553,17323,18876
2016-11-09 08:00:00-05:00,0,11,8,2,0,1518,16420,17938
2016-11-09 09:00:00-05:00,0,11,9,2,0,1316,15870,17186
2016-11-09 10:00:00-05:00,0,11,10,2,0,1162,13896,15058
2016-11-09 11:00:00-05:00,0,11,11,2,0,888,9973,10861
2016-11-09 12:00:00-05:00,0.01,11,12,2,0,590,6451,7041
2016-11-09 13:00:00-05:00,0,11,13,2,0,430,4788,5218
2016-11-09 14:00:00-05:00,0,11,14,2,0,308,3426,3734
2016-11-09 15:00:00-05:00,0,11,15,2,0,305,4724,5029
2016-11-09 16:00:00-05:00,0,11,16,2,0,570,10582,11152
2016-11-09 17:00:00-05:00,0,11,17,2,0,1341,17272,18613
2016-11-09 18:00:00-05:00,0.01,11,18,2,0,1836,19451,21287
2016-11-09 19:00:00-05:00,0,11,19,2,0,1914,18883,20797
2016-11-09 20:00:00-05:00,0,11,20,2,0,1642,16561,18203
2016-11-09 21:00:00-05:00,0,11,21,2,0,1456,16686,18142
2016-11-09 22:00:00-05:00,0,11,22,2,0,1604,17113,18717
2016-11-09 23:00:00-05:00,0,11,23,2,0,1562,16193,17755
2016-11-10 00:00:00-05:00,0,11,0,3,0,1588,17022,18610
2016-11-10 01:00:00-05:00,0,11,1,3,0,1895,15615,17510
2016-11-10 02:00:00-05:00,0,11,2,3,0,2035,13593,15628
2016-11-10 03:00:00-05:00,0,11,3,3,0,2509,17886,20395
2016-11-10 04:00:00-05:00,0,11,4,3,0,2824,20541,23365
2016-11-10 05:00:00-05:00,0,11,5,3,0,2607,20364,22971
2016-11-10 06:00:00-05:00,0,11,6,3,0,2185,19885,22070
2016-11-10 07:00:00-05:00,0,11,7,3,0,2022,21263,23285
2016-11-10 08:00:00-05:00,0,11,8,3,0,1781,19049,20830
2016-11-10 09:00:00-05:00,0,11,9,3,0,1347,13801,15148
2016-11-10 10:00:00-05:00,0,11,10,3,0,1007,8916,9923
2016-11-10 11:00:00-05:00,0,11,11,3,0,571,5060,5631
2016-11-10 12:00:00-05:00,0,11,12,3,0,341,3093,3434
2016-11-10 13:00:00-05:00,0,11,13,3,0,264,2145,2409
2016-11-10 14:00:00-05:00,0,11,14,3,0,233,2272,2505
2016-11-10 15:00:00-05:00,0,11,15,3,0,247,3798,4045
2016-11-10 16:00:00-05:00,0,11,16,3,0,640,10278,10918
2016-11-10 17:00:00-05:00,0,11,17,3,0,1419,17819,19238
2016-11-10 18:00:00-05:00,0,11,18,3,0,1950,20016,21966
2016-11-10 19:00:00-05:00,0,11,19,3,0,1868,18273,20141
2016-11-10 20:00:00-05:00,0,11,20,3,0,1562,16864,18426
2016-11-10 21:00:00-05:00,0,11,21,3,0,1479,16417,17896
2016-11-10 22:00:00-05:00,0,11,22,3,0,1406,17354,18760
2016-11-10 23:00:00-05:00,0,11,23,3,0,1586,17171,18757
2016-11-11 00:00:00-05:00,0,11,0,4,1,1683,18243,19926
2016-11-11 01:00:00-05:00,0,11,1,4,1,1999,16920,18919
2016-11-11 02:00:00-05:00,0,11,2,4,1,2202,14253,16455
2016-11-11 03:00:00-05:00,0,11,3,4,1,2607,17927,20534
2016-11-11 04:00:00-05:00,0,11,4,4,1,2912,21927,24839
2016-11-11 05:00:00-05:00,0,11,5,4,1,2790,22761,25551
2016-11-11 06:00:00-05:00,0,11,6,4,1,2600,22815,25415
2016-11-11 07:00:00-05:00,0,11,7,4,1,2483,23240,25723
2016-11-11 08:00:00-05:00,0,11,8,4,1,2315,22244,24559
2016-11-11 09:00:00-05:00,0,11,9,4,1,2263,19824,22087
2016-11-11 10:00:00-05:00,0,11,10,4,1,1777,15371,17148
2016-11-11 11:00:00-05:00,0,11,11,4,1,1236,10026,11262
2016-11-11 12:00:00-05:00,0,11,12,4,1,836,6820,7656
2016-11-11 13:00:00-05:00,0,11,13,4,1,536,4674,5210
2016-11-11 14:00:00-05:00,0,11,14,4,1,453,3839,4292
2016-11-11 15:00:00-05:00,0,11,15,4,1,296,4162,4458
2016-11-11 16:00:00-05:00,0,11,16,4,1,548,8244,8792
2016-11-11 17:00:00-05:00,0,11,17,4,1,973,14384,15357
2016-11-11 18:00:00-05:00,0,11,18,4,1,1467,16742,18209
2016-11-11 19:00:00-05:00,0,11,19,4,1,1570,16227,17797
2016-11-11 20:00:00-05:00,0,11,20,4,1,1483,15795,17278
2016-11-11 21:00:00-05:00,0,11,21,4,1,1412,15627,17039
2016-11-11 22:00:00-05:00,0,11,22,4,1,1308,16072,17380
2016-11-11 23:00:00-05:00,0,11,23,4,1,1435,16174,17609
2016-11-12 00:00:00-05:00,0,11,0,5,0,1772,17019,18791
2016-11-12 01:00:00-05:00,0,11,1,5,0,2135,15308,17443
2016-11-12 02:00:00-05:00,0,11,2,5,0,2439,13335,15774
2016-11-12 03:00:00-05:00,0,11,3,5,0,2793,17706,20499
2016-11-12 04:00:00-05:00,0,11,4,5,0,3274,21901,25175
2016-11-12 05:00:00-05:00,0,11,5,5,0,3289,23990,27279
2016-11-12 06:00:00-05:00,0,11,6,5,0,3141,22806,25947
2016-11-12 07:00:00-05:00,0,11,7,5,0,2994,22623,25617
2016-11-12 08:00:00-05:00,0,11,8,5,0,2996,23404,26400
2016-11-12 09:00:00-05:00,0,11,9,5,0,3047,23018,26065
2016-11-12 10:00:00-05:00,0,11,10,5,0,2880,21248,24128
2016-11-12 11:00:00-05:00,0,11,11,5,0,2393,18283,20676
2016-11-12 12:00:00-05:00,0,11,12,5,0,1956,14646,16602
2016-11-12 13:00:00-05:00,0,11,13,5,0,1581,11065,12646
2016-11-12 14:00:00-05:00,0,11,14,5,0,1219,7156,8375
2016-11-12 15:00:00-05:00,0,11,15,5,0,580,3156,3736
2016-11-12 16:00:00-05:00,0,11,16,5,0,505,4155,4660
2016-11-12 17:00:00-05:00,0,11,17,5,0,670,6554,7224
2016-11-12 18:00:00-05:00,0,11,18,5,0,968,10269,11237
2016-11-12 19:00:00-05:00,0,11,19,5,0,1258,14442,15700
2016-11-12 20:00:00-05:00,0,11,20,5,0,1547,17127,18674
2016-11-12 21:00:00-05:00,0,11,21,5,0,1663,19278,20941
2016-11-12 22:00:00-05:00,0,11,22,5,0,1757,20120,21877
2016-11-12 23:00:00-05:00,0,11,23,5,0,1952,19496,21448
2016-11-13 00:00:00-05:00,0,11,0,6,0,2023,17755,19778
2016-11-13 01:00:00-05:00,0,11,1,6,0,2277,17597,19874
2016-11-13 02:00:00-05:00,0,11,2,6,0,2502,15881,18383
2016-11-13 03:00:00-05:00,0,11,3,6,0,2672,18616,21288
2016-11-13 04:00:00-05:00,0,11,4,6,0,2908,21509,24417
2016-11-13 05:00:00-05:00,0,11,5,6,0,3038,22509,25547
2016-11-13 06:00:00-05:00,0,11,6,6,0,2786,18846,21632
2016-11-13 07:00:00-05:00,0,11,7,6,0,3004,19281,22285
2016-11-13 08:00:00-05:00,0,11,8,6,0,2893,21608,24501
2016-11-13 09:00:00-05:00,0,11,9,6,0,3155,22001,25156
2016-11-13 10:00:00-05:00,0,11,10,6,0,2998,20678,23676
2016-11-13 11:00:00-05:00,0,11,11,6,0,2824,20651,23475
2016-11-13 12:00:00-05:00,0,11,12,6,0,2358,17850,20208
2016-11-13 13:00:00-05:00,0,11,13,6,0,1945,13204,15149
2016-11-13 14:00:00-05:00,0,11,14,6,0,1507,9104,10611
2016-11-13 15:00:00-05:00,0,11,15,6,0,735,4186,4921
2016-11-13 16:00:00-05:00,0,11,16,6,0,534,4067,4601
2016-11-13 17:00:00-05:00,0,11,17,6,0,617,5779,6396
2016-11-13 18:00:00-05:00,0,11,18,6,0,754,8852,9606
2016-11-13 19:00:00-05:00,0,11,19,6,0,1001,12805,13806
2016-11-13 20:00:00-05:00,0,11,20,6,0,1351,16427,17778
2016-11-13 21:00:00-05:00,0,11,21,6,0,1475,17726,19201
2016-11-13 22:00:00-05:00,0,11,22,6,0,1528,18842,20370
2016-11-13 23:00:00-05:00,0,11,23,6,0,1709,18497,20206
2016-11-14 00:00:00-05:00,0,11,0,0,0,1782,18443,20225
2016-11-14 01:00:00-05:00,0,11,1,0,0,2065,17813,19878
2016-11-14 02:00:00-05:00,0,11,2,0,0,2109,15697,17806
2016-11-14 03:00:00-05:00,0,11,3,0,0,2240,16072,18312
2016-11-14 04:00:00-05:00,0,11,4,0,0,2146,16741,18887
2016-11-14 05:00:00-05:00,0,11,5,0,0,2151,15976,18127
2016-11-14 06:00:00-05:00,0,11,6,0,0,1896,14811,16707
2016-11-14 07:00:00-05:00,0,11,7,0,0,1740,14297,16037
2016-11-14 08:00:00-05:00,0,11,8,0,0,1555,11999,13554
2016-11-14 09:00:00-05:00,0,11,9,0,0,1216,9114,10330
2016-11-14 10:00:00-05:00,0,11,10,0,0,916,5817,6733
2016-11-14 11:00:00-05:00,0,11,11,0,0,583,3653,4236
2016-11-14 12:00:00-05:00,0,11,12,0,0,359,2345,2704
2016-11-14 13:00:00-05:00,0,11,13,0,0,291,1673,1964
2016-11-14 14:00:00-05:00,0,11,14,0,0,338,2330,2668
2016-11-14 15:00:00-05:00,0,11,15,0,0,345,4186,4531
2016-11-14 16:00:00-05:00,0,11,16,0,0,660,10419,11079
2016-11-14 17:00:00-05:00,0,11,17,0,0,1392,16378,17770
2016-11-14 18:00:00-05:00,0,11,18,0,0,1927,18136,20063
2016-11-14 19:00:00-05:00,0,11,19,0,0,1935,17605,19540
2016-11-14 20:00:00-05:00,0,11,20,0,0,1758,15525,17283
2016-11-14 21:00:00-05:00,0,11,21,0,0,1427,15425,16852
2016-11-14 22:00:00-05:00,0,11,22,0,0,1348,15353,16701
2016-11-14 23:00:00-05:00,0,11,23,0,0,1388,15506,16894
2016-11-15 00:00:00-05:00,0,11,0,1,0,1662,17171,18833
2016-11-15 01:00:00-05:00,0,11,1,1,0,1826,17031,18857
2016-11-15 02:00:00-05:00,0,11,2,1,0,2003,15354,17357
2016-11-15 03:00:00-05:00,0.02,11,3,1,0,2165,17987,20152
2016-11-15 04:00:00-05:00,0,11,4,1,0,2343,21157,23500
2016-11-15 05:00:00-05:00,0.04,11,5,1,0,2136,20014,22150
2016-11-15 06:00:00-05:00,0.11,11,6,1,0,1867,19011,20878
2016-11-15 07:00:00-05:00,0.36,11,7,1,0,1548,18746,20294
2016-11-15 08:00:00-05:00,0.19,11,8,1,0,1403,16474,17877
2016-11-15 09:00:00-05:00,0.16,11,9,1,0,1069,11771,12840
2016-11-15 10:00:00-05:00,0.3,11,10,1,0,811,7952,8763
2016-11-15 11:00:00-05:00,0.3,11,11,1,0,546,4875,5421
2016-11-15 12:00:00-05:00,0.13,11,12,1,0,333,2695,3028
2016-11-15 13:00:00-05:00,0,11,13,1,0,241,1894,2135
2016-11-15 14:00:00-05:00,0,11,14,1,0,237,1913,2150
2016-11-15 15:00:00-05:00,0,11,15,1,0,261,3945,4206
2016-11-15 16:00:00-05:00,0,11,16,1,0,666,11707,12373
2016-11-15 17:00:00-05:00,0,11,17,1,0,1608,19897,21505
2016-11-15 18:00:00-05:00,0,11,18,1,0,2157,20864,23021
2016-11-15 19:00:00-05:00,0,11,19,1,0,2190,19590,21780
2016-11-15 20:00:00-05:00,0,11,20,1,0,1916,17657,19573
2016-11-15 21:00:00-05:00,0,11,21,1,0,1849,16769,18618
2016-11-15 22:00:00-05:00,0,11,22,1,0,1475,16318,17793
2016-11-15 23:00:00-05:00,0,11,23,1,0,1408,15098,16506
2016-11-16 00:00:00-05:00,0,11,0,2,0,1593,16625,18218
2016-11-16 01:00:00-05:00,0,11,1,2,0,1860,16521,18381
2016-11-16 02:00:00-05:00,0,11,2,2,0,2042,14713,16755
2016-11-16 03:00:00-05:00,0,11,3,2,0,2411,18267,20678
2016-11-16 04:00:00-05:00,0,11,4,2,0,2684,22193,24877
2016-11-16 05:00:00-05:00,0,11,5,2,0,2432,22178,24610
2016-11-16 06:00:00-05:00,0,11,6,2,0,2082,21887,23969
2016-11-16 07:00:00-05:00,0,11,7,2,0,1908,22162,24070
2016-11-16 08:00:00-05:00,0,11,8,2,0,1539,19502,21041
2016-11-16 09:00:00-05:00,0,11,9,2,0,1340,14661,16001
2016-11-16 10:00:00-05:00,0,11,10,2,0,1013,10537,11550
2016-11-16 11:00:00-05:00,0,11,11,2,0,688,5298,5986
2016-11-16 12:00:00-05:00,0,11,12,2,0,405,3048,3453
2016-11-16 13:00:00-05:00,0,11,13,2,0,268,2025,2293
2016-11-16 14:00:00-05:00,0,11,14,2,0,267,2069,2336
2016-11-16 15:00:00-05:00,0,11,15,2,0,265,3791,4056
2016-11-16 16:00:00-05:00,0,11,16,2,0,588,10415,11003
2016-11-16 17:00:00-05:00,0,11,17,2,0,1318,17877,19195
2016-11-16 18:00:00-05:00,0,11,18,2,0,1880,19432,21312
2016-11-16 19:00:00-05:00,0,11,19,2,0,1803,17746,19549
2016-11-16 20:00:00-05:00,0,11,20,2,0,1530,16330,17860
2016-11-16 21:00:00-05:00,0,11,21,2,0,1476,16065,17541
2016-11-16 22:00:00-05:00,0,11,22,2,0,1422,16502,17924
2016-11-16 23:00:00-05:00,0,11,23,2,0,1473,16420,17893
2016-11-17 00:00:00-05:00,0,11,0,3,0,1678,17536,19214
2016-11-17 01:00:00-05:00,0,11,1,3,0,1894,16107,18001
2016-11-17 02:00:00-05:00,0,11,2,3,0,2163,13755,15918
2016-11-17 03:00:00-05:00,0,11,3,3,0,2503,17449,19952
2016-11-17 04:00:00-05:00,0,11,4,3,0,2709,21500,24209
2016-11-17 05:00:00-05:00,0,11,5,3,0,2677,22166,24843
2016-11-17 06:00:00-05:00,0,11,6,3,0,2351,22330,24681
2016-11-17 07:00:00-05:00,0,11,7,3,0,1992,22605,24597
2016-11-17 08:00:00-05:00,0,11,8,3,0,1802,21014,22816
2016-11-17 09:00:00-05:00,0,11,9,3,0,1525,16308,17833
2016-11-17 10:00:00-05:00,0,11,10,3,0,1067,10647,11714
2016-11-17 11:00:00-05:00,0,11,11,3,0,667,6028,6695
2016-11-17 12:00:00-05:00,0,11,12,3,0,416,3676,4092
2016-11-17 13:00:00-05:00,0,11,13,3,0,314,2412,2726
2016-11-17 14:00:00-05:00,0,11,14,3,0,279,2292,2571
2016-11-17 15:00:00-05:00,0,11,15,3,0,262,3887,4149
2016-11-17 16:00:00-05:00,0,11,16,3,0,614,10269,10883
2016-11-17 17:00:00-05:00,0,11,17,3,0,1436,18170,19606
2016-11-17 18:00:00-05:00,0,11,18,3,0,1910,19566,21476
2016-11-17 19:00:00-05:00,0,11,19,3,0,1822,17653,19475
2016-11-17 20:00:00-05:00,0,11,20,3,0,1597,16210,17807
2016-11-17 21:00:00-05:00,0,11,21,3,0,1458,16304,17762
2016-11-17 22:00:00-05:00,0,11,22,3,0,1393,16740,18133
2016-11-17 23:00:00-05:00,0,11,23,3,0,1600,16871,18471
2016-11-18 00:00:00-05:00,0,11,0,4,0,1851,18190,20041
2016-11-18 01:00:00-05:00,0,11,1,4,0,2051,16729,18780
2016-11-18 02:00:00-05:00,0,11,2,4,0,2318,13861,16179
2016-11-18 03:00:00-05:00,0,11,3,4,0,2641,17431,20072
2016-11-18 04:00:00-05:00,0,11,4,4,0,2845,21262,24107
2016-11-18 05:00:00-05:00,0,11,5,4,0,2965,22464,25429
2016-11-18 06:00:00-05:00,0,11,6,4,0,2684,22987,25671
2016-11-18 07:00:00-05:00,0,11,7,4,0,2390,23734,26124
2016-11-18 08:00:00-05:00,0,11,8,4,0,2192,22700,24892
2016-11-18 09:00:00-05:00,0,11,9,4,0,1849,19903,21752
2016-11-18 10:00:00-05:00,0,11,10,4,0,1540,14522,16062
2016-11-18 11:00:00-05:00,0,11,11,4,0,1098,9053,10151
2016-11-18 12:00:00-05:00,0,11,12,4,0,764,5876,6640
2016-11-18 13:00:00-05:00,0,11,13,4,0,531,3922,4453
2016-11-18 14:00:00-05:00,0,11,14,4,0,452,3351,3803
2016-11-18 15:00:00-05:00,0,11,15,4,0,312,4418,4730
2016-11-18 16:00:00-05:00,0,11,16,4,0,648,10362,11010
2016-11-18 17:00:00-05:00,0,11,17,4,0,1410,17573,18983
2016-11-18 18:00:00-05:00,0,11,18,4,0,2052,19419,21471
2016-11-18 19:00:00-05:00,0,11,19,4,0,1902,17551,19453
2016-11-18 20:00:00-05:00,0,11,20,4,0,1658,16001,17659
2016-11-18 21:00:00-05:00,0,11,21,4,0,1588,16439,18027
2016-11-18 22:00:00-05:00,0,11,22,4,0,1436,16728,18164
2016-11-18 23:00:00-05:00,0,11,23,4,0,1645,17168,18813
2016-11-19 00:00:00-05:00,0,11,0,5,0,1970,18401,20371
2016-11-19 01:00:00-05:00,0,11,1,5,0,2236,16969,19205
2016-11-19 02:00:00-05:00,0,11,2,5,0,2533,14279,16812
2016-11-19 03:00:00-05:00,0,11,3,5,0,2978,17862,20840
2016-11-19 04:00:00-05:00,0,11,4,5,0,3163,22133,25296
2016-11-19 05:00:00-05:00,0,11,5,5,0,3115,23803,26918
2016-11-19 06:00:00-05:00,0,11,6,5,0,3075,21678,24753
2016-11-19 07:00:00-05:00,0,11,7,5,0,2960,21413,24373
2016-11-19 08:00:00-05:00,0,11,8,5,0,2973,21835,24808
2016-11-19 09:00:00-05:00,0,11,9,5,0,3049,21572,24621
2016-11-19 10:00:00-05:00,0,11,10,5,0,2747,19743,22490
2016-11-19 11:00:00-05:00,0,11,11,5,0,2422,16951,19373
2016-11-19 12:00:00-05:00,0,11,12,5,0,2106,14208,16314
2016-11-19 13:00:00-05:00,0,11,13,5,0,1696,10842,12538
2016-11-19 14:00:00-05:00,0,11,14,5,0,1323,6892,8215
2016-11-19 15:00:00-05:00,0,11,15,5,0,650,3692,4342
2016-11-19 16:00:00-05:00,0,11,16,5,0,532,4826,5358
2016-11-19 17:00:00-05:00,0,11,17,5,0,692,6503,7195
2016-11-19 18:00:00-05:00,0,11,18,5,0,1008,9917,10925
2016-11-19 19:00:00-05:00,0,11,19,5,0,1421,13992,15413
2016-11-19 20:00:00-05:00,0,11,20,5,0,1663,15792,17455
2016-11-19 21:00:00-05:00,0.01,11,21,5,0,1673,17390,19063
2016-11-19 22:00:00-05:00,0.09,11,22,5,0,1755,18808,20563
2016-11-19 23:00:00-05:00,0.07,11,23,5,0,2002,19420,21422
2016-11-20 00:00:00-05:00,0.23,11,0,6,0,2015,19037,21052
2016-11-20 01:00:00-05:00,0.11,11,1,6,0,2332,20078,22410
2016-11-20 02:00:00-05:00,0.06,11,2,6,0,2607,16623,19230
2016-11-20 03:00:00-05:00,0.01,11,3,6,0,2743,19044,21787
2016-11-20 04:00:00-05:00,0,11,4,6,0,2920,21427,24347
2016-11-20 05:00:00-05:00,0,11,5,6,0,2938,22066,25004
2016-11-20 06:00:00-05:00,0,11,6,6,0,2809,17947,20756
2016-11-20 07:00:00-05:00,0,11,7,6,0,3648,23409,27057
2016-11-20 08:00:00-05:00,0,11,8,6,0,3515,22591,26106
2016-11-20 09:00:00-05:00,0,11,9,6,0,3896,23173,27069
2016-11-20 10:00:00-05:00,0,11,10,6,0,3521,20689,24210
2016-11-20 11:00:00-05:00,0,11,11,6,0,3017,17305,20322
2016-11-20 12:00:00-05:00,0,11,12,6,0,2269,14840,17109
2016-11-20 13:00:00-05:00,0,11,13,6,0,1852,11176,13028
2016-11-20 14:00:00-05:00,0,11,14,6,0,1427,7001,8428
2016-11-20 15:00:00-05:00,0,11,15,6,0,730,3001,3731
2016-11-20 16:00:00-05:00,0,11,16,6,0,502,3544,4046
2016-11-20 17:00:00-05:00,0,11,17,6,0,563,5077,5640
2016-11-20 18:00:00-05:00,0,11,18,6,0,781,7652,8433
2016-11-20 19:00:00-05:00,0,11,19,6,0,1106,12263,13369
2016-11-20 20:00:00-05:00,0,11,20,6,0,1370,16225,17595
2016-11-20 21:00:00-05:00,0,11,21,6,0,1595,18672,20267
2016-11-20 22:00:00-05:00,0,11,22,6,0,1768,19798,21566
2016-11-20 23:00:00-05:00,0,11,23,6,0,2040,20123,22163
2016-11-21 00:00:00-05:00,0,11,0,0,0,2068,19848,21916
2016-11-21 01:00:00-05:00,0,11,1,0,0,2244,19284,21528
2016-11-21 02:00:00-05:00,0,11,2,0,0,2341,18323,20664
2016-11-21 03:00:00-05:00,0,11,3,0,0,2431,18297,20728
2016-11-21 04:00:00-05:00,0,11,4,0,0,2321,18379,20700
2016-11-21 05:00:00-05:00,0,11,5,0,0,2225,16477,18702
2016-11-21 06:00:00-05:00,0,11,6,0,0,1958,14388,16346
2016-11-21 07:00:00-05:00,0,11,7,0,0,1826,13687,15513
2016-11-21 08:00:00-05:00,0,11,8,0,0,1621,12451,14072
2016-11-21 09:00:00-05:00,0,11,9,0,0,1313,9466,10779
2016-11-21 10:00:00-05:00,0,11,10,0,0,953,6363,7316
2016-11-21 11:00:00-05:00,0,11,11,0,0,583,3450,4033
2016-11-21 12:00:00-05:00,0,11,12,0,0,386,2041,2427
2016-11-21 13:00:00-05:00,0,11,13,0,0,270,1520,1790
2016-11-21 14:00:00-05:00,0,11,14,0,0,320,1848,2168
2016-11-21 15:00:00-05:00,0,11,15,0,0,326,3480,3806
2016-11-21 16:00:00-05:00,0,11,16,0,0,603,9495,10098
2016-11-21 17:00:00-05:00,0,11,17,0,0,1421,16556,17977
2016-11-21 18:00:00-05:00,0,11,18,0,0,2128,18475,20603
2016-11-21 19:00:00-05:00,0,11,19,0,0,1975,17041,19016
2016-11-21 20:00:00-05:00,0,11,20,0,0,1676,15858,17534
2016-11-21 21:00:00-05:00,0,11,21,0,0,1519,16114,17633
2016-11-21 22:00:00-05:00,0,11,22,0,0,1538,16943,18481
2016-11-21 23:00:00-05:00,0,11,23,0,0,1700,17177,18877
2016-11-22 00:00:00-05:00,0,11,0,1,0,1689,18388,20077
2016-11-22 01:00:00-05:00,0,11,1,1,0,1989,18109,20098
2016-11-22 02:00:00-05:00,0,11,2,1,0,2238,15569,17807
2016-11-22 03:00:00-05:00,0,11,3,1,0,2488,18697,21185
2016-11-22 04:00:00-05:00,0,11,4,1,0,2740,21621,24361
2016-11-22 05:00:00-05:00,0,11,5,1,0,2578,21604,24182
2016-11-22 06:00:00-05:00,0,11,6,1,0,2162,20342,22504
2016-11-22 07:00:00-05:00,0,11,7,1,0,1880,19276,21156
2016-11-22 08:00:00-05:00,0,11,8,1,0,1463,16848,18311
2016-11-22 09:00:00-05:00,0,11,9,1,0,1215,11996,13211
2016-11-22 10:00:00-05:00,0,11,10,1,0,885,7678,8563
2016-11-22 11:00:00-05:00,0,11,11,1,0,602,4335,4937
2016-11-22 12:00:00-05:00,0,11,12,1,0,319,2522,2841
2016-11-22 13:00:00-05:00,0,11,13,1,0,207,1661,1868
2016-11-22 14:00:00-05:00,0,11,14,1,0,240,2127,2367
2016-11-22 15:00:00-05:00,0,11,15,1,0,246,3924,4170
2016-11-22 16:00:00-05:00,0,11,16,1,0,565,10072,10637
2016-11-22 17:00:00-05:00,0,11,17,1,0,1370,17401,18771
2016-11-22 18:00:00-05:00,0,11,18,1,0,1970,19851,21821
2016-11-22 19:00:00-05:00,0,11,19,1,0,1883,18808,20691
2016-11-22 20:00:00-05:00,0,11,20,1,0,1643,17194,18837
2016-11-22 21:00:00-05:00,0,11,21,1,0,1637,17372,19009
2016-11-22 22:00:00-05:00,0,11,22,1,0,1498,18020,19518
2016-11-22 23:00:00-05:00,0,11,23,1,0,1705,18253,19958
2016-11-23 00:00:00-05:00,0,11,0,2,0,1926,19596,21522
2016-11-23 01:00:00-05:00,0,11,1,2,0,2156,18162,20318
2016-11-23 02:00:00-05:00,0,11,2,2,0,2305,14533,16838
2016-11-23 03:00:00-05:00,0,11,3,2,0,2619,17425,20044
2016-11-23 04:00:00-05:00,0,11,4,2,0,2754,20836,23590
2016-11-23 05:00:00-05:00,0,11,5,2,0,2928,21409,24337
2016-11-23 06:00:00-05:00,0,11,6,2,0,2510,20743,23253
2016-11-23 07:00:00-05:00,0,11,7,2,0,2160,20226,22386
2016-11-23 08:00:00-05:00,0,11,8,2,0,1770,18995,20765
2016-11-23 09:00:00-05:00,0,11,9,2,0,1467,14319,15786
2016-11-23 10:00:00-05:00,0,11,10,2,0,1085,9870,10955
2016-11-23 11:00:00-05:00,0,11,11,2,0,711,6202,6913
2016-11-23 12:00:00-05:00,0,11,12,2,0,403,3794,4197
2016-11-23 13:00:00-05:00,0,11,13,2,0,330,2591,2921
2016-11-23 14:00:00-05:00,0,11,14,2,0,286,2829,3115
2016-11-23 15:00:00-05:00,0,11,15,2,0,305,3952,4257
2016-11-23 16:00:00-05:00,0,11,16,2,0,603,9139,9742
2016-11-23 17:00:00-05:00,0,11,17,2,0,1278,14125,15403
2016-11-23 18:00:00-05:00,0,11,18,2,0,1842,16941,18783
2016-11-23 19:00:00-05:00,0,11,19,2,0,1784,16807,18591
2016-11-23 20:00:00-05:00,0,11,20,2,0,1622,16206,17828
2016-11-23 21:00:00-05:00,0,11,21,2,0,1670,16951,18621
2016-11-23 22:00:00-05:00,0,11,22,2,0,1729,18732,20461
2016-11-23 23:00:00-05:00,0,11,23,2,0,1916,18759,20675
2016-11-24 00:00:00-05:00,0,11,0,3,1,2136,19372,21508
2016-11-24 01:00:00-05:00,0,11,1,3,1,2333,18021,20354
2016-11-24 02:00:00-05:00,0,11,2,3,1,2579,15186,17765
2016-11-24 03:00:00-05:00,0,11,3,3,1,2814,17619,20433
2016-11-24 04:00:00-05:00,0,11,4,3,1,2805,19612,22417
2016-11-24 05:00:00-05:00,0,11,5,3,1,2693,18195,20888
2016-11-24 06:00:00-05:00,0,11,6,3,1,2347,16158,18505
2016-11-24 07:00:00-05:00,0,11,7,3,1,2294,16113,18407
2016-11-24 08:00:00-05:00,0,11,8,3,1,2067,15126,17193
2016-11-24 09:00:00-05:00,0,11,9,3,1,1729,12762,14491
2016-11-24 10:00:00-05:00,0,11,10,3,1,1519,10710,12229
2016-11-24 11:00:00-05:00,0,11,11,3,1,1268,8767,10035
2016-11-24 12:00:00-05:00,0,11,12,3,1,1004,7189,8193
2016-11-24 13:00:00-05:00,0,11,13,3,1,867,5463,6330
2016-11-24 14:00:00-05:00,0,11,14,3,1,745,4321,5066
2016-11-24 15:00:00-05:00,0,11,15,3,1,422,3008,3430
2016-11-24 16:00:00-05:00,0,11,16,3,1,460,4356,4816
2016-11-24 17:00:00-05:00,0.01,11,17,3,1,554,5452,6006
2016-11-24 18:00:00-05:00,0.01,11,18,3,1,595,6430,7025
2016-11-24 19:00:00-05:00,0,11,19,3,1,782,7153,7935
2016-11-24 20:00:00-05:00,0,11,20,3,1,872,8577,9449
2016-11-24 21:00:00-05:00,0,11,21,3,1,1049,10737,11786
2016-11-24 22:00:00-05:00,0,11,22,3,1,1270,12197,13467
2016-11-24 23:00:00-05:00,0,11,23,3,1,1449,11617,13066
2016-11-25 00:00:00-05:00,0,11,0,4,0,1637,11717,13354
2016-11-25 01:00:00-05:00,0,11,1,4,0,2045,12541,14586
2016-11-25 02:00:00-05:00,0,11,2,4,0,2170,12132,14302
2016-11-25 03:00:00-05:00,0,11,3,4,0,2402,11427,13829
2016-11-25 04:00:00-05:00,0,11,4,4,0,2204,10725,12929
2016-11-25 05:00:00-05:00,0,11,5,4,0,2333,11087,13420
2016-11-25 06:00:00-05:00,0,11,6,4,0,2227,11838,14065
2016-11-25 07:00:00-05:00,0,11,7,4,0,2204,12343,14547
2016-11-25 08:00:00-05:00,0,11,8,4,0,2236,11343,13579
2016-11-25 09:00:00-05:00,0,11,9,4,0,2053,8700,10753
2016-11-25 10:00:00-05:00,0,11,10,4,0,1628,5957,7585
2016-11-25 11:00:00-05:00,0,11,11,4,0,1195,4122,5317
2016-11-25 12:00:00-05:00,0,11,12,4,0,783,2924,3707
2016-11-25 13:00:00-05:00,0,11,13,4,0,542,2047,2589
2016-11-25 14:00:00-05:00,0,11,14,4,0,468,1836,2304
2016-11-25 15:00:00-05:00,0,11,15,4,0,263,1776,2039
2016-11-25 16:00:00-05:00,0,11,16,4,0,360,3604,3964
2016-11-25 17:00:00-05:00,0.01,11,17,4,0,532,5488,6020
2016-11-25 18:00:00-05:00,0,11,18,4,0,754,6965,7719
2016-11-25 19:00:00-05:00,0,11,19,4,0,914,8768,9682
2016-11-25 20:00:00-05:00,0,11,20,4,0,1005,11096,12101
2016-11-25 21:00:00-05:00,0,11,21,4,0,1100,12255,13355
2016-11-25 22:00:00-05:00,0,11,22,4,0,1160,13643,14803
2016-11-25 23:00:00-05:00,0,11,23,4,0,1197,14812,16009
2016-11-26 00:00:00-05:00,0,11,0,5,0,1585,16331,17916
2016-11-26 01:00:00-05:00,0,11,1,5,0,1810,15675,17485
2016-11-26 02:00:00-05:00,0,11,2,5,0,2075,15978,18053
2016-11-26 03:00:00-05:00,0,11,3,5,0,2060,16070,18130
2016-11-26 04:00:00-05:00,0,11,4,5,0,1980,15982,17962
2016-11-26 05:00:00-05:00,0,11,5,5,0,2003,15659,17662
2016-11-26 06:00:00-05:00,0,11,6,5,0,1887,12923,14810
2016-11-26 07:00:00-05:00,0,11,7,5,0,1870,12894,14764
2016-11-26 08:00:00-05:00,0,11,8,5,0,1781,14318,16099
2016-11-26 09:00:00-05:00,0,11,9,5,0,1741,12893,14634
2016-11-26 10:00:00-05:00,0,11,10,5,0,1694,10777,12471
2016-11-26 11:00:00-05:00,0,11,11,5,0,1402,9368,10770
2016-11-26 12:00:00-05:00,0,11,12,5,0,1113,7806,8919
2016-11-26 13:00:00-05:00,0,11,13,5,0,1009,6118,7127
2016-11-26 14:00:00-05:00,0,11,14,5,0,810,4725,5535
2016-11-26 15:00:00-05:00,0,11,15,5,0,444,2346,2790
2016-11-26 16:00:00-05:00,0,11,16,5,0,412,2843,3255
2016-11-26 17:00:00-05:00,0,11,17,5,0,487,4209,4696
2016-11-26 18:00:00-05:00,0,11,18,5,0,637,6242,6879
2016-11-26 19:00:00-05:00,0,11,19,5,0,903,9351,10254
2016-11-26 20:00:00-05:00,0,11,20,5,0,1093,11870,12963
2016-11-26 21:00:00-05:00,0,11,21,5,0,1308,14562,15870
2016-11-26 22:00:00-05:00,0,11,22,5,0,1400,16430,17830
2016-11-26 23:00:00-05:00,0,11,23,5,0,1562,16538,18100
2016-11-27 00:00:00-05:00,0,11,0,6,0,1690,16361,18051
2016-11-27 01:00:00-05:00,0,11,1,6,0,1890,17424,19314
2016-11-27 02:00:00-05:00,0,11,2,6,0,2141,16909,19050
2016-11-27 03:00:00-05:00,0,11,3,6,0,2379,17683,20062
2016-11-27 04:00:00-05:00,0,11,4,6,0,2386,19145,21531
2016-11-27 05:00:00-05:00,0,11,5,6,0,2476,19552,22028
2016-11-27 06:00:00-05:00,0,11,6,6,0,2294,16150,18444
2016-11-27 07:00:00-05:00,0,11,7,6,0,2282,16289,18571
2016-11-27 08:00:00-05:00,0,11,8,6,0,2450,17706,20156
2016-11-27 09:00:00-05:00,0,11,9,6,0,2413,17007,19420
2016-11-27 10:00:00-05:00,0,11,10,6,0,2318,14964,17282
2016-11-27 11:00:00-05:00,0,11,11,6,0,1943,12971,14914
2016-11-27 12:00:00-05:00,0,11,12,6,0,1730,11235,12965
2016-11-27 13:00:00-05:00,0,11,13,6,0,1526,8782,10308
2016-11-27 14:00:00-05:00,0,11,14,6,0,1187,6119,7306
2016-11-27 15:00:00-05:00,0,11,15,6,0,563,3068,3631
2016-11-27 16:00:00-05:00,0,11,16,6,0,400,3324,3724
2016-11-27 17:00:00-05:00,0,11,17,6,0,456,4534,4990
2016-11-27 18:00:00-05:00,0,11,18,6,0,581,6409,6990
2016-11-27 19:00:00-05:00,0,11,19,6,0,786,9301,10087
2016-11-27 20:00:00-05:00,0,11,20,6,0,1096,12223,13319
2016-11-27 21:00:00-05:00,0,11,21,6,0,1402,13955,15357
2016-11-27 22:00:00-05:00,0,11,22,6,0,1338,15621,16959
2016-11-27 23:00:00-05:00,0,11,23,6,0,1550,16445,17995
2016-11-28 00:00:00-05:00,0,11,0,0,0,1670,16787,18457
2016-11-28 01:00:00-05:00,0,11,1,0,0,1841,16152,17993
2016-11-28 02:00:00-05:00,0,11,2,0,0,1982,15889,17871
2016-11-28 03:00:00-05:00,0,11,3,0,0,1981,16595,18576
2016-11-28 04:00:00-05:00,0,11,4,0,0,2007,16445,18452
2016-11-28 05:00:00-05:00,0,11,5,0,0,1876,15323,17199
2016-11-28 06:00:00-05:00,0,11,6,0,0,1790,13769,15559
2016-11-28 07:00:00-05:00,0,11,7,0,0,1490,13307,14797
2016-11-28 08:00:00-05:00,0,11,8,0,0,1288,11139,12427
2016-11-28 09:00:00-05:00,0,11,9,0,0,1075,8214,9289
2016-11-28 10:00:00-05:00,0,11,10,0,0,807,5772,6579
2016-11-28 11:00:00-05:00,0,11,11,0,0,499,3246,3745
2016-11-28 12:00:00-05:00,0,11,12,0,0,301,1847,2148
2016-11-28 13:00:00-05:00,0,11,13,0,0,268,1484,1752
2016-11-28 14:00:00-05:00,0,11,14,0,0,289,1832,2121
2016-11-28 15:00:00-05:00,0,11,15,0,0,250,3502,3752
2016-11-28 16:00:00-05:00,0,11,16,0,0,548,9323,9871
2016-11-28 17:00:00-05:00,0,11,17,0,0,1296,15648,16944
2016-11-28 18:00:00-05:00,0,11,18,0,0,1879,17720,19599
2016-11-28 19:00:00-05:00,0,11,19,0,0,1599,16147,17746
2016-11-28 20:00:00-05:00,0,11,20,0,0,1426,14167,15593
2016-11-28 21:00:00-05:00,0,11,21,0,0,1298,14063,15361
2016-11-28 22:00:00-05:00,0,11,22,0,0,1245,16020,17265
2016-11-28 23:00:00-05:00,0,11,23,0,0,1317,14955,16272
2016-11-29 00:00:00-05:00,0,11,0,1,0,1479,16453,17932
2016-11-29 01:00:00-05:00,0,11,1,1,0,1730,16968,18698
2016-11-29 02:00:00-05:00,0,11,2,1,0,1948,15236,17184
2016-11-29 03:00:00-05:00,0,11,3,1,0,2180,17576,19756
2016-11-29 04:00:00-05:00,0,11,4,1,0,2289,20002,22291
2016-11-29 05:00:00-05:00,0,11,5,1,0,2232,19087,21319
2016-11-29 06:00:00-05:00,0,11,6,1,0,1763,17551,19314
2016-11-29 07:00:00-05:00,0,11,7,1,0,1480,16476,17956
2016-11-29 08:00:00-05:00,0.02,11,8,1,0,1278,13974,15252
2016-11-29 09:00:00-05:00,0.06,11,9,1,0,1002,9336,10338
2016-11-29 10:00:00-05:00,0.12,11,10,1,0,682,6052,6734
2016-11-29 11:00:00-05:00,0.22,11,11,1,0,437,3703,4140
2016-11-29 12:00:00-05:00,0.19,11,12,1,0,289,2234,2523
2016-11-29 13:00:00-05:00,0.25,11,13,1,0,228,1562,1790
2016-11-29 14:00:00-05:00,0.19,11,14,1,0,221,1657,1878
2016-11-29 15:00:00-05:00,0.33,11,15,1,0,237,3434,3671
2016-11-29 16:00:00-05:00,0.2,11,16,1,0,548,9369,9917
2016-11-29 17:00:00-05:00,0.3,11,17,1,0,1273,17135,18408
2016-11-29 18:00:00-05:00,0.21,11,18,1,0,2040,20211,22251
2016-11-29 19:00:00-05:00,0.06,11,19,1,0,2028,18827,20855
2016-11-29 20:00:00-05:00,0.08,11,20,1,0,1750,17646,19396
2016-11-29 21:00:00-05:00,0,11,21,1,0,1644,17458,19102
2016-11-29 22:00:00-05:00,0,11,22,1,0,1605,17464,19069
2016-11-29 23:00:00-05:00,0,11,23,1,0,1669,17056,18725
2016-11-30 00:00:00-05:00,0,11,0,2,0,1888,18092,19980
2016-11-30 01:00:00-05:00,0,11,1,2,0,2204,16875,19079
2016-11-30 02:00:00-05:00,0,11,2,2,0,2185,13303,15488
2016-11-30 03:00:00-05:00,0,11,3,2,0,2592,17132,19724
2016-11-30 04:00:00-05:00,0,11,4,2,0,2610,19334,21944
2016-11-30 05:00:00-05:00,0,11,5,2,0,2411,18986,21397
2016-11-30 06:00:00-05:00,0,11,6,2,0,2073,20243,22316
2016-11-30 07:00:00-05:00,0,11,7,2,0,1600,18652,20252
2016-11-30 08:00:00-05:00,0,11,8,2,0,1272,15879,17151
2016-11-30 09:00:00-05:00,0,11,9,2,0,1112,11645,12757
2016-11-30 10:00:00-05:00,0,11,10,2,0,829,7634,8463
2016-11-30 11:00:00-05:00,0,11,11,2,0,533,4445,4978
2016-11-30 12:00:00-05:00,0,11,12,2,0,317,2726,3043
2016-11-30 13:00:00-05:00,0.05,11,13,2,0,234,1722,1956
2016-11-30 14:00:00-05:00,0.2,11,14,2,0,225,1839,2064
2016-11-30 15:00:00-05:00,0.22,11,15,2,0,256,3540,3796
2016-11-30 16:00:00-05:00,0.02,11,16,2,0,490,9329,9819
2016-11-30 17:00:00-05:00,0.03,11,17,2,0,1368,17260,18628
2016-11-30 18:00:00-05:00,0.01,11,18,2,0,1922,19671,21593
2016-11-30 19:00:00-05:00,0.01,11,19,2,0,1707,17310,19017
2016-11-30 20:00:00-05:00,0.21,11,20,2,0,1615,15839,17454
2016-11-30 21:00:00-05:00,0.01,11,21,2,0,1571,17537,19108
2016-11-30 22:00:00-05:00,0.05,11,22,2,0,1737,18314,20051
2016-11-30 23:00:00-05:00,0.05,11,23,2,0,1716,17483,19199
2016-12-01 00:00:00-05:00,0.03,12,0,3,0,2094,18588,20682
2016-12-01 01:00:00-05:00,0.02,12,1,3,0,2406,17171,19577
2016-12-01 02:00:00-05:00,0,12,2,3,0,2167,13089,15256
2016-12-01 03:00:00-05:00,0,12,3,3,0,2645,16641,19286
2016-12-01 04:00:00-05:00,0,12,4,3,0,2706,19507,22213
2016-12-01 05:00:00-05:00,0,12,5,3,0,2719,20396,23115
2016-12-01 06:00:00-05:00,0,12,6,3,0,2589,21118,23707
2016-12-01 07:00:00-05:00,0,12,7,3,0,2106,20494,22600
2016-12-01 08:00:00-05:00,0,12,8,3,0,1901,20738,22639
2016-12-01 09:00:00-05:00,0,12,9,3,0,1468,14941,16409
2016-12-01 10:00:00-05:00,0,12,10,3,0,1007,9594,10601
2016-12-01 11:00:00-05:00,0,12,11,3,0,611,5411,6022
2016-12-01 12:00:00-05:00,0,12,12,3,0,355,3280,3635
2016-12-01 13:00:00-05:00,0,12,13,3,0,241,2155,2396
2016-12-01 14:00:00-05:00,0,12,14,3,0,274,2241,2515
2016-12-01 15:00:00-05:00,0,12,15,3,0,276,3749,4025
2016-12-01 16:00:00-05:00,0,12,16,3,0,573,9992,10565
2016-12-01 17:00:00-05:00,0,12,17,3,0,1329,17896,19225
2016-12-01 18:00:00-05:00,0,12,18,3,0,2042,20098,22140
2016-12-01 19:00:00-05:00,0,12,19,3,0,1850,18505,20355
2016-12-01 20:00:00-05:00,0,12,20,3,0,1636,16475,18111
2016-12-01 21:00:00-05:00,0,12,21,3,0,1654,16187,17841
2016-12-01 22:00:00-05:00,0,12,22,3,0,1520,17356,18876
2016-12-01 23:00:00-05:00,0,12,23,3,0,1708,17456,19164
2016-12-02 00:00:00-05:00,0,12,0,4,0,1973,19055,21028
2016-12-02 01:00:00-05:00,0,12,1,4,0,2199,17228,19427
2016-12-02 02:00:00-05:00,0,12,2,4,0,2287,14415,16702
2016-12-02 03:00:00-05:00,0,12,3,4,0,2764,17715,20479
2016-12-02 04:00:00-05:00,0,12,4,4,0,2998,21985,24983
2016-12-02 05:00:00-05:00,0,12,5,4,0,2908,23264,26172
2016-12-02 06:00:00-05:00,0,12,6,4,0,2628,23594,26222
2016-12-02 07:00:00-05:00,0,12,7,4,0,2531,23620,26151
2016-12-02 08:00:00-05:00,0,12,8,4,0,2271,23047,25318
2016-12-02 09:00:00-05:00,0,12,9,4,0,1905,20631,22536
2016-12-02 10:00:00-05:00,0,12,10,4,0,1427,14660,16087
2016-12-02 11:00:00-05:00,0,12,11,4,0,1028,9246,10274
2016-12-02 12:00:00-05:00,0,12,12,4,0,703,6196,6899
2016-12-02 13:00:00-05:00,0,12,13,4,0,498,4012,4510
2016-12-02 14:00:00-05:00,0,12,14,4,0,388,3191,3579
2016-12-02 15:00:00-05:00,0,12,15,4,0,306,4203,4509
2016-12-02 16:00:00-05:00,0,12,16,4,0,605,9838,10443
2016-12-02 17:00:00-05:00,0,12,17,4,0,1433,17488,18921
2016-12-02 18:00:00-05:00,0,12,18,4,0,2125,20583,22708
2016-12-02 19:00:00-05:00,0,12,19,4,0,2179,19625,21804
2016-12-02 20:00:00-05:00,0,12,20,4,0,1760,17025,18785
2016-12-02 21:00:00-05:00,0,12,21,4,0,1707,16894,18601
2016-12-02 22:00:00-05:00,0,12,22,4,0,1434,17403,18837
2016-12-02 23:00:00-05:00,0,12,23,4,0,1563,17645,19208
2016-12-03 00:00:00-05:00,0,12,0,5,0,1951,19383,21334
2016-12-03 01:00:00-05:00,0,12,1,5,0,2283,18034,20317
2016-12-03 02:00:00-05:00,0,12,2,5,0,2556,15427,17983
2016-12-03 03:00:00-05:00,0,12,3,5,0,3057,19397,22454
2016-12-03 04:00:00-05:00,0,12,4,5,0,3306,23524,26830
2016-12-03 05:00:00-05:00,0,12,5,5,0,3424,24638,28062
2016-12-03 06:00:00-05:00,0,12,6,5,0,3093,22689,25782
2016-12-03 07:00:00-05:00,0,12,7,5,0,2965,22456,25421
2016-12-03 08:00:00-05:00,0,12,8,5,0,2907,23695,26602
2016-12-03 09:00:00-05:00,0,12,9,5,0,2878,22983,25861
2016-12-03 10:00:00-05:00,0,12,10,5,0,2794,21078,23872
2016-12-03 11:00:00-05:00,0,12,11,5,0,2316,18201,20517
2016-12-03 12:00:00-05:00,0,12,12,5,0,1944,14613,16557
2016-12-03 13:00:00-05:00,0,12,13,5,0,1585,10578,12163
2016-12-03 14:00:00-05:00,0,12,14,5,0,1217,6815,8032
2016-12-03 15:00:00-05:00,0,12,15,5,0,623,3309,3932
2016-12-03 16:00:00-05:00,0,12,16,5,0,595,4375,4970
2016-12-03 17:00:00-05:00,0,12,17,5,0,761,6981,7742
2016-12-03 18:00:00-05:00,0,12,18,5,0,987,10483,11470
2016-12-03 19:00:00-05:00,0,12,19,5,0,1350,15007,16357
2016-12-03 20:00:00-05:00,0,12,20,5,0,1556,17567,19123
2016-12-03 21:00:00-05:00,0,12,21,5,0,1807,19731,21538
2016-12-03 22:00:00-05:00,0,12,22,5,0,1884,21943,23827
2016-12-03 23:00:00-05:00,0,12,23,5,0,2027,21365,23392
2016-12-04 00:00:00-05:00,0,12,0,6,0,2189,20845,23034
2016-12-04 01:00:00-05:00,0,12,1,6,0,2494,21438,23932
2016-12-04 02:00:00-05:00,0,12,2,6,0,2614,17727,20341
2016-12-04 03:00:00-05:00,0,12,3,6,0,2864,19152,22016
2016-12-04 04:00:00-05:00,0,12,4,6,0,3085,21957,25042
2016-12-04 05:00:00-05:00,0,12,5,6,0,3308,22881,26189
2016-12-04 06:00:00-05:00,0,12,6,6,0,2968,19985,22953
2016-12-04 07:00:00-05:00,0,12,7,6,0,2963,19639,22602
2016-12-04 08:00:00-05:00,0,12,8,6,0,3080,21905,24985
2016-12-04 09:00:00-05:00,0,12,9,6,0,3198,23210,26408
2016-12-04 10:00:00-05:00,0,12,10,6,0,3070,22444,25514
2016-12-04 11:00:00-05:00,0,12,11,6,0,2726,20043,22769
2016-12-04 12:00:00-05:00,0,12,12,6,0,2329,17042,19371
2016-12-04 13:00:00-05:00,0,12,13,6,0,1921,12839,14760
2016-12-04 14:00:00-05:00,0,12,14,6,0,1416,7896,9312
2016-12-04 15:00:00-05:00,0,12,15,6,0,685,3337,4022
2016-12-04 16:00:00-05:00,0,12,16,6,0,476,3524,4000
2016-12-04 17:00:00-05:00,0,12,17,6,0,563,5014,5577
2016-12-04 18:00:00-05:00,0,12,18,6,0,747,7846,8593
2016-12-04 19:00:00-05:00,0,12,19,6,0,1020,11827,12847
2016-12-04 20:00:00-05:00,0,12,20,6,0,1276,16401,17677
2016-12-04 21:00:00-05:00,0,12,21,6,0,1489,18443,19932
2016-12-04 22:00:00-05:00,0,12,22,6,0,1593,19679,21272
2016-12-04 23:00:00-05:00,0,12,23,6,0,1763,19478,21241
2016-12-05 00:00:00-05:00,0,12,0,0,0,1855,19247,21102
2016-12-05 01:00:00-05:00,0,12,1,0,0,2040,19302,21342
2016-12-05 02:00:00-05:00,0,12,2,0,0,2123,17374,19497
2016-12-05 03:00:00-05:00,0.04,12,3,0,0,2151,17701,19852
2016-12-05 04:00:00-05:00,0.06,12,4,0,0,2164,18083,20247
2016-12-05 05:00:00-05:00,0.03,12,5,0,0,2124,17255,19379
2016-12-05 06:00:00-05:00,0.03,12,6,0,0,1913,15100,17013
2016-12-05 07:00:00-05:00,0.01,12,7,0,0,1683,14514,16197
2016-12-05 08:00:00-05:00,0.01,12,8,0,0,1548,13082,14630
2016-12-05 09:00:00-05:00,0,12,9,0,0,1247,9079,10326
2016-12-05 10:00:00-05:00,0,12,10,0,0,941,5732,6673
2016-12-05 11:00:00-05:00,0,12,11,0,0,568,3594,4162
2016-12-05 12:00:00-05:00,0,12,12,0,0,370,2228,2598
2016-12-05 13:00:00-05:00,0,12,13,0,0,308,1675,1983
2016-12-05 14:00:00-05:00,0,12,14,0,0,316,2158,2474
2016-12-05 15:00:00-05:00,0,12,15,0,0,285,4059,4344
2016-12-05 16:00:00-05:00,0,12,16,0,0,565,10750,11315
2016-12-05 17:00:00-05:00,0,12,17,0,0,1382,17454,18836
2016-12-05 18:00:00-05:00,0,12,18,0,0,2032,19440,21472
2016-12-05 19:00:00-05:00,0,12,19,0,0,1872,18209,20081
2016-12-05 20:00:00-05:00,0,12,20,0,0,1612,16039,17651
2016-12-05 21:00:00-05:00,0,12,21,0,0,1499,15605,17104
2016-12-05 22:00:00-05:00,0,12,22,0,0,1313,16115,17428
2016-12-05 23:00:00-05:00,0,12,23,0,0,1463,15837,17300
2016-12-06 00:00:00-05:00,0,12,0,1,0,1659,17546,19205
2016-12-06 01:00:00-05:00,0,12,1,1,0,1904,17743,19647
2016-12-06 02:00:00-05:00,0,12,2,1,0,1986,15720,17706
2016-12-06 03:00:00-05:00,0,12,3,1,0,2234,18540,20774
2016-12-06 04:00:00-05:00,0,12,4,1,0,2500,21873,24373
2016-12-06 05:00:00-05:00,0,12,5,1,0,2376,21328,23704
2016-12-06 06:00:00-05:00,0,12,6,1,0,2001,20649,22650
2016-12-06 07:00:00-05:00,0,12,7,1,0,1657,20435,22092
2016-12-06 08:00:00-05:00,0,12,8,1,0,1440,18121,19561
2016-12-06 09:00:00-05:00,0,12,9,1,0,1144,12739,13883
2016-12-06 10:00:00-05:00,0,12,10,1,0,829,8208,9037
2016-12-06 11:00:00-05:00,0,12,11,1,0,534,4506,5040
2016-12-06 12:00:00-05:00,0,12,12,1,0,331,2611,2942
2016-12-06 13:00:00-05:00,0,12,13,1,0,261,1746,2007
2016-12-06 14:00:00-05:00,0,12,14,1,0,239,1919,2158
2016-12-06 15:00:00-05:00,0,12,15,1,0,256,3590,3846
2016-12-06 16:00:00-05:00,0,12,16,1,0,568,9820,10388
2016-12-06 17:00:00-05:00,0,12,17,1,0,1361,18053,19414
2016-12-06 18:00:00-05:00,0.03,12,18,1,0,1930,20274,22204
2016-12-06 19:00:00-05:00,0.1,12,19,1,0,1790,19058,20848
2016-12-06 20:00:00-05:00,0.09,12,20,1,0,1716,16876,18592
2016-12-06 21:00:00-05:00,0.08,12,21,1,0,1435,16365,17800
2016-12-06 22:00:00-05:00,0.05,12,22,1,0,1459,17032,18491
2016-12-06 23:00:00-05:00,0,12,23,1,0,1613,17519,19132
2016-12-07 00:00:00-05:00,0,12,0,2,0,1774,19063,20837
2016-12-07 01:00:00-05:00,0,12,1,2,0,2012,17055,19067
2016-12-07 02:00:00-05:00,0,12,2,2,0,2179,14281,16460
2016-12-07 03:00:00-05:00,0.05,12,3,2,0,2491,17851,20342
2016-12-07 04:00:00-05:00,0.01,12,4,2,0,3449,21690,25139
2016-12-07 05:00:00-05:00,0,12,5,2,0,3743,22713,26456
2016-12-07 06:00:00-05:00,0,12,6,2,0,3107,22632,25739
2016-12-07 07:00:00-05:00,0,12,7,2,0,2741,22015,24756
2016-12-07 08:00:00-05:00,0,12,8,2,0,2038,20078,22116
2016-12-07 09:00:00-05:00,0,12,9,2,0,1365,15877,17242
2016-12-07 10:00:00-05:00,0,12,10,2,0,1006,9473,10479
2016-12-07 11:00:00-05:00,0,12,11,2,0,582,5507,6089
2016-12-07 12:00:00-05:00,0,12,12,2,0,368,3098,3466
2016-12-07 13:00:00-05:00,0,12,13,2,0,261,2088,2349
2016-12-07 14:00:00-05:00,0,12,14,2,0,268,1944,2212
2016-12-07 15:00:00-05:00,0,12,15,2,0,265,3762,4027
2016-12-07 16:00:00-05:00,0,12,16,2,0,541,10090,10631
2016-12-07 17:00:00-05:00,0,12,17,2,0,1318,18451,19769
2016-12-07 18:00:00-05:00,0,12,18,2,0,2087,21096,23183
2016-12-07 19:00:00-05:00,0,12,19,2,0,1986,19108,21094
2016-12-07 20:00:00-05:00,0,12,20,2,0,1780,17272,19052
2016-12-07 21:00:00-05:00,0,12,21,2,0,1576,16819,18395
2016-12-07 22:00:00-05:00,0,12,22,2,0,1475,17831,19306
2016-12-07 23:00:00-05:00,0,12,23,2,0,1593,17190,18783
2016-12-08 00:00:00-05:00,0,12,0,3,0,1662,18631,20293
2016-12-08 01:00:00-05:00,0,12,1,3,0,1941,16921,18862
2016-12-08 02:00:00-05:00,0,12,2,3,0,2113,14151,16264
2016-12-08 03:00:00-05:00,0,12,3,3,0,2431,17301,19732
2016-12-08 04:00:00-05:00,0,12,4,3,0,2723,21258,23981
2016-12-08 05:00:00-05:00,0,12,5,3,0,2671,22911,25582
2016-12-08 06:00:00-05:00,0,12,6,3,0,2325,22350,24675
2016-12-08 07:00:00-05:00,0,12,7,3,0,2123,23170,25293
2016-12-08 08:00:00-05:00,0,12,8,3,0,1878,22727,24605
2016-12-08 09:00:00-05:00,0,12,9,3,0,1590,18556,20146
2016-12-08 10:00:00-05:00,0,12,10,3,0,1129,12157,13286
2016-12-08 11:00:00-05:00,0,12,11,3,0,718,6957,7675
2016-12-08 12:00:00-05:00,0,12,12,3,0,451,4410,4861
2016-12-08 13:00:00-05:00,0,12,13,3,0,301,2721,3022
2016-12-08 14:00:00-05:00,0,12,14,3,0,292,2520,2812
2016-12-08 15:00:00-05:00,0,12,15,3,0,258,3847,4105
2016-12-08 16:00:00-05:00,0,12,16,3,0,521,9906,10427
2016-12-08 17:00:00-05:00,0,12,17,3,0,1396,18513,19909
2016-12-08 18:00:00-05:00,0,12,18,3,0,2028,20777,22805
2016-12-08 19:00:00-05:00,0,12,19,3,0,1917,18926,20843
2016-12-08 20:00:00-05:00,0,12,20,3,0,1652,17378,19030
2016-12-08 21:00:00-05:00,0,12,21,3,0,1549,17224,18773
2016-12-08 22:00:00-05:00,0,12,22,3,0,1573,17850,19423
2016-12-08 23:00:00-05:00,0,12,23,3,0,1607,17210,18817
2016-12-09 00:00:00-05:00,0,12,0,4,0,1818,18220,20038
2016-12-09 01:00:00-05:00,0,12,1,4,0,2087,16661,18748
2016-12-09 02:00:00-05:00,0,12,2,4,0,2227,13617,15844
2016-12-09 03:00:00-05:00,0,12,3,4,0,2724,17922,20646
2016-12-09 04:00:00-05:00,0,12,4,4,0,2914,21842,24756
2016-12-09 05:00:00-05:00,0,12,5,4,0,2926,23306,26232
2016-12-09 06:00:00-05:00,0,12,6,4,0,2695,24087,26782
2016-12-09 07:00:00-05:00,0,12,7,4,0,2517,25048,27565
2016-12-09 08:00:00-05:00,0,12,8,4,0,2385,23972,26357
2016-12-09 09:00:00-05:00,0,12,9,4,0,2176,22303,24479
2016-12-09 10:00:00-05:00,0,12,10,4,0,1731,17936,19667
2016-12-09 11:00:00-05:00,0,12,11,4,0,1188,11466,12654
2016-12-09 12:00:00-05:00,0,12,12,4,0,792,7294,8086
2016-12-09 13:00:00-05:00,0,12,13,4,0,520,4568,5088
2016-12-09 14:00:00-05:00,0,12,14,4,0,405,3492,3897
2016-12-09 15:00:00-05:00,0,12,15,4,0,328,4117,4445
2016-12-09 16:00:00-05:00,0,12,16,4,0,606,10122,10728
2016-12-09 17:00:00-05:00,0,12,17,4,0,1474,17793,19267
2016-12-09 18:00:00-05:00,0,12,18,4,0,2153,20578,22731
2016-12-09 19:00:00-05:00,0,12,19,4,0,1955,19140,21095
2016-12-09 20:00:00-05:00,0,12,20,4,0,1724,17994,19718
2016-12-09 21:00:00-05:00,0,12,21,4,0,1626,18215,19841
2016-12-09 22:00:00-05:00,0,12,22,4,0,1567,18219,19786
2016-12-09 23:00:00-05:00,0,12,23,4,0,1596,18207,19803
2016-12-10 00:00:00-05:00,0,12,0,5,0,2007,19572,21579
2016-12-10 01:00:00-05:00,0,12,1,5,0,2371,17683,20054
2016-12-10 02:00:00-05:00,0,12,2,5,0,2646,14778,17424
2016-12-10 03:00:00-05:00,0,12,3,5,0,3306,19397,22703
2016-12-10 04:00:00-05:00,0,12,4,5,0,3674,23553,27227
2016-12-10 05:00:00-05:00,0,12,5,5,0,3772,25012,28784
2016-12-10 06:00:00-05:00,0,12,6,5,0,3364,24080,27444
2016-12-10 07:00:00-05:00,0,12,7,5,0,3167,23876,27043
2016-12-10 08:00:00-05:00,0,12,8,5,0,3167,24550,27717
2016-12-10 09:00:00-05:00,0,12,9,5,0,3168,23905,27073
2016-12-10 10:00:00-05:00,0,12,10,5,0,2874,22522,25396
2016-12-10 11:00:00-05:00,0,12,11,5,0,2373,18251,20624
2016-12-10 12:00:00-05:00,0,12,12,5,0,1913,14534,16447
2016-12-10 13:00:00-05:00,0,12,13,5,0,1589,10562,12151
2016-12-10 14:00:00-05:00,0,12,14,5,0,1274,6746,8020
2016-12-10 15:00:00-05:00,0,12,15,5,0,573,3109,3682
2016-12-10 16:00:00-05:00,0,12,16,5,0,523,4537,5060
2016-12-10 17:00:00-05:00,0,12,17,5,0,711,6860,7571
2016-12-10 18:00:00-05:00,0,12,18,5,0,938,10797,11735
2016-12-10 19:00:00-05:00,0,12,19,5,0,1372,15419,16791
2016-12-10 20:00:00-05:00,0,12,20,5,0,1688,19857,21545
2016-12-10 21:00:00-05:00,0,12,21,5,0,1869,21723,23592
2016-12-10 22:00:00-05:00,0,12,22,5,0,2000,23430,25430
2016-12-10 23:00:00-05:00,0,12,23,5,0,2259,23563,25822
2016-12-11 00:00:00-05:00,0,12,0,6,0,2375,22275,24650
2016-12-11 01:00:00-05:00,0,12,1,6,0,2480,21053,23533
2016-12-11 02:00:00-05:00,0,12,2,6,0,2738,16964,19702
2016-12-11 03:00:00-05:00,0,12,3,6,0,2992,18406,21398
2016-12-11 04:00:00-05:00,0,12,4,6,0,3139,21660,24799
2016-12-11 05:00:00-05:00,0,12,5,6,0,3509,22188,25697
2016-12-11 06:00:00-05:00,0,12,6,6,0,3420,21274,24694
2016-12-11 07:00:00-05:00,0,12,7,6,0,3244,20972,24216
2016-12-11 08:00:00-05:00,0,12,8,6,0,3183,22416,25599
2016-12-11 09:00:00-05:00,0,12,9,6,0,3260,23055,26315
2016-12-11 10:00:00-05:00,0,12,10,6,0,3132,21469,24601
2016-12-11 11:00:00-05:00,0,12,11,6,0,2851,19215,22066
2016-12-11 12:00:00-05:00,0,12,12,6,0,2376,15574,17950
2016-12-11 13:00:00-05:00,0,12,13,6,0,1923,11839,13762
2016-12-11 14:00:00-05:00,0,12,14,6,0,1465,7703,9168
2016-12-11 15:00:00-05:00,0,12,15,6,0,708,3384,4092
2016-12-11 16:00:00-05:00,0,12,16,6,0,491,3689,4180
2016-12-11 17:00:00-05:00,0.02,12,17,6,0,557,4878,5435
2016-12-11 18:00:00-05:00,0.01,12,18,6,0,718,8091,8809
2016-12-11 19:00:00-05:00,0,12,19,6,0,985,12495,13480
2016-12-11 20:00:00-05:00,0,12,20,6,0,1367,16922,18289
2016-12-11 21:00:00-05:00,0,12,21,6,0,1567,19452,21019
2016-12-11 22:00:00-05:00,0,12,22,6,0,1722,20938,22660
2016-12-11 23:00:00-05:00,0,12,23,6,0,1901,21047,22948
2016-12-12 00:00:00-05:00,0,12,0,0,0,1944,20676,22620
2016-12-12 01:00:00-05:00,0.01,12,1,0,0,2098,19313,21411
2016-12-12 02:00:00-05:00,0.08,12,2,0,0,2249,16689,18938
2016-12-12 03:00:00-05:00,0.08,12,3,0,0,2366,16209,18575
2016-12-12 04:00:00-05:00,0.16,12,4,0,0,2392,16185,18577
2016-12-12 05:00:00-05:00,0.08,12,5,0,0,2039,15507,17546
2016-12-12 06:00:00-05:00,0.04,12,6,0,0,1786,14148,15934
2016-12-12 07:00:00-05:00,0.07,12,7,0,0,1439,14010,15449
2016-12-12 08:00:00-05:00,0.01,12,8,0,0,1310,12405,13715
2016-12-12 09:00:00-05:00,0,12,9,0,0,1147,9742,10889
2016-12-12 10:00:00-05:00,0,12,10,0,0,809,7053,7862
2016-12-12 11:00:00-05:00,0,12,11,0,0,580,4379,4959
2016-12-12 12:00:00-05:00,0,12,12,0,0,412,2492,2904
2016-12-12 13:00:00-05:00,0,12,13,0,0,285,1701,1986
2016-12-12 14:00:00-05:00,0,12,14,0,0,333,2496,2829
2016-12-12 15:00:00-05:00,0,12,15,0,0,281,4083,4364
2016-12-12 16:00:00-05:00,0,12,16,0,0,584,10199,10783
2016-12-12 17:00:00-05:00,0,12,17,0,0,1363,16536,17899
2016-12-12 18:00:00-05:00,0,12,18,0,0,2071,18464,20535
2016-12-12 19:00:00-05:00,0,12,19,0,0,1920,17257,19177
2016-12-12 20:00:00-05:00,0,12,20,0,0,1663,15012,16675
2016-12-12 21:00:00-05:00,0,12,21,0,0,1470,15043,16513
2016-12-12 22:00:00-05:00,0,12,22,0,0,1360,15886,17246
2016-12-12 23:00:00-05:00,0,12,23,0,0,1432,15539,16971
2016-12-13 00:00:00-05:00,0,12,0,1,0,1695,17545,19240
2016-12-13 01:00:00-05:00,0,12,1,1,0,1890,17079,18969
2016-12-13 02:00:00-05:00,0,12,2,1,0,2055,15682,17737
2016-12-13 03:00:00-05:00,0,12,3,1,0,2462,18311,20773
2016-12-13 04:00:00-05:00,0,12,4,1,0,2569,21193,23762
2016-12-13 05:00:00-05:00,0,12,5,1,0,2352,21247,23599
2016-12-13 06:00:00-05:00,0,12,6,1,0,1952,20681,22633
2016-12-13 07:00:00-05:00,0,12,7,1,0,1705,21123,22828
2016-12-13 08:00:00-05:00,0,12,8,1,0,1477,18136,19613
2016-12-13 09:00:00-05:00,0,12,9,1,0,1179,13078,14257
2016-12-13 10:00:00-05:00,0,12,10,1,0,869,8348,9217
2016-12-13 11:00:00-05:00,0,12,11,1,0,527,4659,5186
2016-12-13 12:00:00-05:00,0,12,12,1,0,329,2867,3196
2016-12-13 13:00:00-05:00,0,12,13,1,0,268,1903,2171
2016-12-13 14:00:00-05:00,0,12,14,1,0,250,2042,2292
2016-12-13 15:00:00-05:00,0,12,15,1,0,236,3702,3938
2016-12-13 16:00:00-05:00,0,12,16,1,0,523,9726,10249
2016-12-13 17:00:00-05:00,0,12,17,1,0,1281,17439,18720
2016-12-13 18:00:00-05:00,0,12,18,1,0,1921,19581,21502
2016-12-13 19:00:00-05:00,0,12,19,1,0,1802,18582,20384
2016-12-13 20:00:00-05:00,0,12,20,1,0,1566,16235,17801
2016-12-13 21:00:00-05:00,0,12,21,1,0,1389,16302,17691
2016-12-13 22:00:00-05:00,0,12,22,1,0,1493,16980,18473
2016-12-13 23:00:00-05:00,0,12,23,1,0,1484,16573,18057
2016-12-14 00:00:00-05:00,0,12,0,2,0,1719,18423,20142
2016-12-14 01:00:00-05:00,0,12,1,2,0,1994,17688,19682
2016-12-14 02:00:00-05:00,0,12,2,2,0,2150,14269,16419
2016-12-14 03:00:00-05:00,0,12,3,2,0,2511,17874,20385
2016-12-14 04:00:00-05:00,0,12,4,2,0,2751,22092,24843
2016-12-14 05:00:00-05:00,0,12,5,2,0,2634,22366,25000
2016-12-14 06:00:00-05:00,0,12,6,2,0,2246,22641,24887
2016-12-14 07:00:00-05:00,0,12,7,2,0,2035,23680,25715
2016-12-14 08:00:00-05:00,0,12,8,2,0,1672,21648,23320
2016-12-14 09:00:00-05:00,0,12,9,2,0,1334,17235,18569
2016-12-14 10:00:00-05:00,0,12,10,2,0,983,11193,12176
2016-12-14 11:00:00-05:00,0,12,11,2,0,657,6484,7141
2016-12-14 12:00:00-05:00,0,12,12,2,0,416,3856,4272
2016-12-14 13:00:00-05:00,0,12,13,2,0,282,2369,2651
2016-12-14 14:00:00-05:00,0,12,14,2,0,292,2275,2567
2016-12-14 15:00:00-05:00,0,12,15,2,0,268,3736,4004
2016-12-14 16:00:00-05:00,0,12,16,2,0,526,9806,10332
2016-12-14 17:00:00-05:00,0,12,17,2,0,1363,17947,19310
2016-12-14 18:00:00-05:00,0,12,18,2,0,2018,20737,22755
2016-12-14 19:00:00-05:00,0,12,19,2,0,1890,18568,20458
2016-12-14 20:00:00-05:00,0,12,20,2,0,1584,17141,18725
2016-12-14 21:00:00-05:00,0,12,21,2,0,1543,17193,18736
2016-12-14 22:00:00-05:00,0,12,22,2,0,1452,17641,19093
2016-12-14 23:00:00-05:00,0,12,23,2,0,1571,17275,18846
2016-12-15 00:00:00-05:00,0,12,0,3,0,1720,18741,20461
2016-12-15 01:00:00-05:00,0,12,1,3,0,2033,17948,19981
2016-12-15 02:00:00-05:00,0,12,2,3,0,2213,15344,17557
2016-12-15 03:00:00-05:00,0,12,3,3,0,2804,18921,21725
2016-12-15 04:00:00-05:00,0,12,4,3,0,2965,22583,25548
2016-12-15 05:00:00-05:00,0,12,5,3,0,2981,23737,26718
2016-12-15 06:00:00-05:00,0,12,6,3,0,2637,23690,26327
2016-12-15 07:00:00-05:00,0,12,7,3,0,2312,24538,26850
2016-12-15 08:00:00-05:00,0,12,8,3,0,2239,23367,25606
2016-12-15 09:00:00-05:00,0,12,9,3,0,1825,19937,21762
2016-12-15 10:00:00-05:00,0,12,10,3,0,1269,14274,15543
2016-12-15 11:00:00-05:00,0,12,11,3,0,874,8144,9018
2016-12-15 12:00:00-05:00,0,12,12,3,0,547,4936,5483
2016-12-15 13:00:00-05:00,0,12,13,3,0,358,3009,3367
2016-12-15 14:00:00-05:00,0,12,14,3,0,295,2685,2980
2016-12-15 15:00:00-05:00,0,12,15,3,0,277,3989,4266
2016-12-15 16:00:00-05:00,0,12,16,3,0,616,10664,11280
2016-12-15 17:00:00-05:00,0,12,17,3,0,1503,19620,21123
2016-12-15 18:00:00-05:00,0,12,18,3,0,2212,22482,24694
2016-12-15 19:00:00-05:00,0,12,19,3,0,2120,20930,23050
2016-12-15 20:00:00-05:00,0,12,20,3,0,1816,18963,20779
2016-12-15 21:00:00-05:00,0,12,21,3,0,1805,19349,21154
2016-12-15 22:00:00-05:00,0,12,22,3,0,1746,20186,21932
2016-12-15 23:00:00-05:00,0,12,23,3,0,1826,19551,21377
2016-12-16 00:00:00-05:00,0,12,0,4,0,2052,20592,22644
2016-12-16 01:00:00-05:00,0,12,1,4,0,2445,18978,21423
2016-12-16 02:00:00-05:00,0,12,2,4,0,2699,15060,17759
2016-12-16 03:00:00-05:00,0,12,3,4,0,3333,19297,22630
2016-12-16 04:00:00-05:00,0,12,4,4,0,3550,23558,27108
2016-12-16 05:00:00-05:00,0,12,5,4,0,3545,24320,27865
2016-12-16 06:00:00-05:00,0,12,6,4,0,3244,24446,27690
2016-12-16 07:00:00-05:00,0,12,7,4,0,2939,24823,27762
2016-12-16 08:00:00-05:00,0,12,8,4,0,2672,22821,25493
2016-12-16 09:00:00-05:00,0,12,9,4,0,2344,21664,24008
2016-12-16 10:00:00-05:00,0,12,10,4,0,1918,19345,21263
2016-12-16 11:00:00-05:00,0,12,11,4,0,1285,14068,15353
2016-12-16 12:00:00-05:00,0,12,12,4,0,767,8538,9305
2016-12-16 13:00:00-05:00,0,12,13,4,0,518,5041,5559
2016-12-16 14:00:00-05:00,0,12,14,4,0,393,4038,4431
2016-12-16 15:00:00-05:00,0,12,15,4,0,348,4563,4911
2016-12-16 16:00:00-05:00,0,12,16,4,0,613,11004,11617
2016-12-16 17:00:00-05:00,0,12,17,4,0,1542,18704,20246
2016-12-16 18:00:00-05:00,0,12,18,4,0,2285,22032,24317
2016-12-16 19:00:00-05:00,0,12,19,4,0,2239,20730,22969
2016-12-16 20:00:00-05:00,0,12,20,4,0,1892,18925,20817
2016-12-16 21:00:00-05:00,0,12,21,4,0,1853,19417,21270
2016-12-16 22:00:00-05:00,0,12,22,4,0,1697,19433,21130
2016-12-16 23:00:00-05:00,0,12,23,4,0,1652,18564,20216
2016-12-17 00:00:00-05:00,0,12,0,5,0,2081,19455,21536
2016-12-17 01:00:00-05:00,0,12,1,5,0,2545,17718,20263
2016-12-17 02:00:00-05:00,0,12,2,5,0,2881,15006,17887
2016-12-17 03:00:00-05:00,0.02,12,3,5,0,3357,19264,22621
2016-12-17 04:00:00-05:00,0.05,12,4,5,0,3819,23803,27622
2016-12-17 05:00:00-05:00,0.04,12,5,5,0,3940,25262,29202
2016-12-17 06:00:00-05:00,0.07,12,6,5,0,3656,23742,27398
2016-12-17 07:00:00-05:00,0.1,12,7,5,0,3328,23514,26842
2016-12-17 08:00:00-05:00,0.11,12,8,5,0,3301,24210,27511
2016-12-17 09:00:00-05:00,0.17,12,9,5,0,3223,22788,26011
2016-12-17 10:00:00-05:00,0.12,12,10,5,0,2990,21690,24680
2016-12-17 11:00:00-05:00,0.02,12,11,5,0,2595,18530,21125
2016-12-17 12:00:00-05:00,0,12,12,5,0,1961,15170,17131
2016-12-17 13:00:00-05:00,0,12,13,5,0,1443,10979,12422
2016-12-17 14:00:00-05:00,0,12,14,5,0,1037,6516,7553
2016-12-17 15:00:00-05:00,0,12,15,5,0,570,3604,4174
2016-12-17 16:00:00-05:00,0,12,16,5,0,373,4208,4581
2016-12-17 17:00:00-05:00,0,12,17,5,0,473,5836,6309
2016-12-17 18:00:00-05:00,0,12,18,5,0,633,8563,9196
2016-12-17 19:00:00-05:00,0,12,19,5,0,946,13561,14507
2016-12-17 20:00:00-05:00,0,12,20,5,0,1239,17414,18653
2016-12-17 21:00:00-05:00,0,12,21,5,0,1540,19044,20584
2016-12-17 22:00:00-05:00,0,12,22,5,0,1753,20125,21878
2016-12-17 23:00:00-05:00,0,12,23,5,0,2043,20365,22408
2016-12-18 00:00:00-05:00,0,12,0,6,0,2102,19762,21864
2016-12-18 01:00:00-05:00,0,12,1,6,0,2626,19935,22561
2016-12-18 02:00:00-05:00,0,12,2,6,0,2663,17739,20402
2016-12-18 03:00:00-05:00,0,12,3,6,0,2895,20178,23073
2016-12-18 04:00:00-05:00,0.04,12,4,6,0,3109,22705,25814
2016-12-18 05:00:00-05:00,0,12,5,6,0,3279,23517,26796
2016-12-18 06:00:00-05:00,0,12,6,6,0,3019,19232,22251
2016-12-18 07:00:00-05:00,0,12,7,6,0,2995,18656,21651
2016-12-18 08:00:00-05:00,0,12,8,6,0,2917,20928,23845
2016-12-18 09:00:00-05:00,0,12,9,6,0,3063,22067,25130
2016-12-18 10:00:00-05:00,0,12,10,6,0,2963,22226,25189
2016-12-18 11:00:00-05:00,0,12,11,6,0,2682,19759,22441
2016-12-18 12:00:00-05:00,0.01,12,12,6,0,2033,16439,18472
2016-12-18 13:00:00-05:00,0,12,13,6,0,1704,12682,14386
2016-12-18 14:00:00-05:00,0,12,14,6,0,1420,8337,9757
2016-12-18 15:00:00-05:00,0,12,15,6,0,648,3727,4375
2016-12-18 16:00:00-05:00,0,12,16,6,0,433,3683,4116
2016-12-18 17:00:00-05:00,0,12,17,6,0,532,4557,5089
2016-12-18 18:00:00-05:00,0,12,18,6,0,657,7272,7929
2016-12-18 19:00:00-05:00,0,12,19,6,0,958,10763,11721
2016-12-18 20:00:00-05:00,0,12,20,6,0,1318,15445,16763
2016-12-18 21:00:00-05:00,0,12,21,6,0,1527,17602,19129
2016-12-18 22:00:00-05:00,0,12,22,6,0,1628,19700,21328
2016-12-18 23:00:00-05:00,0,12,23,6,0,1923,20327,22250
2016-12-19 00:00:00-05:00,0,12,0,0,0,2029,20099,22128
2016-12-19 01:00:00-05:00,0,12,1,0,0,2267,18598,20865
2016-12-19 02:00:00-05:00,0,12,2,0,0,2383,17148,19531
2016-12-19 03:00:00-05:00,0,12,3,0,0,2551,18278,20829
2016-12-19 04:00:00-05:00,0,12,4,0,0,2616,18953,21569
2016-12-19 05:00:00-05:00,0,12,5,0,0,2545,17978,20523
2016-12-19 06:00:00-05:00,0,12,6,0,0,2170,16074,18244
2016-12-19 07:00:00-05:00,0,12,7,0,0,2078,15802,17880
2016-12-19 08:00:00-05:00,0,12,8,0,0,1774,14531,16305
2016-12-19 09:00:00-05:00,0,12,9,0,0,1410,10884,12294
2016-12-19 10:00:00-05:00,0,12,10,0,0,1071,7522,8593
2016-12-19 11:00:00-05:00,0,12,11,0,0,725,4706,5431
2016-12-19 12:00:00-05:00,0,12,12,0,0,461,2890,3351
2016-12-19 13:00:00-05:00,0,12,13,0,0,336,2129,2465
2016-12-19 14:00:00-05:00,0,12,14,0,0,377,2555,2932
2016-12-19 15:00:00-05:00,0,12,15,0,0,349,3829,4178
2016-12-19 16:00:00-05:00,0,12,16,0,0,547,9032,9579
2016-12-19 17:00:00-05:00,0,12,17,0,0,1315,14880,16195
2016-12-19 18:00:00-05:00,0,12,18,0,0,2004,18207,20211
2016-12-19 19:00:00-05:00,0,12,19,0,0,1901,17775,19676
2016-12-19 20:00:00-05:00,0,12,20,0,0,1773,16507,18280
2016-12-19 21:00:00-05:00,0,12,21,0,0,1602,17437,19039
2016-12-19 22:00:00-05:00,0,12,22,0,0,1542,18061,19603
2016-12-19 23:00:00-05:00,0,12,23,0,0,1617,17895,19512
2016-12-20 00:00:00-05:00,0,12,0,1,0,1859,19103,20962
2016-12-20 01:00:00-05:00,0,12,1,1,0,2133,18733,20866
2016-12-20 02:00:00-05:00,0,12,2,1,0,2275,16490,18765
2016-12-20 03:00:00-05:00,0,12,3,1,0,2659,19177,21836
2016-12-20 04:00:00-05:00,0,12,4,1,0,2961,22238,25199
2016-12-20 05:00:00-05:00,0,12,5,1,0,2818,21951,24769
2016-12-20 06:00:00-05:00,0,12,6,1,0,2322,21525,23847
2016-12-20 07:00:00-05:00,0,12,7,1,0,2095,21417,23512
2016-12-20 08:00:00-05:00,0,12,8,1,0,1640,19546,21186
2016-12-20 09:00:00-05:00,0,12,9,1,0,1329,13558,14887
2016-12-20 10:00:00-05:00,0,12,10,1,0,967,9148,10115
2016-12-20 11:00:00-05:00,0,12,11,1,0,649,5275,5924
2016-12-20 12:00:00-05:00,0,12,12,1,0,380,3290,3670
2016-12-20 13:00:00-05:00,0,12,13,1,0,292,2157,2449
2016-12-20 14:00:00-05:00,0,12,14,1,0,253,2469,2722
2016-12-20 15:00:00-05:00,0,12,15,1,0,288,3927,4215
2016-12-20 16:00:00-05:00,0,12,16,1,0,503,9196,9699
2016-12-20 17:00:00-05:00,0,12,17,1,0,1255,15299,16554
2016-12-20 18:00:00-05:00,0,12,18,1,0,1872,19082,20954
2016-12-20 19:00:00-05:00,0,12,19,1,0,1916,18513,20429
2016-12-20 20:00:00-05:00,0,12,20,1,0,1689,17259,18948
2016-12-20 21:00:00-05:00,0,12,21,1,0,1652,17867,19519
2016-12-20 22:00:00-05:00,0,12,22,1,0,1681,18821,20502
2016-12-20 23:00:00-05:00,0,12,23,1,0,1666,18696,20362
2016-12-21 00:00:00-05:00,0,12,0,2,0,1906,19305,21211
2016-12-21 01:00:00-05:00,0,12,1,2,0,2102,18145,20247
2016-12-21 02:00:00-05:00,0,12,2,2,0,2293,15162,17455
2016-12-21 03:00:00-05:00,0,12,3,2,0,2612,18320,20932
2016-12-21 04:00:00-05:00,0,12,4,2,0,2867,22357,25224
2016-12-21 05:00:00-05:00,0,12,5,2,0,2923,22217,25140
2016-12-21 06:00:00-05:00,0,12,6,2,0,2544,21013,23557
2016-12-21 07:00:00-05:00,0,12,7,2,0,2176,22362,24538
2016-12-21 08:00:00-05:00,0,12,8,2,0,1964,21174,23138
2016-12-21 09:00:00-05:00,0,12,9,2,0,1540,15786,17326
2016-12-21 10:00:00-05:00,0,12,10,2,0,1093,10550,11643
2016-12-21 11:00:00-05:00,0,12,11,2,0,774,6366,7140
2016-12-21 12:00:00-05:00,0,12,12,2,0,471,3983,4454
2016-12-21 13:00:00-05:00,0,12,13,2,0,331,2622,2953
2016-12-21 14:00:00-05:00,0,12,14,2,0,351,2895,3246
2016-12-21 15:00:00-05:00,0,12,15,2,0,310,4013,4323
2016-12-21 16:00:00-05:00,0,12,16,2,0,509,8938,9447
2016-12-21 17:00:00-05:00,0,12,17,2,0,1214,14156,15370
2016-12-21 18:00:00-05:00,0,12,18,2,0,1877,17912,19789
2016-12-21 19:00:00-05:00,0,12,19,2,0,1857,17427,19284
2016-12-21 20:00:00-05:00,0,12,20,2,0,1590,16472,18062
2016-12-21 21:00:00-05:00,0,12,21,2,0,1640,17487,19127
2016-12-21 22:00:00-05:00,0,12,22,2,0,1689,18743,20432
2016-12-21 23:00:00-05:00,0,12,23,2,0,1798,18580,20378
2016-12-22 00:00:00-05:00,0,12,0,3,0,1935,19060,20995
2016-12-22 01:00:00-05:00,0,12,1,3,0,2130,17704,19834
2016-12-22 02:00:00-05:00,0,12,2,3,0,2357,15302,17659
2016-12-22 03:00:00-05:00,0,12,3,3,0,2770,18453,21223
2016-12-22 04:00:00-05:00,0,12,4,3,0,2922,21625,24547
2016-12-22 05:00:00-05:00,0,12,5,3,0,2898,22039,24937
2016-12-22 06:00:00-05:00,0,12,6,3,0,2524,20240,22764
2016-12-22 07:00:00-05:00,0,12,7,3,0,2309,20620,22929
2016-12-22 08:00:00-05:00,0,12,8,3,0,1968,19471,21439
2016-12-22 09:00:00-05:00,0,12,9,3,0,1603,15800,17403
2016-12-22 10:00:00-05:00,0,12,10,3,0,1203,11649,12852
2016-12-22 11:00:00-05:00,0,12,11,3,0,874,7324,8198
2016-12-22 12:00:00-05:00,0,12,12,3,0,553,4783,5336
2016-12-22 13:00:00-05:00,0,12,13,3,0,418,3266,3684
2016-12-22 14:00:00-05:00,0,12,14,3,0,346,3262,3608
2016-12-22 15:00:00-05:00,0,12,15,3,0,318,3768,4086
2016-12-22 16:00:00-05:00,0,12,16,3,0,510,8172,8682
2016-12-22 17:00:00-05:00,0,12,17,3,0,1194,12130,13324
2016-12-22 18:00:00-05:00,0,12,18,3,0,1848,15753,17601
2016-12-22 19:00:00-05:00,0,12,19,3,0,1836,15950,17786
2016-12-22 20:00:00-05:00,0,12,20,3,0,1691,15536,17227
2016-12-22 21:00:00-05:00,0,12,21,3,0,1514,16715,18229
2016-12-22 22:00:00-05:00,0,12,22,3,0,1669,17573,19242
2016-12-22 23:00:00-05:00,0,12,23,3,0,1728,17389,19117
2016-12-23 00:00:00-05:00,0,12,0,4,0,1917,18696,20613
2016-12-23 01:00:00-05:00,0,12,1,4,0,2146,18169,20315
2016-12-23 02:00:00-05:00,0,12,2,4,0,2433,15611,18044
2016-12-23 03:00:00-05:00,0,12,3,4,0,2947,18468,21415
2016-12-23 04:00:00-05:00,0,12,4,4,0,3069,21722,24791
2016-12-23 05:00:00-05:00,0,12,5,4,0,2996,20690,23686
2016-12-23 06:00:00-05:00,0,12,6,4,0,2655,18959,21614
2016-12-23 07:00:00-05:00,0,12,7,4,0,2550,19357,21907
2016-12-23 08:00:00-05:00,0,12,8,4,0,2271,18789,21060
2016-12-23 09:00:00-05:00,0,12,9,4,0,1977,16378,18355
2016-12-23 10:00:00-05:00,0,12,10,4,0,1563,13091,14654
2016-12-23 11:00:00-05:00,0,12,11,4,0,1130,9245,10375
2016-12-23 12:00:00-05:00,0,12,12,4,0,749,6615,7364
2016-12-23 13:00:00-05:00,0,12,13,4,0,577,4545,5122
2016-12-23 14:00:00-05:00,0,12,14,4,0,502,4247,4749
2016-12-23 15:00:00-05:00,0,12,15,4,0,380,3934,4314
2016-12-23 16:00:00-05:00,0,12,16,4,0,524,7094,7618
2016-12-23 17:00:00-05:00,0,12,17,4,0,1093,9956,11049
2016-12-23 18:00:00-05:00,0,12,18,4,0,1601,12458,14059
2016-12-23 19:00:00-05:00,0,12,19,4,0,1606,13062,14668
2016-12-23 20:00:00-05:00,0,12,20,4,0,1720,14276,15996
2016-12-23 21:00:00-05:00,0,12,21,4,0,1638,15929,17567
2016-12-23 22:00:00-05:00,0,12,22,4,0,1591,17582,19173
2016-12-23 23:00:00-05:00,0,12,23,4,0,1660,18649,20309
2016-12-24 00:00:00-05:00,0,12,0,5,0,2077,19500,21577
2016-12-24 01:00:00-05:00,0,12,1,5,0,2563,19099,21662
2016-12-24 02:00:00-05:00,0,12,2,5,0,2832,16803,19635
2016-12-24 03:00:00-05:00,0,12,3,5,0,3026,18202,21228
2016-12-24 04:00:00-05:00,0,12,4,5,0,3068,18126,21194
2016-12-24 05:00:00-05:00,0,12,5,5,0,3073,17064,20137
2016-12-24 06:00:00-05:00,0.01,12,6,5,0,2858,14076,16934
2016-12-24 07:00:00-05:00,0.07,12,7,5,0,2692,14799,17491
2016-12-24 08:00:00-05:00,0.08,12,8,5,0,2476,14628,17104
2016-12-24 09:00:00-05:00,0.12,12,9,5,0,2207,12777,14984
2016-12-24 10:00:00-05:00,0.16,12,10,5,0,2035,10753,12788
2016-12-24 11:00:00-05:00,0.06,12,11,5,0,1750,9059,10809
2016-12-24 12:00:00-05:00,0.01,12,12,5,0,1307,7684,8991
2016-12-24 13:00:00-05:00,0.01,12,13,5,0,1162,5853,7015
2016-12-24 14:00:00-05:00,0,12,14,5,0,992,4906,5898
2016-12-24 15:00:00-05:00,0,12,15,5,0,522,2911,3433
2016-12-24 16:00:00-05:00,0,12,16,5,0,434,3599,4033
2016-12-24 17:00:00-05:00,0,12,17,5,0,558,4576,5134
2016-12-24 18:00:00-05:00,0,12,18,5,0,777,6540,7317
2016-12-24 19:00:00-05:00,0,12,19,5,0,1056,10388,11444
2016-12-24 20:00:00-05:00,0,12,20,5,0,1323,14135,15458
2016-12-24 21:00:00-05:00,0,12,21,5,0,1549,14576,16125
2016-12-24 22:00:00-05:00,0,12,22,5,0,1627,14700,16327
2016-12-24 23:00:00-05:00,0,12,23,5,0,1868,14313,16181
2016-12-25 00:00:00-05:00,0,12,0,6,0,1901,13632,15533
2016-12-25 01:00:00-05:00,0,12,1,6,0,2106,14456,16562
2016-12-25 02:00:00-05:00,0,12,2,6,0,2356,14347,16703
2016-12-25 03:00:00-05:00,0,12,3,6,0,2643,15087,17730
2016-12-25 04:00:00-05:00,0,12,4,6,0,2682,14239,16921
2016-12-25 05:00:00-05:00,0,12,5,6,0,2834,12857,15691
2016-12-25 06:00:00-05:00,0,12,6,6,0,2573,11860,14433
2016-12-25 07:00:00-05:00,0,12,7,6,0,2415,11528,13943
2016-12-25 08:00:00-05:00,0,12,8,6,0,2192,11789,13981
2016-12-25 09:00:00-05:00,0,12,9,6,0,2083,10440,12523
2016-12-25 10:00:00-05:00,0,12,10,6,0,1724,8750,10474
2016-12-25 11:00:00-05:00,0,12,11,6,0,1620,6535,8155
2016-12-25 12:00:00-05:00,0,12,12,6,0,1261,4560,5821
2016-12-25 13:00:00-05:00,0,12,13,6,0,988,3245,4233
2016-12-25 14:00:00-05:00,0,12,14,6,0,811,2505,3316
2016-12-25 15:00:00-05:00,0,12,15,6,0,399,1639,2038
2016-12-25 16:00:00-05:00,0,12,16,6,0,388,2158,2546
2016-12-25 17:00:00-05:00,0,12,17,6,0,381,2519,2900
2016-12-25 18:00:00-05:00,0,12,18,6,0,416,3145,3561
2016-12-25 19:00:00-05:00,0,12,19,6,0,553,5047,5600
2016-12-25 20:00:00-05:00,0,12,20,6,0,694,7063,7757
2016-12-25 21:00:00-05:00,0,12,21,6,0,813,8267,9080
2016-12-25 22:00:00-05:00,0,12,22,6,0,927,9126,10053
2016-12-25 23:00:00-05:00,0,12,23,6,0,1122,9262,10384
2016-12-26 00:00:00-05:00,0,12,0,0,1,1223,9945,11168
2016-12-26 01:00:00-05:00,0,12,1,0,1,1419,10474,11893
2016-12-26 02:00:00-05:00,0,12,2,0,1,1425,9882,11307
2016-12-26 03:00:00-05:00,0,12,3,0,1,1602,9979,11581
2016-12-26 04:00:00-05:00,0,12,4,0,1,1518,9739,11257
2016-12-26 05:00:00-05:00,0,12,5,0,1,1543,8979,10522
2016-12-26 06:00:00-05:00,0,12,6,0,1,1494,8825,10319
2016-12-26 07:00:00-05:00,0,12,7,0,1,1447,9455,10902
2016-12-26 08:00:00-05:00,0,12,8,0,1,1431,9147,10578
2016-12-26 09:00:00-05:00,0,12,9,0,1,1303,7647,8950
2016-12-26 10:00:00-05:00,0,12,10,0,1,1057,5438,6495
2016-12-26 11:00:00-05:00,0,12,11,0,1,765,3382,4147
2016-12-26 12:00:00-05:00,0,12,12,0,1,537,2211,2748
2016-12-26 13:00:00-05:00,0,12,13,0,1,388,1655,2043
2016-12-26 14:00:00-05:00,0,12,14,0,1,362,1547,1909
2016-12-26 15:00:00-05:00,0,12,15,0,1,237,1482,1719
2016-12-26 16:00:00-05:00,0,12,16,0,1,330,2900,3230
2016-12-26 17:00:00-05:00,0,12,17,0,1,487,4054,4541
2016-12-26 18:00:00-05:00,0,12,18,0,1,600,5161,5761
2016-12-26 19:00:00-05:00,0,12,19,0,1,690,7085,7775
2016-12-26 20:00:00-05:00,0,12,20,0,1,806,9244,10050
2016-12-26 21:00:00-05:00,0,12,21,0,1,908,10493,11401
2016-12-26 22:00:00-05:00,0,12,22,0,1,994,12038,13032
2016-12-26 23:00:00-05:00,0,12,23,0,1,1277,13955,15232
2016-12-27 00:00:00-05:00,0,12,0,1,0,1439,14914,16353
2016-12-27 01:00:00-05:00,0,12,1,1,0,1527,14269,15796
2016-12-27 02:00:00-05:00,0,12,2,1,0,1514,12982,14496
2016-12-27 03:00:00-05:00,0,12,3,1,0,1580,13432,15012
2016-12-27 04:00:00-05:00,0,12,4,1,0,1560,14167,15727
2016-12-27 05:00:00-05:00,0,12,5,1,0,1517,12676,14193
2016-12-27 06:00:00-05:00,0,12,6,1,0,1356,11164,12520
2016-12-27 07:00:00-05:00,0,12,7,1,0,1343,11287,12630
2016-12-27 08:00:00-05:00,0,12,8,1,0,1183,11180,12363
2016-12-27 09:00:00-05:00,0,12,9,1,0,935,8476,9411
2016-12-27 10:00:00-05:00,0,12,10,1,0,721,6340,7061
2016-12-27 11:00:00-05:00,0,12,11,1,0,507,3573,4080
2016-12-27 12:00:00-05:00,0,12,12,1,0,330,2200,2530
2016-12-27 13:00:00-05:00,0,12,13,1,0,243,1519,1762
2016-12-27 14:00:00-05:00,0,12,14,1,0,230,1567,1797
2016-12-27 15:00:00-05:00,0,12,15,1,0,195,2205,2400
2016-12-27 16:00:00-05:00,0,12,16,1,0,322,5135,5457
2016-12-27 17:00:00-05:00,0,12,17,1,0,667,6758,7425
2016-12-27 18:00:00-05:00,0,12,18,1,0,1047,9123,10170
2016-12-27 19:00:00-05:00,0,12,19,1,0,1166,10435,11601
2016-12-27 20:00:00-05:00,0,12,20,1,0,1140,11815,12955
2016-12-27 21:00:00-05:00,0,12,21,1,0,1163,12723,13886
2016-12-27 22:00:00-05:00,0,12,22,1,0,1109,13867,14976
2016-12-27 23:00:00-05:00,0,12,23,1,0,1273,14569,15842
2016-12-28 00:00:00-05:00,0,12,0,2,0,1308,15174,16482
2016-12-28 01:00:00-05:00,0,12,1,2,0,1585,15669,17254
2016-12-28 02:00:00-05:00,0,12,2,2,0,1745,14448,16193
2016-12-28 03:00:00-05:00,0,12,3,2,0,1870,15368,17238
2016-12-28 04:00:00-05:00,0,12,4,2,0,1956,16749,18705
2016-12-28 05:00:00-05:00,0,12,5,2,0,1891,15140,17031
2016-12-28 06:00:00-05:00,0,12,6,2,0,1696,13597,15293
2016-12-28 07:00:00-05:00,0,12,7,2,0,1640,15286,16926
2016-12-28 08:00:00-05:00,0,12,8,2,0,1428,14500,15928
2016-12-28 09:00:00-05:00,0,12,9,2,0,1152,11043,12195
2016-12-28 10:00:00-05:00,0,12,10,2,0,934,7955,8889
2016-12-28 11:00:00-05:00,0,12,11,2,0,641,5178,5819
2016-12-28 12:00:00-05:00,0,12,12,2,0,443,3139,3582
2016-12-28 13:00:00-05:00,0,12,13,2,0,314,2122,2436
2016-12-28 14:00:00-05:00,0,12,14,2,0,240,2068,2308
2016-12-28 15:00:00-05:00,0,12,15,2,0,180,2521,2701
2016-12-28 16:00:00-05:00,0,12,16,2,0,362,5634,5996
2016-12-28 17:00:00-05:00,0,12,17,2,0,649,7109,7758
2016-12-28 18:00:00-05:00,0,12,18,2,0,1193,10706,11899
2016-12-28 19:00:00-05:00,0,12,19,2,0,1333,11975,13308
2016-12-28 20:00:00-05:00,0,12,20,2,0,1279,13133,14412
2016-12-28 21:00:00-05:00,0,12,21,2,0,1346,14732,16078
2016-12-28 22:00:00-05:00,0,12,22,2,0,1339,15810,17149
2016-12-28 23:00:00-05:00,0,12,23,2,0,1499,16669,18168
2016-12-29 00:00:00-05:00,0,12,0,3,0,1590,16602,18192
2016-12-29 01:00:00-05:00,0,12,1,3,0,1885,16570,18455
2016-12-29 02:00:00-05:00,0,12,2,3,0,1911,14378,16289
2016-12-29 03:00:00-05:00,0,12,3,3,0,2192,15725,17917
2016-12-29 04:00:00-05:00,0,12,4,3,0,2328,17721,20049
2016-12-29 05:00:00-05:00,0,12,5,3,0,2229,17515,19744
2016-12-29 06:00:00-05:00,0,12,6,3,0,2028,14909,16937
2016-12-29 07:00:00-05:00,0,12,7,3,0,1704,16040,17744
2016-12-29 08:00:00-05:00,0,12,8,3,0,1582,15119,16701
2016-12-29 09:00:00-05:00,0.07,12,9,3,0,1324,12923,14247
2016-12-29 10:00:00-05:00,0.05,12,10,3,0,1048,10297,11345
2016-12-29 11:00:00-05:00,0.06,12,11,3,0,816,6372,7188
2016-12-29 12:00:00-05:00,0.07,12,12,3,0,510,4514,5024
2016-12-29 13:00:00-05:00,0.05,12,13,3,0,393,3213,3606
2016-12-29 14:00:00-05:00,0.06,12,14,3,0,262,2719,2981
2016-12-29 15:00:00-05:00,0.11,12,15,3,0,242,2544,2786
2016-12-29 16:00:00-05:00,0.01,12,16,3,0,370,5318,5688
2016-12-29 17:00:00-05:00,0,12,17,3,0,670,7035,7705
2016-12-29 18:00:00-05:00,0,12,18,3,0,1203,10730,11933
2016-12-29 19:00:00-05:00,0,12,19,3,0,1483,13804,15287
2016-12-29 20:00:00-05:00,0,12,20,3,0,1360,14359,15719
2016-12-29 21:00:00-05:00,0,12,21,3,0,1395,15822,17217
2016-12-29 22:00:00-05:00,0,12,22,3,0,1399,17433,18832
2016-12-29 23:00:00-05:00,0,12,23,3,0,1498,16843,18341
2016-12-30 00:00:00-05:00,0,12,0,4,0,1654,18320,19974
2016-12-30 01:00:00-05:00,0,12,1,4,0,1954,16976,18930
2016-12-30 02:00:00-05:00,0,12,2,4,0,1920,14277,16197
2016-12-30 03:00:00-05:00,0,12,3,4,0,2043,15931,17974
2016-12-30 04:00:00-05:00,0,12,4,4,0,2178,17712,19890
2016-12-30 05:00:00-05:00,0,12,5,4,0,2158,16260,18418
2016-12-30 06:00:00-05:00,0,12,6,4,0,1994,14535,16529
2016-12-30 07:00:00-05:00,0,12,7,4,0,1802,15716,17518
2016-12-30 08:00:00-05:00,0,12,8,4,0,1602,15528,17130
2016-12-30 09:00:00-05:00,0,12,9,4,0,1478,14256,15734
2016-12-30 10:00:00-05:00,0,12,10,4,0,1302,12309,13611
2016-12-30 11:00:00-05:00,0,12,11,4,0,1040,8788,9828
2016-12-30 12:00:00-05:00,0,12,12,4,0,769,6458,7227
2016-12-30 13:00:00-05:00,0,12,13,4,0,654,4571,5225
2016-12-30 14:00:00-05:00,0,12,14,4,0,525,3648,4173
2016-12-30 15:00:00-05:00,0,12,15,4,0,309,2819,3128
2016-12-30 16:00:00-05:00,0,12,16,4,0,391,5191,5582
2016-12-30 17:00:00-05:00,0,12,17,4,0,672,6726,7398
2016-12-30 18:00:00-05:00,0,12,18,4,0,1123,9313,10436
2016-12-30 19:00:00-05:00,0,12,19,4,0,1429,11196,12625
2016-12-30 20:00:00-05:00,0,12,20,4,0,1471,13090,14561
2016-12-30 21:00:00-05:00,0,12,21,4,0,1479,14876,16355
2016-12-30 22:00:00-05:00,0,12,22,4,0,1505,16218,17723
2016-12-30 23:00:00-05:00,0,12,23,4,0,1579,17550,19129
2016-12-31 00:00:00-05:00,0,12,0,5,0,1869,17808,19677
2016-12-31 01:00:00-05:00,0,12,1,5,0,2306,17747,20053
2016-12-31 02:00:00-05:00,0,12,2,5,0,2513,16479,18992
2016-12-31 03:00:00-05:00,0,12,3,5,0,2819,17725,20544
2016-12-31 04:00:00-05:00,0,12,4,5,0,2821,18175,20996
2016-12-31 05:00:00-05:00,0,12,5,5,0,2753,18838,21591
2016-12-31 06:00:00-05:00,0,12,6,5,0,2597,15611,18208
2016-12-31 07:00:00-05:00,0,12,7,5,0,2453,15547,18000
2016-12-31 08:00:00-05:00,0,12,8,5,0,2557,16821,19378
2016-12-31 09:00:00-05:00,0,12,9,5,0,2462,16419,18881
2016-12-31 10:00:00-05:00,0,12,10,5,0,2335,15519,17854
2016-12-31 11:00:00-05:00,0,12,11,5,0,2102,12542,14644
2016-12-31 12:00:00-05:00,0,12,12,5,0,1701,10371,12072
2016-12-31 13:00:00-05:00,0,12,13,5,0,1372,8012,9384
2016-12-31 14:00:00-05:00,0,12,14,5,0,1054,5464,6518
2016-12-31 15:00:00-05:00,0,12,15,5,0,509,2608,3117
2016-12-31 16:00:00-05:00,0,12,16,5,0,336,3068,3404
2016-12-31 17:00:00-05:00,0,12,17,5,0,474,3658,4132
2016-12-31 18:00:00-05:00,0,12,18,5,0,594,5205,5799
2016-12-31 19:00:00-05:00,0,12,19,5,0,871,7832,8703
2016-12-31 20:00:00-05:00,0,12,20,5,0,1039,10126,11165
2016-12-31 21:00:00-05:00,0,12,21,5,0,1201,11815,13016
2016-12-31 22:00:00-05:00,0,12,22,5,0,1360,13410,14770
2016-12-31 23:00:00-05:00,0,12,23,5,0,1594,14188,15782
2017-01-01 00:00:00-05:00,0,1,0,6,0,1851,14242,16093
2017-01-01 01:00:00-05:00,0,1,1,6,0,2216,15061,17277
2017-01-01 02:00:00-05:00,0,1,2,6,0,2284,15113,17397
2017-01-01 03:00:00-05:00,0,1,3,6,0,2699,15801,18500
2017-01-01 04:00:00-05:00,0,1,4,6,0,2917,16387,19304
2017-01-01 05:00:00-05:00,0,1,5,6,0,3273,17474,20747
2017-01-01 06:00:00-05:00,0,1,6,6,0,3610,17684,21294
2017-01-01 07:00:00-05:00,0,1,7,6,0,3923,17818,21741
2017-01-01 08:00:00-05:00,0,1,8,6,0,3959,17010,20969
2017-01-01 09:00:00-05:00,0,1,9,6,0,3371,13758,17129
2017-01-01 10:00:00-05:00,0,1,10,6,0,4059,20815,24874
2017-01-01 11:00:00-05:00,0,1,11,6,0,4184,23232,27416
2017-01-01 12:00:00-05:00,0,1,12,6,0,3931,21382,25313
2017-01-01 13:00:00-05:00,0,1,13,6,0,3501,17989,21490
2017-01-01 14:00:00-05:00,0,1,14,6,0,2858,12958,15816
2017-01-01 15:00:00-05:00,0,1,15,6,0,1776,6489,8265
2017-01-01 16:00:00-05:00,0,1,16,6,0,1139,4747,5886
2017-01-01 17:00:00-05:00,0,1,17,6,0,800,4120,4920
2017-01-01 18:00:00-05:00,0,1,18,6,0,572,4137,4709
2017-01-01 19:00:00-05:00,0,1,19,6,0,583,5571,6154
2017-01-01 20:00:00-05:00,0,1,20,6,0,694,8455,9149
2017-01-01 21:00:00-05:00,0,1,21,6,0,823,10513,11336
2017-01-01 22:00:00-05:00,0,1,22,6,0,943,12163,13106
2017-01-01 23:00:00-05:00,0,1,23,6,0,1107,12486,13593
2017-01-02 00:00:00-05:00,0,1,0,0,1,1163,12860,14023
2017-01-02 01:00:00-05:00,0,1,1,0,1,1355,13263,14618
2017-01-02 02:00:00-05:00,0,1,2,0,1,1492,13221,14713
2017-01-02 03:00:00-05:00,0,1,3,0,1,1649,13019,14668
2017-01-02 04:00:00-05:00,0,1,4,0,1,1529,12697,14226
2017-01-02 05:00:00-05:00,0,1,5,0,1,1520,12181,13701
2017-01-02 06:00:00-05:00,0,1,6,0,1,1428,10696,12124
2017-01-02 07:00:00-05:00,0,1,7,0,1,1360,10397,11757
2017-01-02 08:00:00-05:00,0.02,1,8,0,1,1326,9580,10906
2017-01-02 09:00:00-05:00,0.01,1,9,0,1,1146,8292,9438
2017-01-02 10:00:00-05:00,0,1,10,0,1,999,6280,7279
2017-01-02 11:00:00-05:00,0,1,11,0,1,705,4160,4865
2017-01-02 12:00:00-05:00,0.01,1,12,0,1,497,2753,3250
2017-01-02 13:00:00-05:00,0.01,1,13,0,1,391,2106,2497
2017-01-02 14:00:00-05:00,0.03,1,14,0,1,339,2041,2380
2017-01-02 15:00:00-05:00,0.02,1,15,0,1,259,1984,2243
2017-01-02 16:00:00-05:00,0.02,1,16,0,1,303,3039,3342
2017-01-02 17:00:00-05:00,0.01,1,17,0,1,501,4315,4816
2017-01-02 18:00:00-05:00,0.04,1,18,0,1,610,5774,6384
2017-01-02 19:00:00-05:00,0,1,19,0,1,684,7535,8219
2017-01-02 20:00:00-05:00,0,1,20,0,1,804,9751,10555
2017-01-02 21:00:00-05:00,0,1,21,0,1,997,11903,12900
2017-01-02 22:00:00-05:00,0,1,22,0,1,1144,14930,16074
2017-01-02 23:00:00-05:00,0.01,1,23,0,1,1347,15685,17032
2017-01-03 00:00:00-05:00,0.01,1,0,1,0,1508,16680,18188
2017-01-03 01:00:00-05:00,0.01,1,1,1,0,1661,16001,17662
2017-01-03 02:00:00-05:00,0.01,1,2,1,0,1719,15706,17425
2017-01-03 03:00:00-05:00,0.01,1,3,1,0,1886,15595,17481
2017-01-03 04:00:00-05:00,0,1,4,1,0,1799,16179,17978
2017-01-03 05:00:00-05:00,0,1,5,1,0,1664,13073,14737
2017-01-03 06:00:00-05:00,0,1,6,1,0,1451,10831,12282
2017-01-03 07:00:00-05:00,0,1,7,1,0,1257,10793,12050
2017-01-03 08:00:00-05:00,0,1,8,1,0,1096,10039,11135
2017-01-03 09:00:00-05:00,0,1,9,1,0,905,7740,8645
2017-01-03 10:00:00-05:00,0,1,10,1,0,692,5473,6165
2017-01-03 11:00:00-05:00,0.03,1,11,1,0,411,3048,3459
2017-01-03 12:00:00-05:00,0.04,1,12,1,0,277,1937,2214
2017-01-03 13:00:00-05:00,0.05,1,13,1,0,204,1245,1449
2017-01-03 14:00:00-05:00,0.04,1,14,1,0,180,1627,1807
2017-01-03 15:00:00-05:00,0.11,1,15,1,0,210,3156,3366
2017-01-03 16:00:00-05:00,0.07,1,16,1,0,469,8737,9206
2017-01-03 17:00:00-05:00,0,1,17,1,0,1172,14362,15534
2017-01-03 18:00:00-05:00,0.02,1,18,1,0,1922,16985,18907
2017-01-03 19:00:00-05:00,0.01,1,19,1,0,1894,15517,17411
2017-01-03 20:00:00-05:00,0,1,20,1,0,1545,13796,15341
2017-01-03 21:00:00-05:00,0,1,21,1,0,1548,14316,15864
2017-01-03 22:00:00-05:00,0.01,1,22,1,0,1512,15820,17332
2017-01-03 23:00:00-05:00,0.03,1,23,1,0,1526,15875,17401
2017-01-04 00:00:00-05:00,0,1,0,2,0,1737,16083,17820
2017-01-04 01:00:00-05:00,0,1,1,2,0,2087,17648,19735
2017-01-04 02:00:00-05:00,0,1,2,2,0,2009,14967,16976
2017-01-04 03:00:00-05:00,0,1,3,2,0,2129,16385,18514
2017-01-04 04:00:00-05:00,0,1,4,2,0,2414,18878,21292
2017-01-04 05:00:00-05:00,0,1,5,2,0,2102,15927,18029
2017-01-04 06:00:00-05:00,0,1,6,2,0,1631,13465,15096
2017-01-04 07:00:00-05:00,0,1,7,2,0,1284,13529,14813
2017-01-04 08:00:00-05:00,0,1,8,2,0,1087,11354,12441
2017-01-04 09:00:00-05:00,0,1,9,2,0,891,7969,8860
2017-01-04 10:00:00-05:00,0,1,10,2,0,632,5323,5955
2017-01-04 11:00:00-05:00,0,1,11,2,0,438,3243,3681
2017-01-04 12:00:00-05:00,0,1,12,2,0,276,2060,2336
2017-01-04 13:00:00-05:00,0,1,13,2,0,212,1451,1663
2017-01-04 14:00:00-05:00,0,1,14,2,0,182,1575,1757
2017-01-04 15:00:00-05:00,0,1,15,2,0,183,3028,3211
2017-01-04 16:00:00-05:00,0,1,16,2,0,377,8029,8406
2017-01-04 17:00:00-05:00,0,1,17,2,0,1112,14290,15402
2017-01-04 18:00:00-05:00,0,1,18,2,0,1806,16599,18405
2017-01-04 19:00:00-05:00,0,1,19,2,0,1621,15255,16876
2017-01-04 20:00:00-05:00,0,1,20,2,0,1409,13243,14652
2017-01-04 21:00:00-05:00,0,1,21,2,0,1326,13620,14946
2017-01-04 22:00:00-05:00,0,1,22,2,0,1355,13875,15230
2017-01-04 23:00:00-05:00,0,1,23,2,0,1390,14448,15838
2017-01-05 00:00:00-05:00,0,1,0,3,0,1535,15565,17100
2017-01-05 01:00:00-05:00,0,1,1,3,0,1705,15865,17570
2017-01-05 02:00:00-05:00,0,1,2,3,0,1919,14944,16863
2017-01-05 03:00:00-05:00,0,1,3,3,0,2351,17226,19577
2017-01-05 04:00:00-05:00,0,1,4,3,0,2586,19900,22486
2017-01-05 05:00:00-05:00,0,1,5,3,0,2621,19379,22000
2017-01-05 06:00:00-05:00,0,1,6,3,0,2241,17576,19817
2017-01-05 07:00:00-05:00,0,1,7,3,0,1904,17032,18936
2017-01-05 08:00:00-05:00,0,1,8,3,0,1552,15465,17017
2017-01-05 09:00:00-05:00,0,1,9,3,0,1308,10310,11618
2017-01-05 10:00:00-05:00,0,1,10,3,0,865,6886,7751
2017-01-05 11:00:00-05:00,0,1,11,3,0,635,4049,4684
2017-01-05 12:00:00-05:00,0,1,12,3,0,439,2675,3114
2017-01-05 13:00:00-05:00,0,1,13,3,0,251,1824,2075
2017-01-05 14:00:00-05:00,0,1,14,3,0,269,1775,2044
2017-01-05 15:00:00-05:00,0,1,15,3,0,221,3209,3430
2017-01-05 16:00:00-05:00,0,1,16,3,0,426,8823,9249
2017-01-05 17:00:00-05:00,0,1,17,3,0,1216,15787,17003
2017-01-05 18:00:00-05:00,0,1,18,3,0,1984,18786,20770
2017-01-05 19:00:00-05:00,0,1,19,3,0,1827,17136,18963
2017-01-05 20:00:00-05:00,0,1,20,3,0,1489,14677,16166
2017-01-05 21:00:00-05:00,0,1,21,3,0,1406,14961,16367
2017-01-05 22:00:00-05:00,0,1,22,3,0,1404,15840,17244
2017-01-05 23:00:00-05:00,0,1,23,3,0,1469,15558,17027
2017-01-06 00:00:00-05:00,0,1,0,4,0,1627,17276,18903
2017-01-06 01:00:00-05:00,0.02,1,1,4,0,1942,17318,19260
2017-01-06 02:00:00-05:00,0.01,1,2,4,0,2063,15408,17471
2017-01-06 03:00:00-05:00,0.01,1,3,4,0,2436,17948,20384
2017-01-06 04:00:00-05:00,0,1,4,4,0,2741,21265,24006
2017-01-06 05:00:00-05:00,0,1,5,4,0,2617,20933,23550
2017-01-06 06:00:00-05:00,0,1,6,4,0,2251,19927,22178
2017-01-06 07:00:00-05:00,0,1,7,4,0,2183,21711,23894
2017-01-06 08:00:00-05:00,0,1,8,4,0,1693,17477,19170
2017-01-06 09:00:00-05:00,0,1,9,4,0,1358,13172,14530
2017-01-06 10:00:00-05:00,0,1,10,4,0,942,9052,9994
2017-01-06 11:00:00-05:00,0,1,11,4,0,644,5789,6433
2017-01-06 12:00:00-05:00,0,1,12,4,0,429,3871,4300
2017-01-06 13:00:00-05:00,0,1,13,4,0,305,2394,2699
2017-01-06 14:00:00-05:00,0,1,14,4,0,268,2258,2526
2017-01-06 15:00:00-05:00,0,1,15,4,0,230,3427,3657
2017-01-06 16:00:00-05:00,0,1,16,4,0,468,8703,9171
2017-01-06 17:00:00-05:00,0,1,17,4,0,1152,15574,16726
2017-01-06 18:00:00-05:00,0,1,18,4,0,1835,17906,19741
2017-01-06 19:00:00-05:00,0,1,19,4,0,1672,16109,17781
2017-01-06 20:00:00-05:00,0,1,20,4,0,1423,14275,15698
2017-01-06 21:00:00-05:00,0,1,21,4,0,1367,14267,15634
2017-01-06 22:00:00-05:00,0,1,22,4,0,1253,15257,16510
2017-01-06 23:00:00-05:00,0,1,23,4,0,1201,15688,16889
2017-01-07 00:00:00-05:00,0,1,0,5,0,1631,17551,19182
2017-01-07 01:00:00-05:00,0,1,1,5,0,2024,17656,19680
2017-01-07 02:00:00-05:00,0,1,2,5,0,2225,16258,18483
2017-01-07 03:00:00-05:00,0,1,3,5,0,2715,19594,22309
2017-01-07 04:00:00-05:00,0,1,4,5,0,3057,22943,26000
2017-01-07 05:00:00-05:00,0,1,5,5,0,2998,22953,25951
2017-01-07 06:00:00-05:00,0,1,6,5,0,2759,19573,22332
2017-01-07 07:00:00-05:00,0,1,7,5,0,2585,19022,21607
2017-01-07 08:00:00-05:00,0,1,8,5,0,2605,21283,23888
2017-01-07 09:00:00-05:00,0,1,9,5,0,2526,19282,21808
2017-01-07 10:00:00-05:00,0.02,1,10,5,0,2320,17254,19574
2017-01-07 11:00:00-05:00,0.02,1,11,5,0,1996,14586,16582
2017-01-07 12:00:00-05:00,0.02,1,12,5,0,1545,11435,12980
2017-01-07 13:00:00-05:00,0.02,1,13,5,0,1284,8205,9489
2017-01-07 14:00:00-05:00,0.02,1,14,5,0,981,5119,6100
2017-01-07 15:00:00-05:00,0.04,1,15,5,0,487,2565,3052
2017-01-07 16:00:00-05:00,0.02,1,16,5,0,384,3608,3992
2017-01-07 17:00:00-05:00,0.02,1,17,5,0,571,5794,6365
2017-01-07 18:00:00-05:00,0.01,1,18,5,0,849,8497,9346
2017-01-07 19:00:00-05:00,0,1,19,5,0,1222,13053,14275
2017-01-07 20:00:00-05:00,0.01,1,20,5,0,1404,15767,17171
2017-01-07 21:00:00-05:00,0,1,21,5,0,1450,16814,18264
2017-01-07 22:00:00-05:00,0,1,22,5,0,1479,17603,19082
2017-01-07 23:00:00-05:00,0,1,23,5,0,1461,17283,18744
2017-01-08 00:00:00-05:00,0,1,0,6,0,1544,15804,17348
2017-01-08 01:00:00-05:00,0,1,1,6,0,1473,15626,17099
2017-01-08 02:00:00-05:00,0,1,2,6,0,1367,13214,14581
2017-01-08 03:00:00-05:00,0,1,3,6,0,1338,12936,14274
2017-01-08 04:00:00-05:00,0,1,4,6,0,1355,15599,16954
2017-01-08 05:00:00-05:00,0,1,5,6,0,1374,16566,17940
2017-01-08 06:00:00-05:00,0,1,6,6,0,1544,13743,15287
2017-01-08 07:00:00-05:00,0,1,7,6,0,1552,13819,15371
2017-01-08 08:00:00-05:00,0,1,8,6,0,1483,15106,16589
2017-01-08 09:00:00-05:00,0,1,9,6,0,1614,15985,17599
2017-01-08 10:00:00-05:00,0,1,10,6,0,1545,14248,15793
2017-01-08 11:00:00-05:00,0,1,11,6,0,1341,12374,13715
2017-01-08 12:00:00-05:00,0,1,12,6,0,1132,10633,11765
2017-01-08 13:00:00-05:00,0,1,13,6,0,946,7864,8810
2017-01-08 14:00:00-05:00,0,1,14,6,0,727,4811,5538
2017-01-08 15:00:00-05:00,0,1,15,6,0,330,2315,2645
2017-01-08 16:00:00-05:00,0,1,16,6,0,300,3228,3528
2017-01-08 17:00:00-05:00,0,1,17,6,0,410,4614,5024
2017-01-08 18:00:00-05:00,0,1,18,6,0,551,7145,7696
2017-01-08 19:00:00-05:00,0,1,19,6,0,868,10422,11290
2017-01-08 20:00:00-05:00,0,1,20,6,0,1222,14097,15319
2017-01-08 21:00:00-05:00,0,1,21,6,0,1447,16025,17472
2017-01-08 22:00:00-05:00,0,1,22,6,0,1600,18198,19798
2017-01-08 23:00:00-05:00,0,1,23,6,0,1808,17859,19667
2017-01-09 00:00:00-05:00,0,1,0,0,0,1880,16946,18826
2017-01-09 01:00:00-05:00,0,1,1,0,0,2132,17885,20017
2017-01-09 02:00:00-05:00,0,1,2,0,0,2215,18171,20386
2017-01-09 03:00:00-05:00,0,1,3,0,0,2177,17268,19445
2017-01-09 04:00:00-05:00,0,1,4,0,0,2147,16643,18790
2017-01-09 05:00:00-05:00,0,1,5,0,0,2051,15085,17136
2017-01-09 06:00:00-05:00,0,1,6,0,0,1916,13888,15804
2017-01-09 07:00:00-05:00,0,1,7,0,0,1718,12110,13828
2017-01-09 08:00:00-05:00,0,1,8,0,0,1337,10308,11645
2017-01-09 09:00:00-05:00,0,1,9,0,0,1189,8795,9984
2017-01-09 10:00:00-05:00,0,1,10,0,0,856,5245,6101
2017-01-09 11:00:00-05:00,0,1,11,0,0,528,3514,4042
2017-01-09 12:00:00-05:00,0,1,12,0,0,326,2116,2442
2017-01-09 13:00:00-05:00,0,1,13,0,0,259,1657,1916
2017-01-09 14:00:00-05:00,0,1,14,0,0,290,2070,2360
2017-01-09 15:00:00-05:00,0,1,15,0,0,288,4085,4373
2017-01-09 16:00:00-05:00,0,1,16,0,0,526,9650,10176
2017-01-09 17:00:00-05:00,0,1,17,0,0,1325,16332,17657
2017-01-09 18:00:00-05:00,0,1,18,0,0,2112,19282,21394
2017-01-09 19:00:00-05:00,0,1,19,0,0,2007,18167,20174
2017-01-09 20:00:00-05:00,0,1,20,0,0,1646,15038,16684
2017-01-09 21:00:00-05:00,0,1,21,0,0,1421,14097,15518
2017-01-09 22:00:00-05:00,0,1,22,0,0,1356,14472,15828
2017-01-09 23:00:00-05:00,0,1,23,0,0,1297,14358,15655
2017-01-10 00:00:00-05:00,0,1,0,1,0,1594,16169,17763
2017-01-10 01:00:00-05:00,0,1,1,1,0,1770,17107,18877
2017-01-10 02:00:00-05:00,0,1,2,1,0,2104,15166,17270
2017-01-10 03:00:00-05:00,0,1,3,1,0,2372,18321,20693
2017-01-10 04:00:00-05:00,0,1,4,1,0,2551,20767,23318
2017-01-10 05:00:00-05:00,0,1,5,1,0,2324,19646,21970
2017-01-10 06:00:00-05:00,0,1,6,1,0,1880,17387,19267
2017-01-10 07:00:00-05:00,0,1,7,1,0,1617,15912,17529
2017-01-10 08:00:00-05:00,0,1,8,1,0,1295,12957,14252
2017-01-10 09:00:00-05:00,0,1,9,1,0,999,8481,9480
2017-01-10 10:00:00-05:00,0,1,10,1,0,693,6481,7174
2017-01-10 11:00:00-05:00,0,1,11,1,0,476,3412,3888
2017-01-10 12:00:00-05:00,0,1,12,1,0,312,2109,2421
2017-01-10 13:00:00-05:00,0,1,13,1,0,210,1509,1719
2017-01-10 14:00:00-05:00,0,1,14,1,0,196,1634,1830
2017-01-10 15:00:00-05:00,0,1,15,1,0,232,3248,3480
2017-01-10 16:00:00-05:00,0,1,16,1,0,429,8965,9394
2017-01-10 17:00:00-05:00,0,1,17,1,0,1207,16270,17477
2017-01-10 18:00:00-05:00,0,1,18,1,0,1907,19588,21495
2017-01-10 19:00:00-05:00,0,1,19,1,0,1774,17485,19259
2017-01-10 20:00:00-05:00,0,1,20,1,0,1437,15086,16523
2017-01-10 21:00:00-05:00,0,1,21,1,0,1340,14552,15892
2017-01-10 22:00:00-05:00,0,1,22,1,0,1302,14807,16109
2017-01-10 23:00:00-05:00,0,1,23,1,0,1324,14883,16207
2017-01-11 00:00:00-05:00,0,1,0,2,0,1577,16698,18275
2017-01-11 01:00:00-05:00,0.01,1,1,2,0,1777,16645,18422
2017-01-11 02:00:00-05:00,0.13,1,2,2,0,1863,14590,16453
2017-01-11 03:00:00-05:00,0.12,1,3,2,0,2166,17233,19399
2017-01-11 04:00:00-05:00,0,1,4,2,0,2355,20338,22693
2017-01-11 05:00:00-05:00,0,1,5,2,0,2225,19512,21737
2017-01-11 06:00:00-05:00,0,1,6,2,0,1905,18762,20667
2017-01-11 07:00:00-05:00,0,1,7,2,0,1622,17077,18699
2017-01-11 08:00:00-05:00,0,1,8,2,0,1400,15135,16535
2017-01-11 09:00:00-05:00,0,1,9,2,0,1091,9902,10993
2017-01-11 10:00:00-05:00,0,1,10,2,0,745,6457,7202
2017-01-11 11:00:00-05:00,0,1,11,2,0,566,4030,4596
2017-01-11 12:00:00-05:00,0,1,12,2,0,373,2737,3110
2017-01-11 13:00:00-05:00,0,1,13,2,0,240,1756,1996
2017-01-11 14:00:00-05:00,0,1,14,2,0,235,1685,1920
2017-01-11 15:00:00-05:00,0,1,15,2,0,209,3188,3397
2017-01-11 16:00:00-05:00,0,1,16,2,0,456,8636,9092
2017-01-11 17:00:00-05:00,0,1,17,2,0,1182,16064,17246
2017-01-11 18:00:00-05:00,0,1,18,2,0,1779,18880,20659
2017-01-11 19:00:00-05:00,0,1,19,2,0,1634,16660,18294
2017-01-11 20:00:00-05:00,0,1,20,2,0,1368,14505,15873
2017-01-11 21:00:00-05:00,0.02,1,21,2,0,1237,14277,15514
2017-01-11 22:00:00-05:00,0.09,1,22,2,0,1228,15082,16310
2017-01-11 23:00:00-05:00,0.14,1,23,2,0,1285,15256,16541
2017-01-12 00:00:00-05:00,0.04,1,0,3,0,1518,15984,17502
2017-01-12 01:00:00-05:00,0.01,1,1,3,0,1783,16327,18110
2017-01-12 02:00:00-05:00,0.01,1,2,3,0,1842,14760,16602
2017-01-12 03:00:00-05:00,0,1,3,3,0,2134,17370,19504
2017-01-12 04:00:00-05:00,0,1,4,3,0,2456,20490,22946
2017-01-12 05:00:00-05:00,0,1,5,3,0,2229,19994,22223
2017-01-12 06:00:00-05:00,0,1,6,3,0,1959,19132,21091
2017-01-12 07:00:00-05:00,0,1,7,3,0,2171,21882,24053
2017-01-12 08:00:00-05:00,0,1,8,3,0,1957,19901,21858
2017-01-12 09:00:00-05:00,0,1,9,3,0,1443,13198,14641
2017-01-12 10:00:00-05:00,0,1,10,3,0,956,7880,8836
2017-01-12 11:00:00-05:00,0,1,11,3,0,524,4450,4974
2017-01-12 12:00:00-05:00,0,1,12,3,0,361,2888,3249
2017-01-12 13:00:00-05:00,0,1,13,3,0,234,1911,2145
2017-01-12 14:00:00-05:00,0,1,14,3,0,242,1944,2186
2017-01-12 15:00:00-05:00,0,1,15,3,0,214,3431,3645
2017-01-12 16:00:00-05:00,0,1,16,3,0,485,8845,9330
2017-01-12 17:00:00-05:00,0,1,17,3,0,1216,16212,17428
2017-01-12 18:00:00-05:00,0,1,18,3,0,1876,18906,20782
2017-01-12 19:00:00-05:00,0,1,19,3,0,1705,16848,18553
2017-01-12 20:00:00-05:00,0,1,20,3,0,1411,14472,15883
2017-01-12 21:00:00-05:00,0,1,21,3,0,1393,14702,16095
2017-01-12 22:00:00-05:00,0,1,22,3,0,1351,15956,17307
2017-01-12 23:00:00-05:00,0,1,23,3,0,1351,15399,16750
2017-01-13 00:00:00-05:00,0,1,0,4,0,1593,16784,18377
2017-01-13 01:00:00-05:00,0,1,1,4,0,1801,16791,18592
2017-01-13 02:00:00-05:00,0,1,2,4,0,2060,15540,17600
2017-01-13 03:00:00-05:00,0,1,3,4,0,2345,17833,20178
2017-01-13 04:00:00-05:00,0,1,4,4,0,2516,21325,23841
2017-01-13 05:00:00-05:00,0,1,5,4,0,2315,20942,23257
2017-01-13 06:00:00-05:00,0,1,6,4,0,2146,19435,21581
2017-01-13 07:00:00-05:00,0,1,7,4,0,1910,20093,22003
2017-01-13 08:00:00-05:00,0,1,8,4,0,1734,19230,20964
2017-01-13 09:00:00-05:00,0,1,9,4,0,1465,14983,16448
2017-01-13 10:00:00-05:00,0,1,10,4,0,1179,10967,12146
2017-01-13 11:00:00-05:00,0,1,11,4,0,812,7121,7933
2017-01-13 12:00:00-05:00,0,1,12,4,0,565,4946,5511
2017-01-13 13:00:00-05:00,0,1,13,4,0,443,3249,3692
2017-01-13 14:00:00-05:00,0,1,14,4,0,384,2944,3328
2017-01-13 15:00:00-05:00,0,1,15,4,0,319,3971,4290
2017-01-13 16:00:00-05:00,0,1,16,4,0,529,8978,9507
2017-01-13 17:00:00-05:00,0,1,17,4,0,1283,15572,16855
2017-01-13 18:00:00-05:00,0,1,18,4,0,1823,17235,19058
2017-01-13 19:00:00-05:00,0,1,19,4,0,1780,15324,17104
2017-01-13 20:00:00-05:00,0,1,20,4,0,1484,13609,15093
2017-01-13 21:00:00-05:00,0,1,21,4,0,1405,13336,14741
2017-01-13 22:00:00-05:00,0,1,22,4,0,1315,14125,15440
2017-01-13 23:00:00-05:00,0,1,23,4,0,1422,15214,16636
2017-01-14 00:00:00-05:00,0,1,0,5,0,1707,17688,19395
2017-01-14 01:00:00-05:00,0,1,1,5,0,2078,17990,20068
2017-01-14 02:00:00-05:00,0,1,2,5,0,2526,16247,18773
2017-01-14 03:00:00-05:00,0,1,3,5,0,2825,19392,22217
2017-01-14 04:00:00-05:00,0,1,4,5,0,3284,23149,26433
2017-01-14 05:00:00-05:00,0,1,5,5,0,3210,23137,26347
2017-01-14 06:00:00-05:00,0,1,6,5,0,2934,20396,23330
2017-01-14 07:00:00-05:00,0,1,7,5,0,2777,19827,22604
2017-01-14 08:00:00-05:00,0,1,8,5,0,2628,21129,23757
2017-01-14 09:00:00-05:00,0,1,9,5,0,2533,19335,21868
2017-01-14 10:00:00-05:00,0,1,10,5,0,2453,17350,19803
2017-01-14 11:00:00-05:00,0,1,11,5,0,2013,14940,16953
2017-01-14 12:00:00-05:00,0,1,12,5,0,1768,12546,14314
2017-01-14 13:00:00-05:00,0,1,13,5,0,1488,9508,10996
2017-01-14 14:00:00-05:00,0,1,14,5,0,1134,6177,7311
2017-01-14 15:00:00-05:00,0.02,1,15,5,0,587,3062,3649
2017-01-14 16:00:00-05:00,0.03,1,16,5,0,417,3846,4263
2017-01-14 17:00:00-05:00,0.02,1,17,5,0,607,5366,5973
2017-01-14 18:00:00-05:00,0.01,1,18,5,0,845,7927,8772
2017-01-14 19:00:00-05:00,0.01,1,19,5,0,1195,11891,13086
2017-01-14 20:00:00-05:00,0,1,20,5,0,1348,14157,15505
2017-01-14 21:00:00-05:00,0,1,21,5,0,1583,16285,17868
2017-01-14 22:00:00-05:00,0.01,1,22,5,0,1702,17405,19107
2017-01-14 23:00:00-05:00,0,1,23,5,0,1825,18182,20007
2017-01-15 00:00:00-05:00,0,1,0,6,0,2033,19049,21082
2017-01-15 01:00:00-05:00,0,1,1,6,0,2410,20577,22987
2017-01-15 02:00:00-05:00,0,1,2,6,0,2332,17611,19943
2017-01-15 03:00:00-05:00,0,1,3,6,0,2432,18385,20817
2017-01-15 04:00:00-05:00,0,1,4,6,0,2605,20424,23029
2017-01-15 05:00:00-05:00,0,1,5,6,0,2516,19473,21989
2017-01-15 06:00:00-05:00,0,1,6,6,0,2461,16088,18549
2017-01-15 07:00:00-05:00,0,1,7,6,0,2258,16142,18400
2017-01-15 08:00:00-05:00,0,1,8,6,0,2259,17562,19821
2017-01-15 09:00:00-05:00,0,1,9,6,0,2502,18216,20718
2017-01-15 10:00:00-05:00,0,1,10,6,0,2295,16900,19195
2017-01-15 11:00:00-05:00,0,1,11,6,0,2147,15228,17375
2017-01-15 12:00:00-05:00,0,1,12,6,0,1810,13219,15029
2017-01-15 13:00:00-05:00,0,1,13,6,0,1593,9977,11570
2017-01-15 14:00:00-05:00,0,1,14,6,0,1247,6314,7561
2017-01-15 15:00:00-05:00,0,1,15,6,0,566,2712,3278
2017-01-15 16:00:00-05:00,0,1,16,6,0,366,3147,3513
2017-01-15 17:00:00-05:00,0,1,17,6,0,471,4501,4972
2017-01-15 18:00:00-05:00,0,1,18,6,0,519,6877,7396
2017-01-15 19:00:00-05:00,0,1,19,6,0,911,9807,10718
2017-01-15 20:00:00-05:00,0,1,20,6,0,1177,13068,14245
2017-01-15 21:00:00-05:00,0,1,21,6,0,1357,14852,16209
2017-01-15 22:00:00-05:00,0,1,22,6,0,1419,16155,17574
2017-01-15 23:00:00-05:00,0,1,23,6,0,1554,16874,18428
2017-01-16 00:00:00-05:00,0,1,0,0,1,1637,16747,18384
2017-01-16 01:00:00-05:00,0,1,1,0,1,1831,17650,19481
2017-01-16 02:00:00-05:00,0,1,2,0,1,1965,17627,19592
2017-01-16 03:00:00-05:00,0,1,3,0,1,2050,17307,19357
2017-01-16 04:00:00-05:00,0,1,4,0,1,2093,17636,19729
2017-01-16 05:00:00-05:00,0,1,5,0,1,2012,15029,17041
2017-01-16 06:00:00-05:00,0,1,6,0,1,2055,15534,17589
2017-01-16 07:00:00-05:00,0,1,7,0,1,1819,14604,16423
2017-01-16 08:00:00-05:00,0,1,8,0,1,1711,13538,15249
2017-01-16 09:00:00-05:00,0,1,9,0,1,1526,12141,13667
2017-01-16 10:00:00-05:00,0,1,10,0,1,1317,8889,10206
2017-01-16 11:00:00-05:00,0,1,11,0,1,936,6108,7044
2017-01-16 12:00:00-05:00,0,1,12,0,1,666,4476,5142
2017-01-16 13:00:00-05:00,0,1,13,0,1,609,3118,3727
2017-01-16 14:00:00-05:00,0,1,14,0,1,537,2693,3230
2017-01-16 15:00:00-05:00,0,1,15,0,1,314,2473,2787
2017-01-16 16:00:00-05:00,0,1,16,0,1,349,4612,4961
2017-01-16 17:00:00-05:00,0,1,17,0,1,492,6498,6990
2017-01-16 18:00:00-05:00,0,1,18,0,1,737,10202,10939
2017-01-16 19:00:00-05:00,0,1,19,0,1,927,11540,12467
2017-01-16 20:00:00-05:00,0,1,20,0,1,975,12556,13531
2017-01-16 21:00:00-05:00,0,1,21,0,1,1055,13706,14761
2017-01-16 22:00:00-05:00,0,1,22,0,1,1109,15150,16259
2017-01-16 23:00:00-05:00,0,1,23,0,1,1154,14904,16058
2017-01-17 00:00:00-05:00,0,1,0,1,0,1219,15465,16684
2017-01-17 01:00:00-05:00,0,1,1,1,0,1441,16529,17970
2017-01-17 02:00:00-05:00,0,1,2,1,0,1522,15719,17241
2017-01-17 03:00:00-05:00,0,1,3,1,0,1602,16891,18493
2017-01-17 04:00:00-05:00,0,1,4,1,0,1784,17989,19773
2017-01-17 05:00:00-05:00,0,1,5,1,0,1700,15831,17531
2017-01-17 06:00:00-05:00,0,1,6,1,0,1412,13569,14981
2017-01-17 07:00:00-05:00,0,1,7,1,0,1215,12507,13722
2017-01-17 08:00:00-05:00,0,1,8,1,0,1105,10992,12097
2017-01-17 09:00:00-05:00,0,1,9,1,0,852,7777,8629
2017-01-17 10:00:00-05:00,0.01,1,10,1,0,658,4849,5507
2017-01-17 11:00:00-05:00,0.04,1,11,1,0,385,3003,3388
2017-01-17 12:00:00-05:00,0.05,1,12,1,0,272,1943,2215
2017-01-17 13:00:00-05:00,0.03,1,13,1,0,174,1413,1587
2017-01-17 14:00:00-05:00,0.01,1,14,1,0,200,1599,1799
2017-01-17 15:00:00-05:00,0,1,15,1,0,211,3488,3699
2017-01-17 16:00:00-05:00,0,1,16,1,0,477,9408,9885
2017-01-17 17:00:00-05:00,0.04,1,17,1,0,1230,16612,17842
2017-01-17 18:00:00-05:00,0.04,1,18,1,0,1875,19556,21431
2017-01-17 19:00:00-05:00,0.06,1,19,1,0,1822,18752,20574
2017-01-17 20:00:00-05:00,0.04,1,20,1,0,1540,16392,17932
2017-01-17 21:00:00-05:00,0.02,1,21,1,0,1537,16677,18214
2017-01-17 22:00:00-05:00,0,1,22,1,0,1442,17373,18815
2017-01-17 23:00:00-05:00,0.01,1,23,1,0,1539,16477,18016
2017-01-18 00:00:00-05:00,0.03,1,0,2,0,1589,17412,19001
2017-01-18 01:00:00-05:00,0,1,1,2,0,1745,16867,18612
2017-01-18 02:00:00-05:00,0.01,1,2,2,0,1754,14873,16627
2017-01-18 03:00:00-05:00,0.05,1,3,2,0,2401,19020,21421
2017-01-18 04:00:00-05:00,0.04,1,4,2,0,3024,22212,25236
2017-01-18 05:00:00-05:00,0,1,5,2,0,2787,21244,24031
2017-01-18 06:00:00-05:00,0,1,6,2,0,2246,20103,22349
2017-01-18 07:00:00-05:00,0,1,7,2,0,1721,18333,20054
2017-01-18 08:00:00-05:00,0,1,8,2,0,1391,16048,17439
2017-01-18 09:00:00-05:00,0,1,9,2,0,1079,10557,11636
2017-01-18 10:00:00-05:00,0,1,10,2,0,756,6507,7263
2017-01-18 11:00:00-05:00,0,1,11,2,0,476,3805,4281
2017-01-18 12:00:00-05:00,0,1,12,2,0,278,2463,2741
2017-01-18 13:00:00-05:00,0,1,13,2,0,209,1795,2004
2017-01-18 14:00:00-05:00,0,1,14,2,0,218,1806,2024
2017-01-18 15:00:00-05:00,0,1,15,2,0,219,3446,3665
2017-01-18 16:00:00-05:00,0,1,16,2,0,427,9404,9831
2017-01-18 17:00:00-05:00,0,1,17,2,0,1169,16736,17905
2017-01-18 18:00:00-05:00,0,1,18,2,0,1873,19972,21845
2017-01-18 19:00:00-05:00,0,1,19,2,0,1749,18005,19754
2017-01-18 20:00:00-05:00,0,1,20,2,0,1415,15410,16825
2017-01-18 21:00:00-05:00,0,1,21,2,0,1356,15412,16768
2017-01-18 22:00:00-05:00,0,1,22,2,0,1306,16108,17414
2017-01-18 23:00:00-05:00,0,1,23,2,0,1405,16083,17488
2017-01-19 00:00:00-05:00,0,1,0,3,0,1528,17107,18635
2017-01-19 01:00:00-05:00,0,1,1,3,0,1567,16576,18143
2017-01-19 02:00:00-05:00,0,1,2,3,0,1892,15069,16961
2017-01-19 03:00:00-05:00,0,1,3,3,0,2160,17562,19722
2017-01-19 04:00:00-05:00,0,1,4,3,0,2484,21020,23504
2017-01-19 05:00:00-05:00,0,1,5,3,0,2428,21244,23672
2017-01-19 06:00:00-05:00,0,1,6,3,0,2217,19790,22007
2017-01-19 07:00:00-05:00,0,1,7,3,0,1685,19627,21312
2017-01-19 08:00:00-05:00,0,1,8,3,0,1458,17442,18900
2017-01-19 09:00:00-05:00,0,1,9,3,0,1212,11961,13173
2017-01-19 10:00:00-05:00,0,1,10,3,0,928,7670,8598
2017-01-19 11:00:00-05:00,0,1,11,3,0,561,4480,5041
2017-01-19 12:00:00-05:00,0,1,12,3,0,371,3150,3521
2017-01-19 13:00:00-05:00,0,1,13,3,0,284,2220,2504
2017-01-19 14:00:00-05:00,0,1,14,3,0,264,1959,2223
2017-01-19 15:00:00-05:00,0,1,15,3,0,214,3474,3688
2017-01-19 16:00:00-05:00,0,1,16,3,0,422,8870,9292
2017-01-19 17:00:00-05:00,0,1,17,3,0,1183,16098,17281
2017-01-19 18:00:00-05:00,0,1,18,3,0,1844,18716,20560
2017-01-19 19:00:00-05:00,0,1,19,3,0,1671,16759,18430
2017-01-19 20:00:00-05:00,0,1,20,3,0,1491,14735,16226
2017-01-19 21:00:00-05:00,0,1,21,3,0,1341,14398,15739
2017-01-19 22:00:00-05:00,0,1,22,3,0,1256,15931,17187
2017-01-19 23:00:00-05:00,0,1,23,3,0,1519,16793,18312
2017-01-20 00:00:00-05:00,0,1,0,4,0,1664,17508,19172
2017-01-20 01:00:00-05:00,0,1,1,4,0,1769,17038,18807
2017-01-20 02:00:00-05:00,0,1,2,4,0,2017,15078,17095
2017-01-20 03:00:00-05:00,0,1,3,4,0,2389,17812,20201
2017-01-20 04:00:00-05:00,0,1,4,4,0,2657,20976,23633
2017-01-20 05:00:00-05:00,0,1,5,4,0,2549,20840,23389
2017-01-20 06:00:00-05:00,0,1,6,4,0,2187,20220,22407
2017-01-20 07:00:00-05:00,0,1,7,4,0,2080,20957,23037
2017-01-20 08:00:00-05:00,0,1,8,4,0,1900,20272,22172
2017-01-20 09:00:00-05:00,0,1,9,4,0,1663,16471,18134
2017-01-20 10:00:00-05:00,0,1,10,4,0,1169,11428,12597
2017-01-20 11:00:00-05:00,0,1,11,4,0,921,6855,7776
2017-01-20 12:00:00-05:00,0,1,12,4,0,677,4371,5048
2017-01-20 13:00:00-05:00,0,1,13,4,0,459,3115,3574
2017-01-20 14:00:00-05:00,0,1,14,4,0,357,2566,2923
2017-01-20 15:00:00-05:00,0,1,15,4,0,299,3613,3912
2017-01-20 16:00:00-05:00,0.02,1,16,4,0,514,8822,9336
2017-01-20 17:00:00-05:00,0.03,1,17,4,0,1231,15447,16678
2017-01-20 18:00:00-05:00,0.01,1,18,4,0,1890,18301,20191
2017-01-20 19:00:00-05:00,0,1,19,4,0,1809,16553,18362
2017-01-20 20:00:00-05:00,0,1,20,4,0,1463,14558,16021
2017-01-20 21:00:00-05:00,0,1,21,4,0,1355,14791,16146
2017-01-20 22:00:00-05:00,0.01,1,22,4,0,1299,15592,16891
2017-01-20 23:00:00-05:00,0,1,23,4,0,1276,16022,17298
2017-01-21 00:00:00-05:00,0,1,0,5,0,1595,17252,18847
2017-01-21 01:00:00-05:00,0,1,1,5,0,2023,19066,21089
2017-01-21 02:00:00-05:00,0,1,2,5,0,2667,17107,19774
2017-01-21 03:00:00-05:00,0,1,3,5,0,2849,19042,21891
2017-01-21 04:00:00-05:00,0,1,4,5,0,3054,21940,24994
2017-01-21 05:00:00-05:00,0,1,5,5,0,2789,21478,24267
2017-01-21 06:00:00-05:00,0,1,6,5,0,2488,18361,20849
2017-01-21 07:00:00-05:00,0,1,7,5,0,2284,18162,20446
2017-01-21 08:00:00-05:00,0,1,8,5,0,2262,18704,20966
2017-01-21 09:00:00-05:00,0,1,9,5,0,2287,18373,20660
2017-01-21 10:00:00-05:00,0,1,10,5,0,2151,16363,18514
2017-01-21 11:00:00-05:00,0,1,11,5,0,1838,14097,15935
2017-01-21 12:00:00-05:00,0,1,12,5,0,1499,11704,13203
2017-01-21 13:00:00-05:00,0,1,13,5,0,1345,9170,10515
2017-01-21 14:00:00-05:00,0,1,14,5,0,1194,6760,7954
2017-01-21 15:00:00-05:00,0,1,15,5,0,581,3359,3940
2017-01-21 16:00:00-05:00,0,1,16,5,0,433,3641,4074
2017-01-21 17:00:00-05:00,0,1,17,5,0,561,5400,5961
2017-01-21 18:00:00-05:00,0,1,18,5,0,867,8213,9080
2017-01-21 19:00:00-05:00,0,1,19,5,0,1235,11934,13169
2017-01-21 20:00:00-05:00,0,1,20,5,0,1477,14640,16117
2017-01-21 21:00:00-05:00,0,1,21,5,0,1589,15946,17535
2017-01-21 22:00:00-05:00,0,1,22,5,0,1558,16670,18228
2017-01-21 23:00:00-05:00,0,1,23,5,0,1642,15667,17309
2017-01-22 00:00:00-05:00,0,1,0,6,0,1716,15391,17107
2017-01-22 01:00:00-05:00,0,1,1,6,0,1937,16141,18078
2017-01-22 02:00:00-05:00,0,1,2,6,0,2174,15127,17301
2017-01-22 03:00:00-05:00,0,1,3,6,0,2324,16926,19250
2017-01-22 04:00:00-05:00,0,1,4,6,0,2414,19474,21888
2017-01-22 05:00:00-05:00,0,1,5,6,0,2458,19941,22399
2017-01-22 06:00:00-05:00,0,1,6,6,0,2358,16430,18788
2017-01-22 07:00:00-05:00,0,1,7,6,0,2470,16661,19131
2017-01-22 08:00:00-05:00,0,1,8,6,0,2335,19706,22041
2017-01-22 09:00:00-05:00,0,1,9,6,0,2522,19710,22232
2017-01-22 10:00:00-05:00,0,1,10,6,0,2439,18992,21431
2017-01-22 11:00:00-05:00,0,1,11,6,0,2131,17289,19420
2017-01-22 12:00:00-05:00,0,1,12,6,0,1861,14756,16617
2017-01-22 13:00:00-05:00,0,1,13,6,0,1585,11028,12613
2017-01-22 14:00:00-05:00,0,1,14,6,0,1174,6903,8077
2017-01-22 15:00:00-05:00,0,1,15,6,0,551,2937,3488
2017-01-22 16:00:00-05:00,0.03,1,16,6,0,419,3039,3458
2017-01-22 17:00:00-05:00,0,1,17,6,0,486,4433,4919
2017-01-22 18:00:00-05:00,0,1,18,6,0,562,6324,6886
2017-01-22 19:00:00-05:00,0,1,19,6,0,790,9198,9988
2017-01-22 20:00:00-05:00,0,1,20,6,0,1113,12654,13767
2017-01-22 21:00:00-05:00,0,1,21,6,0,1323,14531,15854
2017-01-22 22:00:00-05:00,0,1,22,6,0,1325,15975,17300
2017-01-22 23:00:00-05:00,0,1,23,6,0,1485,16650,18135
2017-01-23 00:00:00-05:00,0,1,0,0,0,1625,17533,19158
2017-01-23 01:00:00-05:00,0,1,1,0,0,2022,18554,20576
2017-01-23 02:00:00-05:00,0,1,2,0,0,2098,17743,19841
2017-01-23 03:00:00-05:00,0,1,3,0,0,1735,15217,16952
2017-01-23 04:00:00-05:00,0,1,4,0,0,1810,15138,16948
2017-01-23 05:00:00-05:00,0,1,5,0,0,1697,12659,14356
2017-01-23 06:00:00-05:00,0,1,6,0,0,1561,11535,13096
2017-01-23 07:00:00-05:00,0,1,7,0,0,1468,11903,13371
2017-01-23 08:00:00-05:00,0,1,8,0,0,1263,10039,11302
2017-01-23 09:00:00-05:00,0,1,9,0,0,1013,7016,8029
2017-01-23 10:00:00-05:00,0,1,10,0,0,742,4655,5397
2017-01-23 11:00:00-05:00,0,1,11,0,0,508,2991,3499
2017-01-23 12:00:00-05:00,0,1,12,0,0,352,1963,2315
2017-01-23 13:00:00-05:00,0,1,13,0,0,305,1464,1769
2017-01-23 14:00:00-05:00,0,1,14,0,0,304,1739,2043
2017-01-23 15:00:00-05:00,0,1,15,0,0,271,3374,3645
2017-01-23 16:00:00-05:00,0,1,16,0,0,477,9009,9486
2017-01-23 17:00:00-05:00,0.07,1,17,0,0,1277,15242,16519
2017-01-23 18:00:00-05:00,0.14,1,18,0,0,1888,17845,19733
2017-01-23 19:00:00-05:00,0.14,1,19,0,0,1778,16355,18133
2017-01-23 20:00:00-05:00,0.08,1,20,0,0,1474,14127,15601
2017-01-23 21:00:00-05:00,0.11,1,21,0,0,1277,13708,14985
2017-01-23 22:00:00-05:00,0.13,1,22,0,0,1295,14719,16014
2017-01-23 23:00:00-05:00,0.15,1,23,0,0,1381,14919,16300
2017-01-24 00:00:00-05:00,0.13,1,0,1,0,1669,15544,17213
2017-01-24 01:00:00-05:00,0.11,1,1,1,0,2004,17708,19712
2017-01-24 02:00:00-05:00,0.06,1,2,1,0,2169,15166,17335
2017-01-24 03:00:00-05:00,0.05,1,3,1,0,2719,18809,21528
2017-01-24 04:00:00-05:00,0.04,1,4,1,0,3116,20992,24108
2017-01-24 05:00:00-05:00,0.02,1,5,1,0,2801,19792,22593
2017-01-24 06:00:00-05:00,0.01,1,6,1,0,2132,16858,18990
2017-01-24 07:00:00-05:00,0,1,7,1,0,1725,15274,16999
2017-01-24 08:00:00-05:00,0,1,8,1,0,1323,12916,14239
2017-01-24 09:00:00-05:00,0.02,1,9,1,0,971,8631,9602
2017-01-24 10:00:00-05:00,0.01,1,10,1,0,650,5395,6045
2017-01-24 11:00:00-05:00,0.01,1,11,1,0,421,2974,3395
2017-01-24 12:00:00-05:00,0.16,1,12,1,0,233,1702,1935
2017-01-24 13:00:00-05:00,0.14,1,13,1,0,168,1238,1406
2017-01-24 14:00:00-05:00,0.02,1,14,1,0,191,1454,1645
2017-01-24 15:00:00-05:00,0.01,1,15,1,0,190,3337,3527
2017-01-24 16:00:00-05:00,0.09,1,16,1,0,461,9439,9900
2017-01-24 17:00:00-05:00,0.03,1,17,1,0,1249,16201,17450
2017-01-24 18:00:00-05:00,0.03,1,18,1,0,1885,18971,20856
2017-01-24 19:00:00-05:00,0.04,1,19,1,0,1785,17893,19678
2017-01-24 20:00:00-05:00,0.02,1,20,1,0,1478,15007,16485
2017-01-24 21:00:00-05:00,0.03,1,21,1,0,1543,15915,17458
2017-01-24 22:00:00-05:00,0,1,22,1,0,1577,18115,19692
2017-01-24 23:00:00-05:00,0,1,23,1,0,1505,17029,18534
2017-01-25 00:00:00-05:00,0,1,0,2,0,1691,17532,19223
2017-01-25 01:00:00-05:00,0,1,1,2,0,1748,16838,18586
2017-01-25 02:00:00-05:00,0,1,2,2,0,2153,15899,18052
2017-01-25 03:00:00-05:00,0,1,3,2,0,2413,17596,20009
2017-01-25 04:00:00-05:00,0,1,4,2,0,2584,20799,23383
2017-01-25 05:00:00-05:00,0,1,5,2,0,2654,21245,23899
2017-01-25 06:00:00-05:00,0,1,6,2,0,2202,20749,22951
2017-01-25 07:00:00-05:00,0,1,7,2,0,1812,18725,20537
2017-01-25 08:00:00-05:00,0,1,8,2,0,1327,16043,17370
2017-01-25 09:00:00-05:00,0,1,9,2,0,1049,10856,11905
2017-01-25 10:00:00-05:00,0,1,10,2,0,749,6794,7543
2017-01-25 11:00:00-05:00,0,1,11,2,0,462,3772,4234
2017-01-25 12:00:00-05:00,0,1,12,2,0,277,2316,2593
2017-01-25 13:00:00-05:00,0,1,13,2,0,201,1571,1772
2017-01-25 14:00:00-05:00,0,1,14,2,0,231,1762,1993
2017-01-25 15:00:00-05:00,0,1,15,2,0,236,3379,3615
2017-01-25 16:00:00-05:00,0,1,16,2,0,449,8895,9344
2017-01-25 17:00:00-05:00,0,1,17,2,0,1234,16133,17367
2017-01-25 18:00:00-05:00,0,1,18,2,0,1890,19075,20965
2017-01-25 19:00:00-05:00,0,1,19,2,0,1722,16933,18655
2017-01-25 20:00:00-05:00,0,1,20,2,0,1439,14852,16291
2017-01-25 21:00:00-05:00,0,1,21,2,0,1405,15122,16527
2017-01-25 22:00:00-05:00,0,1,22,2,0,1333,16101,17434
2017-01-25 23:00:00-05:00,0,1,23,2,0,1425,17404,18829
2017-01-26 00:00:00-05:00,0,1,0,3,0,1507,16940,18447
2017-01-26 01:00:00-05:00,0,1,1,3,0,1638,17003,18641
2017-01-26 02:00:00-05:00,0,1,2,3,0,1946,15199,17145
2017-01-26 03:00:00-05:00,0,1,3,3,0,2287,17629,19916
2017-01-26 04:00:00-05:00,0,1,4,3,0,2552,21500,24052
2017-01-26 05:00:00-05:00,0,1,5,3,0,2470,21200,23670
2017-01-26 06:00:00-05:00,0,1,6,3,0,2052,19770,21822
2017-01-26 07:00:00-05:00,0,1,7,3,0,1871,19821,21692
2017-01-26 08:00:00-05:00,0,1,8,3,0,1649,18842,20491
2017-01-26 09:00:00-05:00,0.02,1,9,3,0,1283,13220,14503
2017-01-26 10:00:00-05:00,0,1,10,3,0,939,8278,9217
2017-01-26 11:00:00-05:00,0,1,11,3,0,626,4992,5618
2017-01-26 12:00:00-05:00,0,1,12,3,0,409,3124,3533
2017-01-26 13:00:00-05:00,0,1,13,3,0,289,2156,2445
2017-01-26 14:00:00-05:00,0,1,14,3,0,243,1979,2222
2017-01-26 15:00:00-05:00,0,1,15,3,0,234,3514,3748
2017-01-26 16:00:00-05:00,0,1,16,3,0,422,8936,9358
2017-01-26 17:00:00-05:00,0,1,17,3,0,1252,15986,17238
2017-01-26 18:00:00-05:00,0,1,18,3,0,1934,20622,22556
2017-01-26 19:00:00-05:00,0,1,19,3,0,1918,18806,20724
2017-01-26 20:00:00-05:00,0,1,20,3,0,1509,15080,16589
2017-01-26 21:00:00-05:00,0,1,21,3,0,1375,15017,16392
2017-01-26 22:00:00-05:00,0,1,22,3,0,1297,15406,16703
2017-01-26 23:00:00-05:00,0,1,23,3,0,1399,15199,16598
2017-01-27 00:00:00-05:00,0,1,0,4,0,1641,16899,18540
2017-01-27 01:00:00-05:00,0,1,1,4,0,1885,17373,19258
2017-01-27 02:00:00-05:00,0,1,2,4,0,2162,15629,17791
2017-01-27 03:00:00-05:00,0,1,3,4,0,2466,18163,20629
2017-01-27 04:00:00-05:00,0,1,4,4,0,2804,21973,24777
2017-01-27 05:00:00-05:00,0,1,5,4,0,2638,22140,24778
2017-01-27 06:00:00-05:00,0,1,6,4,0,2344,22205,24549
2017-01-27 07:00:00-05:00,0,1,7,4,0,2108,22152,24260
2017-01-27 08:00:00-05:00,0,1,8,4,0,1783,20938,22721
2017-01-27 09:00:00-05:00,0,1,9,4,0,1587,16228,17815
2017-01-27 10:00:00-05:00,0,1,10,4,0,1275,11381,12656
2017-01-27 11:00:00-05:00,0,1,11,4,0,943,7001,7944
2017-01-27 12:00:00-05:00,0,1,12,4,0,602,4845,5447
2017-01-27 13:00:00-05:00,0,1,13,4,0,410,3131,3541
2017-01-27 14:00:00-05:00,0,1,14,4,0,370,2594,2964
2017-01-27 15:00:00-05:00,0,1,15,4,0,252,3593,3845
2017-01-27 16:00:00-05:00,0,1,16,4,0,499,8901,9400
2017-01-27 17:00:00-05:00,0,1,17,4,0,1255,15923,17178
2017-01-27 18:00:00-05:00,0,1,18,4,0,1978,19222,21200
2017-01-27 19:00:00-05:00,0,1,19,4,0,1889,17446,19335
2017-01-27 20:00:00-05:00,0,1,20,4,0,1663,15484,17147
2017-01-27 21:00:00-05:00,0,1,21,4,0,1474,15831,17305
2017-01-27 22:00:00-05:00,0,1,22,4,0,1400,16744,18144
2017-01-27 23:00:00-05:00,0,1,23,4,0,1524,17662,19186
2017-01-28 00:00:00-05:00,0,1,0,5,0,1796,19069,20865
2017-01-28 01:00:00-05:00,0,1,1,5,0,2050,18096,20146
2017-01-28 02:00:00-05:00,0,1,2,5,0,2339,16355,18694
2017-01-28 03:00:00-05:00,0,1,3,5,0,2706,19458,22164
2017-01-28 04:00:00-05:00,0,1,4,5,0,2987,23383,26370
2017-01-28 05:00:00-05:00,0,1,5,5,0,3147,24053,27200
2017-01-28 06:00:00-05:00,0,1,6,5,0,2916,21024,23940
2017-01-28 07:00:00-05:00,0,1,7,5,0,2831,20377,23208
2017-01-28 08:00:00-05:00,0,1,8,5,0,2704,21794,24498
2017-01-28 09:00:00-05:00,0,1,9,5,0,2690,20538,23228
2017-01-28 10:00:00-05:00,0,1,10,5,0,2503,18775,21278
2017-01-28 11:00:00-05:00,0,1,11,5,0,2234,16114,18348
2017-01-28 12:00:00-05:00,0,1,12,5,0,1845,13538,15383
2017-01-28 13:00:00-05:00,0,1,13,5,0,1476,9736,11212
2017-01-28 14:00:00-05:00,0,1,14,5,0,1113,5970,7083
2017-01-28 15:00:00-05:00,0,1,15,5,0,571,2831,3402
2017-01-28 16:00:00-05:00,0,1,16,5,0,417,3827,4244
2017-01-28 17:00:00-05:00,0,1,17,5,0,558,5497,6055
2017-01-28 18:00:00-05:00,0,1,18,5,0,864,8818,9682
2017-01-28 19:00:00-05:00,0,1,19,5,0,1208,13068,14276
2017-01-28 20:00:00-05:00,0,1,20,5,0,1493,15588,17081
2017-01-28 21:00:00-05:00,0,1,21,5,0,1662,17201,18863
2017-01-28 22:00:00-05:00,0,1,22,5,0,1711,19099,20810
2017-01-28 23:00:00-05:00,0,1,23,5,0,1878,19932,21810
2017-01-29 00:00:00-05:00,0,1,0,6,0,1922,19341,21263
2017-01-29 01:00:00-05:00,0,1,1,6,0,2092,18926,21018
2017-01-29 02:00:00-05:00,0,1,2,6,0,2261,18222,20483
2017-01-29 03:00:00-05:00,0,1,3,6,0,2337,19085,21422
2017-01-29 04:00:00-05:00,0,1,4,6,0,2584,22038,24622
2017-01-29 05:00:00-05:00,0,1,5,6,0,2752,22357,25109
2017-01-29 06:00:00-05:00,0,1,6,6,0,2617,18367,20984
2017-01-29 07:00:00-05:00,0,1,7,6,0,2661,18395,21056
2017-01-29 08:00:00-05:00,0,1,8,6,0,2611,20485,23096
2017-01-29 09:00:00-05:00,0,1,9,6,0,2751,21181,23932
2017-01-29 10:00:00-05:00,0,1,10,6,0,2655,19866,22521
2017-01-29 11:00:00-05:00,0,1,11,6,0,2469,18357,20826
2017-01-29 12:00:00-05:00,0,1,12,6,0,2088,15793,17881
2017-01-29 13:00:00-05:00,0,1,13,6,0,1760,12064,13824
2017-01-29 14:00:00-05:00,0,1,14,6,0,1488,7675,9163
2017-01-29 15:00:00-05:00,0,1,15,6,0,752,3879,4631
2017-01-29 16:00:00-05:00,0,1,16,6,0,500,4275,4775
2017-01-29 17:00:00-05:00,0,1,17,6,0,459,5133,5592
2017-01-29 18:00:00-05:00,0,1,18,6,0,433,6346,6779
2017-01-29 19:00:00-05:00,0,1,19,6,0,500,7726,8226
2017-01-29 20:00:00-05:00,0,1,20,6,0,910,12618,13528
2017-01-29 21:00:00-05:00,0,1,21,6,0,1385,16299,17684
2017-01-29 22:00:00-05:00,0,1,22,6,0,1435,17142,18577
2017-01-29 23:00:00-05:00,0,1,23,6,0,1613,17310,18923
2017-01-30 00:00:00-05:00,0,1,0,0,0,1595,17427,19022
2017-01-30 01:00:00-05:00,0,1,1,0,0,1774,17128,18902
2017-01-30 02:00:00-05:00,0,1,2,0,0,1925,16847,18772
2017-01-30 03:00:00-05:00,0,1,3,0,0,1929,16704,18633
2017-01-30 04:00:00-05:00,0,1,4,0,0,2144,17298,19442
2017-01-30 05:00:00-05:00,0,1,5,0,0,1929,14514,16443
2017-01-30 06:00:00-05:00,0,1,6,0,0,1653,12495,14148
2017-01-30 07:00:00-05:00,0,1,7,0,0,1546,11695,13241
2017-01-30 08:00:00-05:00,0,1,8,0,0,1344,9870,11214
2017-01-30 09:00:00-05:00,0,1,9,0,0,1092,7264,8356
2017-01-30 10:00:00-05:00,0,1,10,0,0,778,4419,5197
2017-01-30 11:00:00-05:00,0,1,11,0,0,509,3090,3599
2017-01-30 12:00:00-05:00,0,1,12,0,0,300,2274,2574
2017-01-30 13:00:00-05:00,0,1,13,0,0,251,1673,1924
2017-01-30 14:00:00-05:00,0,1,14,0,0,226,1896,2122
2017-01-30 15:00:00-05:00,0,1,15,0,0,315,3281,3596
2017-01-30 16:00:00-05:00,0,1,16,0,0,562,9013,9575
2017-01-30 17:00:00-05:00,0,1,17,0,0,1241,15213,16454
2017-01-30 18:00:00-05:00,0,1,18,0,0,1864,17769,19633
2017-01-30 19:00:00-05:00,0,1,19,0,0,1691,15591,17282
2017-01-30 20:00:00-05:00,0,1,20,0,0,1420,13251,14671
2017-01-30 21:00:00-05:00,0,1,21,0,0,1342,13368,14710
2017-01-30 22:00:00-05:00,0,1,22,0,0,1245,14044,15289
2017-01-30 23:00:00-05:00,0,1,23,0,0,1253,13760,15013
2017-01-31 00:00:00-05:00,0,1,0,1,0,1426,15348,16774
2017-01-31 01:00:00-05:00,0,1,1,1,0,1574,16053,17627
2017-01-31 02:00:00-05:00,0,1,2,1,0,1827,15094,16921
2017-01-31 03:00:00-05:00,0,1,3,1,0,2087,17406,19493
2017-01-31 04:00:00-05:00,0,1,4,1,0,2470,20144,22614
2017-01-31 05:00:00-05:00,0,1,5,1,0,2304,19357,21661
2017-01-31 06:00:00-05:00,0,1,6,1,0,1895,17782,19677
2017-01-31 07:00:00-05:00,0,1,7,1,0,1540,16119,17659
2017-01-31 08:00:00-05:00,0,1,8,1,0,1268,14007,15275
2017-01-31 09:00:00-05:00,0,1,9,1,0,944,9141,10085
2017-01-31 10:00:00-05:00,0,1,10,1,0,716,5488,6204
2017-01-31 11:00:00-05:00,0.02,1,11,1,0,405,3242,3647
2017-01-31 12:00:00-05:00,0.01,1,12,1,0,277,2050,2327
2017-01-31 13:00:00-05:00,0.01,1,13,1,0,214,1368,1582
2017-01-31 14:00:00-05:00,0.02,1,14,1,0,207,1636,1843
2017-01-31 15:00:00-05:00,0,1,15,1,0,258,3312,3570
2017-01-31 16:00:00-05:00,0,1,16,1,0,466,9063,9529
2017-01-31 17:00:00-05:00,0,1,17,1,0,1265,16250,17515
2017-01-31 18:00:00-05:00,0,1,18,1,0,1918,19060,20978
2017-01-31 19:00:00-05:00,0,1,19,1,0,1870,17551,19421
2017-01-31 20:00:00-05:00,0,1,20,1,0,1650,15775,17425
2017-01-31 21:00:00-05:00,0,1,21,1,0,1477,14958,16435
2017-01-31 22:00:00-05:00,0,1,22,1,0,1309,14947,16256
2017-01-31 23:00:00-05:00,0,1,23,1,0,1410,15446,16856
2017-02-01 00:00:00-05:00,0,2,0,2,0,1555,16252,17807
2017-02-01 01:00:00-05:00,0,2,1,2,0,1758,15901,17659
2017-02-01 02:00:00-05:00,0,2,2,2,0,1905,14584,16489
2017-02-01 03:00:00-05:00,0,2,3,2,0,2062,17497,19559
2017-02-01 04:00:00-05:00,0,2,4,2,0,2489,21172,23661
2017-02-01 05:00:00-05:00,0,2,5,2,0,2314,19789,22103
2017-02-01 06:00:00-05:00,0,2,6,2,0,1893,19271,21164
2017-02-01 07:00:00-05:00,0,2,7,2,0,1671,19795,21466
2017-02-01 08:00:00-05:00,0,2,8,2,0,1414,17296,18710
2017-02-01 09:00:00-05:00,0,2,9,2,0,1083,11674,12757
2017-02-01 10:00:00-05:00,0,2,10,2,0,772,7087,7859
2017-02-01 11:00:00-05:00,0,2,11,2,0,486,4174,4660
2017-02-01 12:00:00-05:00,0,2,12,2,0,337,2696,3033
2017-02-01 13:00:00-05:00,0,2,13,2,0,194,1704,1898
2017-02-01 14:00:00-05:00,0,2,14,2,0,226,1835,2061
2017-02-01 15:00:00-05:00,0,2,15,2,0,245,3518,3763
2017-02-01 16:00:00-05:00,0,2,16,2,0,483,9063,9546
2017-02-01 17:00:00-05:00,0,2,17,2,0,1246,16286,17532
2017-02-01 18:00:00-05:00,0,2,18,2,0,1978,19772,21750
2017-02-01 19:00:00-05:00,0,2,19,2,0,1759,17222,18981
2017-02-01 20:00:00-05:00,0,2,20,2,0,1609,14909,16518
2017-02-01 21:00:00-05:00,0,2,21,2,0,1447,14816,16263
2017-02-01 22:00:00-05:00,0,2,22,2,0,1415,15549,16964
2017-02-01 23:00:00-05:00,0,2,23,2,0,1478,15503,16981
2017-02-02 00:00:00-05:00,0,2,0,3,0,1678,17415,19093
2017-02-02 01:00:00-05:00,0,2,1,3,0,1852,17301,19153
2017-02-02 02:00:00-05:00,0,2,2,3,0,1971,15765,17736
2017-02-02 03:00:00-05:00,0,2,3,3,0,2293,18280,20573
2017-02-02 04:00:00-05:00,0,2,4,3,0,2655,22171,24826
2017-02-02 05:00:00-05:00,0,2,5,3,0,2498,21649,24147
2017-02-02 06:00:00-05:00,0,2,6,3,0,2145,20295,22440
2017-02-02 07:00:00-05:00,0,2,7,3,0,1995,20587,22582
2017-02-02 08:00:00-05:00,0,2,8,3,0,1759,18771,20530
2017-02-02 09:00:00-05:00,0,2,9,3,0,1343,13328,14671
2017-02-02 10:00:00-05:00,0,2,10,3,0,931,8214,9145
2017-02-02 11:00:00-05:00,0,2,11,3,0,614,4797,5411
2017-02-02 12:00:00-05:00,0,2,12,3,0,397,3127,3524
2017-02-02 13:00:00-05:00,0,2,13,3,0,298,2008,2306
2017-02-02 14:00:00-05:00,0,2,14,3,0,288,2159,2447
2017-02-02 15:00:00-05:00,0,2,15,3,0,257,3452,3709
2017-02-02 16:00:00-05:00,0,2,16,3,0,504,9242,9746
2017-02-02 17:00:00-05:00,0,2,17,3,0,1345,16745,18090
2017-02-02 18:00:00-05:00,0,2,18,3,0,2063,20178,22241
2017-02-02 19:00:00-05:00,0,2,19,3,0,1844,18265,20109
2017-02-02 20:00:00-05:00,0,2,20,3,0,1507,15451,16958
2017-02-02 21:00:00-05:00,0,2,21,3,0,1413,15205,16618
2017-02-02 22:00:00-05:00,0,2,22,3,0,1361,16605,17966
2017-02-02 23:00:00-05:00,0,2,23,3,0,1417,16311,17728
2017-02-03 00:00:00-05:00,0,2,0,4,0,1724,19263,20987
2017-02-03 01:00:00-05:00,0,2,1,4,0,1909,18110,20019
2017-02-03 02:00:00-05:00,0,2,2,4,0,2173,15980,18153
2017-02-03 03:00:00-05:00,0,2,3,4,0,2430,18789,21219
2017-02-03 04:00:00-05:00,0,2,4,4,0,2917,22839,25756
2017-02-03 05:00:00-05:00,0,2,5,4,0,2855,22962,25817
2017-02-03 06:00:00-05:00,0,2,6,4,0,2482,22720,25202
2017-02-03 07:00:00-05:00,0,2,7,4,0,2301,21878,24179
2017-02-03 08:00:00-05:00,0,2,8,4,0,2006,21858,23864
2017-02-03 09:00:00-05:00,0,2,9,4,0,1804,16993,18797
2017-02-03 10:00:00-05:00,0,2,10,4,0,1260,11715,12975
2017-02-03 11:00:00-05:00,0,2,11,4,0,853,7272,8125
2017-02-03 12:00:00-05:00,0,2,12,4,0,608,4730,5338
2017-02-03 13:00:00-05:00,0,2,13,4,0,417,3250,3667
2017-02-03 14:00:00-05:00,0,2,14,4,0,347,2698,3045
2017-02-03 15:00:00-05:00,0,2,15,4,0,244,3689,3933
2017-02-03 16:00:00-05:00,0,2,16,4,0,509,9013,9522
2017-02-03 17:00:00-05:00,0,2,17,4,0,1392,16844,18236
2017-02-03 18:00:00-05:00,0,2,18,4,0,2076,20367,22443
2017-02-03 19:00:00-05:00,0,2,19,4,0,1974,18188,20162
2017-02-03 20:00:00-05:00,0,2,20,4,0,1743,16007,17750
2017-02-03 21:00:00-05:00,0,2,21,4,0,1562,16264,17826
2017-02-03 22:00:00-05:00,0,2,22,4,0,1449,17302,18751
2017-02-03 23:00:00-05:00,0,2,23,4,0,1453,17306,18759
2017-02-04 00:00:00-05:00,0,2,0,5,0,1769,19166,20935
2017-02-04 01:00:00-05:00,0,2,1,5,0,2077,18476,20553
2017-02-04 02:00:00-05:00,0,2,2,5,0,2517,16814,19331
2017-02-04 03:00:00-05:00,0,2,3,5,0,2730,20323,23053
2017-02-04 04:00:00-05:00,0,2,4,5,0,3334,24171,27505
2017-02-04 05:00:00-05:00,0,2,5,5,0,3403,24739,28142
2017-02-04 06:00:00-05:00,0,2,6,5,0,3138,22379,25517
2017-02-04 07:00:00-05:00,0,2,7,5,0,2896,20915,23811
2017-02-04 08:00:00-05:00,0,2,8,5,0,2914,21847,24761
2017-02-04 09:00:00-05:00,0,2,9,5,0,2820,21237,24057
2017-02-04 10:00:00-05:00,0,2,10,5,0,2609,18855,21464
2017-02-04 11:00:00-05:00,0,2,11,5,0,2228,15668,17896
2017-02-04 12:00:00-05:00,0,2,12,5,0,1721,12670,14391
2017-02-04 13:00:00-05:00,0,2,13,5,0,1457,9168,10625
2017-02-04 14:00:00-05:00,0,2,14,5,0,1114,5705,6819
2017-02-04 15:00:00-05:00,0,2,15,5,0,575,2696,3271
2017-02-04 16:00:00-05:00,0,2,16,5,0,492,3797,4289
2017-02-04 17:00:00-05:00,0,2,17,5,0,648,5638,6286
2017-02-04 18:00:00-05:00,0,2,18,5,0,1030,9071,10101
2017-02-04 19:00:00-05:00,0,2,19,5,0,1460,13681,15141
2017-02-04 20:00:00-05:00,0,2,20,5,0,1559,16013,17572
2017-02-04 21:00:00-05:00,0,2,21,5,0,1724,17280,19004
2017-02-04 22:00:00-05:00,0,2,22,5,0,1758,19807,21565
2017-02-04 23:00:00-05:00,0,2,23,5,0,1974,19254,21228
2017-02-05 00:00:00-05:00,0,2,0,6,0,2046,18189,20235
2017-02-05 01:00:00-05:00,0,2,1,6,0,2279,18985,21264
2017-02-05 02:00:00-05:00,0,2,2,6,0,2509,18533,21042
2017-02-05 03:00:00-05:00,0,2,3,6,0,2559,19932,22491
2017-02-05 04:00:00-05:00,0,2,4,6,0,3033,22295,25328
2017-02-05 05:00:00-05:00,0,2,5,6,0,2901,22530,25431
2017-02-05 06:00:00-05:00,0,2,6,6,0,2832,17951,20783
2017-02-05 07:00:00-05:00,0,2,7,6,0,2819,17921,20740
2017-02-05 08:00:00-05:00,0,2,8,6,0,2697,19854,22551
2017-02-05 09:00:00-05:00,0,2,9,6,0,2852,20502,23354
2017-02-05 10:00:00-05:00,0,2,10,6,0,2621,18457,21078
2017-02-05 11:00:00-05:00,0,2,11,6,0,2352,16798,19150
2017-02-05 12:00:00-05:00,0,2,12,6,0,1973,13828,15801
2017-02-05 13:00:00-05:00,0,2,13,6,0,1657,10376,12033
2017-02-05 14:00:00-05:00,0,2,14,6,0,1252,6449,7701
2017-02-05 15:00:00-05:00,0,2,15,6,0,599,2737,3336
2017-02-05 16:00:00-05:00,0,2,16,6,0,438,2865,3303
2017-02-05 17:00:00-05:00,0,2,17,6,0,481,4065,4546
2017-02-05 18:00:00-05:00,0,2,18,6,0,610,7270,7880
2017-02-05 19:00:00-05:00,0,2,19,6,0,918,10069,10987
2017-02-05 20:00:00-05:00,0,2,20,6,0,1266,13558,14824
2017-02-05 21:00:00-05:00,0,2,21,6,0,1442,15074,16516
2017-02-05 22:00:00-05:00,0,2,22,6,0,1488,16454,17942
2017-02-05 23:00:00-05:00,0,2,23,6,0,1720,17273,18993
2017-02-06 00:00:00-05:00,0,2,0,0,0,1819,16346,18165
2017-02-06 01:00:00-05:00,0,2,1,0,0,1901,16231,18132
2017-02-06 02:00:00-05:00,0,2,2,0,0,2171,16694,18865
2017-02-06 03:00:00-05:00,0,2,3,0,0,2374,20321,22695
2017-02-06 04:00:00-05:00,0,2,4,0,0,2466,18974,21440
2017-02-06 05:00:00-05:00,0,2,5,0,0,1813,11478,13291
2017-02-06 06:00:00-05:00,0,2,6,0,0,1515,11181,12696
2017-02-06 07:00:00-05:00,0,2,7,0,0,1377,11389,12766
2017-02-06 08:00:00-05:00,0,2,8,0,0,1918,15806,17724
2017-02-06 09:00:00-05:00,0,2,9,0,0,1724,13146,14870
2017-02-06 10:00:00-05:00,0,2,10,0,0,1123,6118,7241
2017-02-06 11:00:00-05:00,0,2,11,0,0,729,3364,4093
2017-02-06 12:00:00-05:00,0,2,12,0,0,451,2108,2559
2017-02-06 13:00:00-05:00,0,2,13,0,0,319,1591,1910
2017-02-06 14:00:00-05:00,0,2,14,0,0,304,2040,2344
2017-02-06 15:00:00-05:00,0,2,15,0,0,272,3410,3682
2017-02-06 16:00:00-05:00,0,2,16,0,0,525,9000,9525
2017-02-06 17:00:00-05:00,0,2,17,0,0,1313,15622,16935
2017-02-06 18:00:00-05:00,0,2,18,0,0,1930,18866,20796
2017-02-06 19:00:00-05:00,0,2,19,0,0,1734,16703,18437
2017-02-06 20:00:00-05:00,0,2,20,0,0,1415,13868,15283
2017-02-06 21:00:00-05:00,0,2,21,0,0,1323,13274,14597
2017-02-06 22:00:00-05:00,0,2,22,0,0,1194,14321,15515
2017-02-06 23:00:00-05:00,0,2,23,0,0,1256,14188,15444
2017-02-07 00:00:00-05:00,0,2,0,1,0,1414,15409,16823
2017-02-07 01:00:00-05:00,0,2,1,1,0,1568,15564,17132
2017-02-07 02:00:00-05:00,0,2,2,1,0,1789,14732,16521
2017-02-07 03:00:00-05:00,0,2,3,1,0,1975,17375,19350
2017-02-07 04:00:00-05:00,0,2,4,1,0,2313,20266,22579
2017-02-07 05:00:00-05:00,0,2,5,1,0,2065,18283,20348
2017-02-07 06:00:00-05:00,0.04,2,6,1,0,1711,16627,18338
2017-02-07 07:00:00-05:00,0,2,7,1,0,1495,15890,17385
2017-02-07 08:00:00-05:00,0.03,2,8,1,0,1134,12813,13947
2017-02-07 09:00:00-05:00,0,2,9,1,0,956,8793,9749
2017-02-07 10:00:00-05:00,0,2,10,1,0,669,5104,5773
2017-02-07 11:00:00-05:00,0.1,2,11,1,0,471,2865,3336
2017-02-07 12:00:00-05:00,0.05,2,12,1,0,276,1969,2245
2017-02-07 13:00:00-05:00,0,2,13,1,0,184,1343,1527
2017-02-07 14:00:00-05:00,0.01,2,14,1,0,172,1628,1800
2017-02-07 15:00:00-05:00,0,2,15,1,0,221,3409,3630
2017-02-07 16:00:00-05:00,0,2,16,1,0,495,9718,10213
2017-02-07 17:00:00-05:00,0,2,17,1,0,1353,17016,18369
2017-02-07 18:00:00-05:00,0,2,18,1,0,2007,20852,22859
2017-02-07 19:00:00-05:00,0,2,19,1,0,1900,17932,19832
2017-02-07 20:00:00-05:00,0,2,20,1,0,1660,16599,18259
2017-02-07 21:00:00-05:00,0,2,21,1,0,1686,17987,19673
2017-02-07 22:00:00-05:00,0,2,22,1,0,1349,15966,17315
2017-02-07 23:00:00-05:00,0,2,23,1,0,1408,15650,17058
2017-02-08 00:00:00-05:00,0,2,0,2,0,1545,17232,18777
2017-02-08 01:00:00-05:00,0,2,1,2,0,1679,16799,18478
2017-02-08 02:00:00-05:00,0,2,2,2,0,1882,15318,17200
2017-02-08 03:00:00-05:00,0.01,2,3,2,0,2090,18438,20528
2017-02-08 04:00:00-05:00,0.01,2,4,2,0,2510,21677,24187
2017-02-08 05:00:00-05:00,0,2,5,2,0,2251,20517,22768
2017-02-08 06:00:00-05:00,0,2,6,2,0,1967,19717,21684
2017-02-08 07:00:00-05:00,0,2,7,2,0,1628,20121,21749
2017-02-08 08:00:00-05:00,0,2,8,2,0,1349,16950,18299
2017-02-08 09:00:00-05:00,0,2,9,2,0,1060,11393,12453
2017-02-08 10:00:00-05:00,0,2,10,2,0,773,6904,7677
2017-02-08 11:00:00-05:00,0,2,11,2,0,463,3791,4254
2017-02-08 12:00:00-05:00,0,2,12,2,0,267,2432,2699
2017-02-08 13:00:00-05:00,0,2,13,2,0,228,1736,1964
2017-02-08 14:00:00-05:00,0,2,14,2,0,198,1637,1835
2017-02-08 15:00:00-05:00,0,2,15,2,0,218,3296,3514
2017-02-08 16:00:00-05:00,0,2,16,2,0,479,8813,9292
2017-02-08 17:00:00-05:00,0,2,17,2,0,1228,16304,17532
2017-02-08 18:00:00-05:00,0,2,18,2,0,1883,19115,20998
2017-02-08 19:00:00-05:00,0,2,19,2,0,1768,17202,18970
2017-02-08 20:00:00-05:00,0,2,20,2,0,1481,15096,16577
2017-02-08 21:00:00-05:00,0,2,21,2,0,1501,15274,16775
2017-02-08 22:00:00-05:00,0,2,22,2,0,1388,15983,17371
2017-02-08 23:00:00-05:00,0,2,23,2,0,1435,15986,17421
2017-02-09 00:00:00-05:00,0,2,0,3,0,1637,17203,18840
2017-02-09 01:00:00-05:00,0,2,1,3,0,1786,17086,18872
2017-02-09 02:00:00-05:00,0,2,2,3,0,2055,15514,17569
2017-02-09 03:00:00-05:00,0,2,3,3,0,2356,18088,20444
2017-02-09 04:00:00-05:00,0.04,2,4,3,0,2713,22081,24794
2017-02-09 05:00:00-05:00,0.03,2,5,3,0,2615,22479,25094
2017-02-09 06:00:00-05:00,0.08,2,6,3,0,2391,21260,23651
2017-02-09 07:00:00-05:00,0.07,2,7,3,0,2112,21107,23219
2017-02-09 08:00:00-05:00,0.09,2,8,3,0,1912,19457,21369
2017-02-09 09:00:00-05:00,0.07,2,9,3,0,1633,14060,15693
2017-02-09 10:00:00-05:00,0.02,2,10,3,0,1147,9333,10480
2017-02-09 11:00:00-05:00,0.03,2,11,3,0,725,5820,6545
2017-02-09 12:00:00-05:00,0.01,2,12,3,0,477,3862,4339
2017-02-09 13:00:00-05:00,0,2,13,3,0,335,2529,2864
2017-02-09 14:00:00-05:00,0,2,14,3,0,264,2148,2412
2017-02-09 15:00:00-05:00,0,2,15,3,0,212,2793,3005
2017-02-09 16:00:00-05:00,0,2,16,3,0,285,6052,6337
2017-02-09 17:00:00-05:00,0,2,17,3,0,436,8076,8512
2017-02-09 18:00:00-05:00,0,2,18,3,0,459,7651,8110
2017-02-09 19:00:00-05:00,0,2,19,3,0,412,6974,7386
2017-02-09 20:00:00-05:00,0,2,20,3,0,358,6595,6953
2017-02-09 21:00:00-05:00,0,2,21,3,0,357,6472,6829
2017-02-09 22:00:00-05:00,0,2,22,3,0,384,6803,7187
2017-02-09 23:00:00-05:00,0,2,23,3,0,455,7331,7786
2017-02-10 00:00:00-05:00,0,2,0,4,0,511,8262,8773
2017-02-10 01:00:00-05:00,0,2,1,4,0,588,8831,9419
2017-02-10 02:00:00-05:00,0,2,2,4,0,785,9524,10309
2017-02-10 03:00:00-05:00,0,2,3,4,0,985,12077,13062
2017-02-10 04:00:00-05:00,0,2,4,4,0,1266,14883,16149
2017-02-10 05:00:00-05:00,0,2,5,4,0,1236,14434,15670
2017-02-10 06:00:00-05:00,0,2,6,4,0,1177,13236,14413
2017-02-10 07:00:00-05:00,0,2,7,4,0,1112,14005,15117
2017-02-10 08:00:00-05:00,0,2,8,4,0,1012,13628,14640
2017-02-10 09:00:00-05:00,0,2,9,4,0,976,11868,12844
2017-02-10 10:00:00-05:00,0,2,10,4,0,720,8358,9078
2017-02-10 11:00:00-05:00,0,2,11,4,0,409,5189,5598
2017-02-10 12:00:00-05:00,0,2,12,4,0,283,3279,3562
2017-02-10 13:00:00-05:00,0,2,13,4,0,216,2206,2422
2017-02-10 14:00:00-05:00,0,2,14,4,0,222,2446,2668
2017-02-10 15:00:00-05:00,0,2,15,4,0,243,4012,4255
2017-02-10 16:00:00-05:00,0,2,16,4,0,538,9345,9883
2017-02-10 17:00:00-05:00,0,2,17,4,0,1219,15650,16869
2017-02-10 18:00:00-05:00,0,2,18,4,0,1874,17938,19812
2017-02-10 19:00:00-05:00,0,2,19,4,0,2075,16997,19072
2017-02-10 20:00:00-05:00,0,2,20,4,0,1742,15396,17138
2017-02-10 21:00:00-05:00,0,2,21,4,0,1614,15797,17411
2017-02-10 22:00:00-05:00,0,2,22,4,0,1487,16059,17546
2017-02-10 23:00:00-05:00,0,2,23,4,0,1601,16396,17997
2017-02-11 00:00:00-05:00,0,2,0,5,0,1994,18576,20570
2017-02-11 01:00:00-05:00,0,2,1,5,0,2163,17460,19623
2017-02-11 02:00:00-05:00,0,2,2,5,0,2588,15987,18575
2017-02-11 03:00:00-05:00,0,2,3,5,0,3040,19197,22237
2017-02-11 04:00:00-05:00,0,2,4,5,0,3376,22724,26100
2017-02-11 05:00:00-05:00,0,2,5,5,0,3285,23673,26958
2017-02-11 06:00:00-05:00,0,2,6,5,0,3035,21164,24199
2017-02-11 07:00:00-05:00,0,2,7,5,0,2940,21299,24239
2017-02-11 08:00:00-05:00,0,2,8,5,0,2810,21796,24606
2017-02-11 09:00:00-05:00,0,2,9,5,0,2662,21453,24115
2017-02-11 10:00:00-05:00,0,2,10,5,0,2438,18914,21352
2017-02-11 11:00:00-05:00,0,2,11,5,0,2057,15522,17579
2017-02-11 12:00:00-05:00,0,2,12,5,0,1760,12872,14632
2017-02-11 13:00:00-05:00,0,2,13,5,0,1467,9752,11219
2017-02-11 14:00:00-05:00,0,2,14,5,0,1110,6472,7582
2017-02-11 15:00:00-05:00,0,2,15,5,0,579,3186,3765
2017-02-11 16:00:00-05:00,0,2,16,5,0,431,4305,4736
2017-02-11 17:00:00-05:00,0,2,17,5,0,670,5970,6640
2017-02-11 18:00:00-05:00,0,2,18,5,0,949,9320,10269
2017-02-11 19:00:00-05:00,0,2,19,5,0,1341,14041,15382
2017-02-11 20:00:00-05:00,0,2,20,5,0,1521,16210,17731
2017-02-11 21:00:00-05:00,0,2,21,5,0,1716,18216,19932
2017-02-11 22:00:00-05:00,0,2,22,5,0,1832,19491,21323
2017-02-11 23:00:00-05:00,0,2,23,5,0,1938,19469,21407
2017-02-12 00:00:00-05:00,0,2,0,6,0,2101,18583,20684
2017-02-12 01:00:00-05:00,0,2,1,6,0,2210,18742,20952
2017-02-12 02:00:00-05:00,0,2,2,6,0,2429,17317,19746
2017-02-12 03:00:00-05:00,0,2,3,6,0,2558,19085,21643
2017-02-12 04:00:00-05:00,0,2,4,6,0,2877,22396,25273
2017-02-12 05:00:00-05:00,0,2,5,6,0,2897,22567,25464
2017-02-12 06:00:00-05:00,0.02,2,6,6,0,2679,18275,20954
2017-02-12 07:00:00-05:00,0.01,2,7,6,0,2689,18387,21076
2017-02-12 08:00:00-05:00,0,2,8,6,0,2807,20736,23543
2017-02-12 09:00:00-05:00,0.01,2,9,6,0,2910,21042,23952
2017-02-12 10:00:00-05:00,0.07,2,10,6,0,2860,19977,22837
2017-02-12 11:00:00-05:00,0.09,2,11,6,0,2522,18792,21314
2017-02-12 12:00:00-05:00,0.11,2,12,6,0,2095,15812,17907
2017-02-12 13:00:00-05:00,0.04,2,13,6,0,1836,12236,14072
2017-02-12 14:00:00-05:00,0.01,2,14,6,0,1398,7762,9160
2017-02-12 15:00:00-05:00,0.02,2,15,6,0,683,3215,3898
2017-02-12 16:00:00-05:00,0.01,2,16,6,0,438,3192,3630
2017-02-12 17:00:00-05:00,0.02,2,17,6,0,455,4409,4864
2017-02-12 18:00:00-05:00,0.01,2,18,6,0,582,6470,7052
2017-02-12 19:00:00-05:00,0,2,19,6,0,1022,11370,12392
2017-02-12 20:00:00-05:00,0,2,20,6,0,1338,16920,18258
2017-02-12 21:00:00-05:00,0,2,21,6,0,1660,20618,22278
2017-02-12 22:00:00-05:00,0,2,22,6,0,1708,21644,23352
2017-02-12 23:00:00-05:00,0,2,23,6,0,1923,20018,21941
2017-02-13 00:00:00-05:00,0,2,0,0,0,1847,18506,20353
2017-02-13 01:00:00-05:00,0,2,1,0,0,2034,18238,20272
2017-02-13 02:00:00-05:00,0.01,2,2,0,0,2047,17147,19194
2017-02-13 03:00:00-05:00,0,2,3,0,0,1937,17147,19084
2017-02-13 04:00:00-05:00,0,2,4,0,0,2049,17790,19839
2017-02-13 05:00:00-05:00,0,2,5,0,0,1839,14312,16151
2017-02-13 06:00:00-05:00,0,2,6,0,0,1672,12209,13881
2017-02-13 07:00:00-05:00,0,2,7,0,0,1339,11547,12886
2017-02-13 08:00:00-05:00,0,2,8,0,0,1152,9042,10194
2017-02-13 09:00:00-05:00,0,2,9,0,0,1035,7783,8818
2017-02-13 10:00:00-05:00,0,2,10,0,0,731,5011,5742
2017-02-13 11:00:00-05:00,0,2,11,0,0,489,2896,3385
2017-02-13 12:00:00-05:00,0,2,12,0,0,330,1998,2328
2017-02-13 13:00:00-05:00,0,2,13,0,0,247,1453,1700
2017-02-13 14:00:00-05:00,0,2,14,0,0,286,1874,2160
2017-02-13 15:00:00-05:00,0,2,15,0,0,254,3539,3793
2017-02-13 16:00:00-05:00,0,2,16,0,0,532,9298,9830
2017-02-13 17:00:00-05:00,0,2,17,0,0,1304,16240,17544
2017-02-13 18:00:00-05:00,0,2,18,0,0,1908,18457,20365
2017-02-13 19:00:00-05:00,0,2,19,0,0,1835,16685,18520
2017-02-13 20:00:00-05:00,0,2,20,0,0,1600,14852,16452
2017-02-13 21:00:00-05:00,0,2,21,0,0,1344,14832,16176
2017-02-13 22:00:00-05:00,0,2,22,0,0,1290,15427,16717
2017-02-13 23:00:00-05:00,0,2,23,0,0,1387,16264,17651
2017-02-14 00:00:00-05:00,0,2,0,1,0,1579,17406,18985
2017-02-14 01:00:00-05:00,0,2,1,1,0,1767,17715,19482
2017-02-14 02:00:00-05:00,0,2,2,1,0,2023,16663,18686
2017-02-14 03:00:00-05:00,0,2,3,1,0,2344,19908,22252
2017-02-14 04:00:00-05:00,0,2,4,1,0,2785,22568,25353
2017-02-14 05:00:00-05:00,0,2,5,1,0,2480,21371,23851
2017-02-14 06:00:00-05:00,0,2,6,1,0,2092,19715,21807
2017-02-14 07:00:00-05:00,0,2,7,1,0,1817,18371,20188
2017-02-14 08:00:00-05:00,0,2,8,1,0,1458,16149,17607
2017-02-14 09:00:00-05:00,0,2,9,1,0,1163,11429,12592
2017-02-14 10:00:00-05:00,0,2,10,1,0,859,6785,7644
2017-02-14 11:00:00-05:00,0,2,11,1,0,548,3893,4441
2017-02-14 12:00:00-05:00,0,2,12,1,0,300,2270,2570
2017-02-14 13:00:00-05:00,0,2,13,1,0,206,1606,1812
2017-02-14 14:00:00-05:00,0,2,14,1,0,227,1755,1982
2017-02-14 15:00:00-05:00,0,2,15,1,0,226,3379,3605
2017-02-14 16:00:00-05:00,0,2,16,1,0,501,9500,10001
2017-02-14 17:00:00-05:00,0,2,17,1,0,1320,16880,18200
2017-02-14 18:00:00-05:00,0,2,18,1,0,1905,19717,21622
2017-02-14 19:00:00-05:00,0,2,19,1,0,1759,18136,19895
2017-02-14 20:00:00-05:00,0,2,20,1,0,1544,15974,17518
2017-02-14 21:00:00-05:00,0,2,21,1,0,1525,15914,17439
2017-02-14 22:00:00-05:00,0,2,22,1,0,1467,16853,18320
2017-02-14 23:00:00-05:00,0,2,23,1,0,1523,16587,18110
2017-02-15 00:00:00-05:00,0,2,0,2,0,1624,18076,19700
2017-02-15 01:00:00-05:00,0,2,1,2,0,1864,18156,20020
2017-02-15 02:00:00-05:00,0,2,2,2,0,2212,16509,18721
2017-02-15 03:00:00-05:00,0,2,3,2,0,2493,19643,22136
2017-02-15 04:00:00-05:00,0,2,4,2,0,3007,23257,26264
2017-02-15 05:00:00-05:00,0,2,5,2,0,2982,23321,26303
2017-02-15 06:00:00-05:00,0,2,6,2,0,2686,21010,23696
2017-02-15 07:00:00-05:00,0,2,7,2,0,2314,20138,22452
2017-02-15 08:00:00-05:00,0,2,8,2,0,2012,19088,21100
2017-02-15 09:00:00-05:00,0,2,9,2,0,1694,15496,17190
2017-02-15 10:00:00-05:00,0,2,10,2,0,1243,9709,10952
2017-02-15 11:00:00-05:00,0,2,11,2,0,832,5440,6272
2017-02-15 12:00:00-05:00,0,2,12,2,0,509,3387,3896
2017-02-15 13:00:00-05:00,0,2,13,2,0,348,2409,2757
2017-02-15 14:00:00-05:00,0,2,14,2,0,320,2352,2672
2017-02-15 15:00:00-05:00,0,2,15,2,0,264,3869,4133
2017-02-15 16:00:00-05:00,0,2,16,2,0,526,9954,10480
2017-02-15 17:00:00-05:00,0,2,17,2,0,1284,17302,18586
2017-02-15 18:00:00-05:00,0,2,18,2,0,1932,20002,21934
2017-02-15 19:00:00-05:00,0,2,19,2,0,1747,17886,19633
2017-02-15 20:00:00-05:00,0,2,20,2,0,1527,15426,16953
2017-02-15 21:00:00-05:00,0,2,21,2,0,1395,15244,16639
2017-02-15 22:00:00-05:00,0,2,22,2,0,1355,15832,17187
2017-02-15 23:00:00-05:00,0,2,23,2,0,1353,15705,17058
2017-02-16 00:00:00-05:00,0,2,0,3,0,1562,17031,18593
2017-02-16 01:00:00-05:00,0,2,1,3,0,1670,17028,18698
2017-02-16 02:00:00-05:00,0,2,2,3,0,2054,16080,18134
2017-02-16 03:00:00-05:00,0,2,3,3,0,2443,19368,21811
2017-02-16 04:00:00-05:00,0,2,4,3,0,2930,22887,25817
2017-02-16 05:00:00-05:00,0,2,5,3,0,2539,22677,25216
2017-02-16 06:00:00-05:00,0,2,6,3,0,2260,21872,24132
2017-02-16 07:00:00-05:00,0,2,7,3,0,1936,21426,23362
2017-02-16 08:00:00-05:00,0,2,8,3,0,1710,19538,21248
2017-02-16 09:00:00-05:00,0,2,9,3,0,1320,14790,16110
2017-02-16 10:00:00-05:00,0,2,10,3,0,1059,9049,10108
2017-02-16 11:00:00-05:00,0,2,11,3,0,662,5187,5849
2017-02-16 12:00:00-05:00,0,2,12,3,0,359,3128,3487
2017-02-16 13:00:00-05:00,0,2,13,3,0,259,2071,2330
2017-02-16 14:00:00-05:00,0,2,14,3,0,238,2138,2376
2017-02-16 15:00:00-05:00,0,2,15,3,0,244,3454,3698
2017-02-16 16:00:00-05:00,0,2,16,3,0,524,9684,10208
2017-02-16 17:00:00-05:00,0,2,17,3,0,1338,17229,18567
2017-02-16 18:00:00-05:00,0,2,18,3,0,1959,20138,22097
2017-02-16 19:00:00-05:00,0,2,19,3,0,1806,18323,20129
2017-02-16 20:00:00-05:00,0,2,20,3,0,1574,16334,17908
2017-02-16 21:00:00-05:00,0,2,21,3,0,1534,16653,18187
2017-02-16 22:00:00-05:00,0,2,22,3,0,1439,17353,18792
2017-02-16 23:00:00-05:00,0,2,23,3,0,1544,17551,19095
2017-02-17 00:00:00-05:00,0,2,0,4,0,1812,19259,21071
2017-02-17 01:00:00-05:00,0,2,1,4,0,1864,19064,20928
2017-02-17 02:00:00-05:00,0,2,2,4,0,2266,16937,19203
2017-02-17 03:00:00-05:00,0,2,3,4,0,2608,20064,22672
2017-02-17 04:00:00-05:00,0,2,4,4,0,3032,24194,27226
2017-02-17 05:00:00-05:00,0,2,5,4,0,3009,24296,27305
2017-02-17 06:00:00-05:00,0,2,6,4,0,2595,23207,25802
2017-02-17 07:00:00-05:00,0,2,7,4,0,2492,23543,26035
2017-02-17 08:00:00-05:00,0,2,8,4,0,2100,22419,24519
2017-02-17 09:00:00-05:00,0,2,9,4,0,1857,17014,18871
2017-02-17 10:00:00-05:00,0,2,10,4,0,1276,12022,13298
2017-02-17 11:00:00-05:00,0,2,11,4,0,873,7436,8309
2017-02-17 12:00:00-05:00,0,2,12,4,0,594,4629,5223
2017-02-17 13:00:00-05:00,0,2,13,4,0,476,3139,3615
2017-02-17 14:00:00-05:00,0,2,14,4,0,348,2927,3275
2017-02-17 15:00:00-05:00,0,2,15,4,0,282,3937,4219
2017-02-17 16:00:00-05:00,0,2,16,4,0,556,9386,9942
2017-02-17 17:00:00-05:00,0,2,17,4,0,1304,15980,17284
2017-02-17 18:00:00-05:00,0,2,18,4,0,1977,19362,21339
2017-02-17 19:00:00-05:00,0,2,19,4,0,1862,17768,19630
2017-02-17 20:00:00-05:00,0,2,20,4,0,1647,16024,17671
2017-02-17 21:00:00-05:00,0,2,21,4,0,1466,16364,17830
2017-02-17 22:00:00-05:00,0,2,22,4,0,1373,17035,18408
2017-02-17 23:00:00-05:00,0,2,23,4,0,1409,17482,18891
2017-02-18 00:00:00-05:00,0,2,0,5,0,1812,18652,20464
2017-02-18 01:00:00-05:00,0,2,1,5,0,2056,17596,19652
2017-02-18 02:00:00-05:00,0,2,2,5,0,2405,15652,18057
2017-02-18 03:00:00-05:00,0,2,3,5,0,2656,18383,21039
2017-02-18 04:00:00-05:00,0,2,4,5,0,3043,21729,24772
2017-02-18 05:00:00-05:00,0,2,5,5,0,3080,22861,25941
2017-02-18 06:00:00-05:00,0,2,6,5,0,2754,19028,21782
2017-02-18 07:00:00-05:00,0,2,7,5,0,2523,18590,21113
2017-02-18 08:00:00-05:00,0,2,8,5,0,2450,19823,22273
2017-02-18 09:00:00-05:00,0,2,9,5,0,2529,19501,22030
2017-02-18 10:00:00-05:00,0,2,10,5,0,2337,17033,19370
2017-02-18 11:00:00-05:00,0,2,11,5,0,2013,13926,15939
2017-02-18 12:00:00-05:00,0,2,12,5,0,1646,11963,13609
2017-02-18 13:00:00-05:00,0,2,13,5,0,1386,8944,10330
2017-02-18 14:00:00-05:00,0,2,14,5,0,1098,5910,7008
2017-02-18 15:00:00-05:00,0,2,15,5,0,571,2897,3468
2017-02-18 16:00:00-05:00,0,2,16,5,0,478,3947,4425
2017-02-18 17:00:00-05:00,0,2,17,5,0,583,5519,6102
2017-02-18 18:00:00-05:00,0,2,18,5,0,856,8171,9027
2017-02-18 19:00:00-05:00,0,2,19,5,0,1216,11214,12430
2017-02-18 20:00:00-05:00,0,2,20,5,0,1434,13046,14480
2017-02-18 21:00:00-05:00,0,2,21,5,0,1575,14491,16066
2017-02-18 22:00:00-05:00,0,2,22,5,0,1585,15494,17079
2017-02-18 23:00:00-05:00,0,2,23,5,0,1733,16165,17898
2017-02-19 00:00:00-05:00,0,2,0,6,0,1959,15649,17608
2017-02-19 01:00:00-05:00,0,2,1,6,0,2011,16671,18682
2017-02-19 02:00:00-05:00,0,2,2,6,0,2215,16218,18433
2017-02-19 03:00:00-05:00,0,2,3,6,0,2434,17837,20271
2017-02-19 04:00:00-05:00,0,2,4,6,0,2776,20193,22969
2017-02-19 05:00:00-05:00,0,2,5,6,0,2804,20408,23212
2017-02-19 06:00:00-05:00,0,2,6,6,0,2640,16823,19463
2017-02-19 07:00:00-05:00,0,2,7,6,0,2617,16159,18776
2017-02-19 08:00:00-05:00,0,2,8,6,0,2657,18289,20946
2017-02-19 09:00:00-05:00,0,2,9,6,0,2798,19403,22201
2017-02-19 10:00:00-05:00,0,2,10,6,0,2649,18008,20657
2017-02-19 11:00:00-05:00,0,2,11,6,0,2399,17282,19681
2017-02-19 12:00:00-05:00,0,2,12,6,0,2075,14614,16689
2017-02-19 13:00:00-05:00,0,2,13,6,0,1790,11200,12990
2017-02-19 14:00:00-05:00,0,2,14,6,0,1299,7148,8447
2017-02-19 15:00:00-05:00,0,2,15,6,0,602,2921,3523
2017-02-19 16:00:00-05:00,0,2,16,6,0,444,3029,3473
2017-02-19 17:00:00-05:00,0,2,17,6,0,479,4068,4547
2017-02-19 18:00:00-05:00,0,2,18,6,0,576,6605,7181
2017-02-19 19:00:00-05:00,0,2,19,6,0,876,8861,9737
2017-02-19 20:00:00-05:00,0,2,20,6,0,1151,12264,13415
2017-02-19 21:00:00-05:00,0,2,21,6,0,1418,13868,15286
2017-02-19 22:00:00-05:00,0,2,22,6,0,1384,15195,16579
2017-02-19 23:00:00-05:00,0,2,23,6,0,1599,15522,17121
2017-02-20 00:00:00-05:00,0,2,0,0,1,1728,15655,17383
2017-02-20 01:00:00-05:00,0,2,1,0,1,1793,16154,17947
2017-02-20 02:00:00-05:00,0,2,2,0,1,1909,15577,17486
2017-02-20 03:00:00-05:00,0,2,3,0,1,2040,16023,18063
2017-02-20 04:00:00-05:00,0,2,4,0,1,2197,17136,19333
2017-02-20 05:00:00-05:00,0,2,5,0,1,2126,15516,17642
2017-02-20 06:00:00-05:00,0,2,6,0,1,1955,13642,15597
2017-02-20 07:00:00-05:00,0,2,7,0,1,1852,13993,15845
2017-02-20 08:00:00-05:00,0,2,8,0,1,1769,13391,15160
2017-02-20 09:00:00-05:00,0,2,9,0,1,1654,11611,13265
2017-02-20 10:00:00-05:00,0,2,10,0,1,1321,8906,10227
2017-02-20 11:00:00-05:00,0,2,11,0,1,1036,6427,7463
2017-02-20 12:00:00-05:00,0,2,12,0,1,785,4673,5458
2017-02-20 13:00:00-05:00,0,2,13,0,1,617,3453,4070
2017-02-20 14:00:00-05:00,0,2,14,0,1,566,2901,3467
2017-02-20 15:00:00-05:00,0,2,15,0,1,381,2430,2811
2017-02-20 16:00:00-05:00,0,2,16,0,1,443,4079,4522
2017-02-20 17:00:00-05:00,0,2,17,0,1,603,6236,6839
2017-02-20 18:00:00-05:00,0,2,18,0,1,1059,9485,10544
2017-02-20 19:00:00-05:00,0,2,19,0,1,1180,10974,12154
2017-02-20 20:00:00-05:00,0,2,20,0,1,1129,11854,12983
2017-02-20 21:00:00-05:00,0,2,21,0,1,1159,12963,14122
2017-02-20 22:00:00-05:00,0,2,22,0,1,1207,13951,15158
2017-02-20 23:00:00-05:00,0,2,23,0,1,1241,14517,15758
2017-02-21 00:00:00-05:00,0,2,0,1,0,1380,15604,16984
2017-02-21 01:00:00-05:00,0,2,1,1,0,1611,16246,17857
2017-02-21 02:00:00-05:00,0,2,2,1,0,1832,15875,17707
2017-02-21 03:00:00-05:00,0,2,3,1,0,2031,16561,18592
2017-02-21 04:00:00-05:00,0,2,4,1,0,2390,18659,21049
2017-02-21 05:00:00-05:00,0,2,5,1,0,2212,16688,18900
2017-02-21 06:00:00-05:00,0,2,6,1,0,1930,14599,16529
2017-02-21 07:00:00-05:00,0,2,7,1,0,1615,13653,15268
2017-02-21 08:00:00-05:00,0,2,8,1,0,1319,12581,13900
2017-02-21 09:00:00-05:00,0,2,9,1,0,1110,8773,9883
2017-02-21 10:00:00-05:00,0,2,10,1,0,697,5381,6078
2017-02-21 11:00:00-05:00,0,2,11,1,0,472,3073,3545
2017-02-21 12:00:00-05:00,0,2,12,1,0,306,1881,2187
2017-02-21 13:00:00-05:00,0,2,13,1,0,205,1252,1457
2017-02-21 14:00:00-05:00,0,2,14,1,0,203,1574,1777
2017-02-21 15:00:00-05:00,0,2,15,1,0,214,3379,3593
2017-02-21 16:00:00-05:00,0,2,16,1,0,480,8768,9248
2017-02-21 17:00:00-05:00,0,2,17,1,0,959,13101,14060
2017-02-21 18:00:00-05:00,0,2,18,1,0,1525,16722,18247
2017-02-21 19:00:00-05:00,0,2,19,1,0,1517,15925,17442
2017-02-21 20:00:00-05:00,0,2,20,1,0,1388,14257,15645
2017-02-21 21:00:00-05:00,0,2,21,1,0,1185,14112,15297
2017-02-21 22:00:00-05:00,0,2,22,1,0,1317,15320,16637
2017-02-21 23:00:00-05:00,0,2,23,1,0,1329,15380,16709
2017-02-22 00:00:00-05:00,0,2,0,2,0,1449,16061,17510
2017-02-22 01:00:00-05:00,0,2,1,2,0,1577,15767,17344
2017-02-22 02:00:00-05:00,0,2,2,2,0,1836,14822,16658
2017-02-22 03:00:00-05:00,0,2,3,2,0,2173,17052,19225
2017-02-22 04:00:00-05:00,0,2,4,2,0,2426,20350,22776
2017-02-22 05:00:00-05:00,0,2,5,2,0,2240,18963,21203
2017-02-22 06:00:00-05:00,0,2,6,2,0,1911,18099,20010
2017-02-22 07:00:00-05:00,0,2,7,2,0,1669,18220,19889
2017-02-22 08:00:00-05:00,0,2,8,2,0,1387,15562,16949
2017-02-22 09:00:00-05:00,0,2,9,2,0,1138,10461,11599
2017-02-22 10:00:00-05:00,0,2,10,2,0,832,6589,7421
2017-02-22 11:00:00-05:00,0,2,11,2,0,482,3748,4230
2017-02-22 12:00:00-05:00,0,2,12,2,0,279,2395,2674
2017-02-22 13:00:00-05:00,0,2,13,2,0,233,1613,1846
2017-02-22 14:00:00-05:00,0,2,14,2,0,191,1790,1981
2017-02-22 15:00:00-05:00,0,2,15,2,0,237,3305,3542
2017-02-22 16:00:00-05:00,0,2,16,2,0,448,8554,9002
2017-02-22 17:00:00-05:00,0,2,17,2,0,994,14768,15762
2017-02-22 18:00:00-05:00,0,2,18,2,0,1621,17595,19216
2017-02-22 19:00:00-05:00,0,2,19,2,0,1645,16372,18017
2017-02-22 20:00:00-05:00,0,2,20,2,0,1495,14635,16130
2017-02-22 21:00:00-05:00,0,2,21,2,0,1490,14657,16147
2017-02-22 22:00:00-05:00,0,2,22,2,0,1349,15581,16930
2017-02-22 23:00:00-05:00,0,2,23,2,0,1380,15248,16628
2017-02-23 00:00:00-05:00,0,2,0,3,0,1516,16260,17776
2017-02-23 01:00:00-05:00,0,2,1,3,0,1621,16205,17826
2017-02-23 02:00:00-05:00,0,2,2,3,0,1961,14823,16784
2017-02-23 03:00:00-05:00,0,2,3,3,0,2290,17463,19753
2017-02-23 04:00:00-05:00,0,2,4,3,0,2491,21207,23698
2017-02-23 05:00:00-05:00,0,2,5,3,0,2331,20948,23279
2017-02-23 06:00:00-05:00,0,2,6,3,0,2097,19385,21482
2017-02-23 07:00:00-05:00,0,2,7,3,0,1771,20010,21781
2017-02-23 08:00:00-05:00,0,2,8,3,0,1591,17942,19533
2017-02-23 09:00:00-05:00,0,2,9,3,0,1291,13790,15081
2017-02-23 10:00:00-05:00,0,2,10,3,0,977,8530,9507
2017-02-23 11:00:00-05:00,0,2,11,3,0,660,4807,5467
2017-02-23 12:00:00-05:00,0,2,12,3,0,424,3135,3559
2017-02-23 13:00:00-05:00,0,2,13,3,0,298,2097,2395
2017-02-23 14:00:00-05:00,0,2,14,3,0,252,1976,2228
2017-02-23 15:00:00-05:00,0,2,15,3,0,233,3355,3588
2017-02-23 16:00:00-05:00,0,2,16,3,0,463,8827,9290
2017-02-23 17:00:00-05:00,0,2,17,3,0,1066,14929,15995
2017-02-23 18:00:00-05:00,0,2,18,3,0,1643,17667,19310
2017-02-23 19:00:00-05:00,0,2,19,3,0,1741,16821,18562
2017-02-23 20:00:00-05:00,0,2,20,3,0,1490,14789,16279
2017-02-23 21:00:00-05:00,0,2,21,3,0,1563,15335,16898
2017-02-23 22:00:00-05:00,0,2,22,3,0,1491,16010,17501
2017-02-23 23:00:00-05:00,0,2,23,3,0,1554,15680,17234
2017-02-24 00:00:00-05:00,0,2,0,4,0,1751,17020,18771
2017-02-24 01:00:00-05:00,0,2,1,4,0,1826,16821,18647
2017-02-24 02:00:00-05:00,0,2,2,4,0,2235,15545,17780
2017-02-24 03:00:00-05:00,0,2,3,4,0,2487,18164,20651
2017-02-24 04:00:00-05:00,0,2,4,4,0,2750,21957,24707
2017-02-24 05:00:00-05:00,0,2,5,4,0,2590,22021,24611
2017-02-24 06:00:00-05:00,0,2,6,4,0,2387,21019,23406
2017-02-24 07:00:00-05:00,0,2,7,4,0,2209,21296,23505
2017-02-24 08:00:00-05:00,0,2,8,4,0,1822,20400,22222
2017-02-24 09:00:00-05:00,0,2,9,4,0,1625,16856,18481
2017-02-24 10:00:00-05:00,0,2,10,4,0,1338,12086,13424
2017-02-24 11:00:00-05:00,0,2,11,4,0,967,7576,8543
2017-02-24 12:00:00-05:00,0,2,12,4,0,656,5089,5745
2017-02-24 13:00:00-05:00,0,2,13,4,0,404,3236,3640
2017-02-24 14:00:00-05:00,0,2,14,4,0,326,2784,3110
2017-02-24 15:00:00-05:00,0,2,15,4,0,265,3682,3947
2017-02-24 16:00:00-05:00,0,2,16,4,0,492,8352,8844
2017-02-24 17:00:00-05:00,0,2,17,4,0,1027,14266,15293
2017-02-24 18:00:00-05:00,0,2,18,4,0,1681,16470,18151
2017-02-24 19:00:00-05:00,0,2,19,4,0,1831,16236,18067
2017-02-24 20:00:00-05:00,0,2,20,4,0,1595,14595,16190
2017-02-24 21:00:00-05:00,0,2,21,4,0,1512,14787,16299
2017-02-24 22:00:00-05:00,0,2,22,4,0,1412,16044,17456
2017-02-24 23:00:00-05:00,0,2,23,4,0,1445,16243,17688
2017-02-25 00:00:00-05:00,0,2,0,5,0,1709,17751,19460
2017-02-25 01:00:00-05:00,0,2,1,5,0,1981,17578,19559
2017-02-25 02:00:00-05:00,0,2,2,5,0,2508,16024,18532
2017-02-25 03:00:00-05:00,0,2,3,5,0,2776,18986,21762
2017-02-25 04:00:00-05:00,0,2,4,5,0,3109,23005,26114
2017-02-25 05:00:00-05:00,0,2,5,5,0,3068,23092,26160
2017-02-25 06:00:00-05:00,0,2,6,5,0,2854,20560,23414
2017-02-25 07:00:00-05:00,0,2,7,5,0,2799,20165,22964
2017-02-25 08:00:00-05:00,0,2,8,5,0,2731,21235,23966
2017-02-25 09:00:00-05:00,0,2,9,5,0,2607,20824,23431
2017-02-25 10:00:00-05:00,0,2,10,5,0,2617,19151,21768
2017-02-25 11:00:00-05:00,0,2,11,5,0,2296,16377,18673
2017-02-25 12:00:00-05:00,0,2,12,5,0,1910,13375,15285
2017-02-25 13:00:00-05:00,0,2,13,5,0,1620,9939,11559
2017-02-25 14:00:00-05:00,0,2,14,5,0,1282,6410,7692
2017-02-25 15:00:00-05:00,0,2,15,5,0,592,3067,3659
2017-02-25 16:00:00-05:00,0,2,16,5,0,495,4131,4626
2017-02-25 17:00:00-05:00,0,2,17,5,0,664,5623,6287
2017-02-25 18:00:00-05:00,0.19,2,18,5,0,897,8551,9448
2017-02-25 19:00:00-05:00,0.11,2,19,5,0,1315,12249,13564
2017-02-25 20:00:00-05:00,0.01,2,20,5,0,1507,14435,15942
2017-02-25 21:00:00-05:00,0.01,2,21,5,0,1703,15952,17655
2017-02-25 22:00:00-05:00,0,2,22,5,0,1688,17501,19189
2017-02-25 23:00:00-05:00,0,2,23,5,0,1888,18195,20083
2017-02-26 00:00:00-05:00,0,2,0,6,0,2027,17378,19405
2017-02-26 01:00:00-05:00,0,2,1,6,0,2161,17600,19761
2017-02-26 02:00:00-05:00,0,2,2,6,0,2632,17942,20574
2017-02-26 03:00:00-05:00,0,2,3,6,0,2666,19271,21937
2017-02-26 04:00:00-05:00,0,2,4,6,0,3655,26855,30510
2017-02-26 05:00:00-05:00,0,2,5,6,0,3569,25237,28806
2017-02-26 06:00:00-05:00,0,2,6,6,0,2986,18916,21902
2017-02-26 07:00:00-05:00,0,2,7,6,0,2722,17970,20692
2017-02-26 08:00:00-05:00,0,2,8,6,0,2708,20931,23639
2017-02-26 09:00:00-05:00,0,2,9,6,0,2987,21335,24322
2017-02-26 10:00:00-05:00,0,2,10,6,0,2824,20465,23289
2017-02-26 11:00:00-05:00,0,2,11,6,0,2492,17930,20422
2017-02-26 12:00:00-05:00,0,2,12,6,0,2088,14865,16953
2017-02-26 13:00:00-05:00,0,2,13,6,0,1756,11048,12804
2017-02-26 14:00:00-05:00,0,2,14,6,0,1318,6851,8169
2017-02-26 15:00:00-05:00,0,2,15,6,0,566,3006,3572
2017-02-26 16:00:00-05:00,0,2,16,6,0,395,3264,3659
2017-02-26 17:00:00-05:00,0,2,17,6,0,485,4657,5142
2017-02-26 18:00:00-05:00,0,2,18,6,0,630,7318,7948
2017-02-26 19:00:00-05:00,0,2,19,6,0,989,10883,11872
2017-02-26 20:00:00-05:00,0,2,20,6,0,1290,14837,16127
2017-02-26 21:00:00-05:00,0,2,21,6,0,1577,16697,18274
2017-02-26 22:00:00-05:00,0,2,22,6,0,1637,17827,19464
2017-02-26 23:00:00-05:00,0,2,23,6,0,1819,18215,20034
2017-02-27 00:00:00-05:00,0,2,0,0,0,1976,18643,20619
2017-02-27 01:00:00-05:00,0,2,1,0,0,1966,17824,19790
2017-02-27 02:00:00-05:00,0,2,2,0,0,2134,17618,19752
2017-02-27 03:00:00-05:00,0,2,3,0,0,2365,17669,20034
2017-02-27 04:00:00-05:00,0,2,4,0,0,2548,18932,21480
2017-02-27 05:00:00-05:00,0,2,5,0,0,2297,16952,19249
2017-02-27 06:00:00-05:00,0,2,6,0,0,2130,13644,15774
2017-02-27 07:00:00-05:00,0,2,7,0,0,1807,12043,13850
2017-02-27 08:00:00-05:00,0,2,8,0,0,1532,10940,12472
2017-02-27 09:00:00-05:00,0,2,9,0,0,1239,8193,9432
2017-02-27 10:00:00-05:00,0,2,10,0,0,1139,8908,10047
2017-02-27 11:00:00-05:00,0,2,11,0,0,614,3297,3911
2017-02-27 12:00:00-05:00,0,2,12,0,0,334,1988,2322
2017-02-27 13:00:00-05:00,0,2,13,0,0,270,1290,1560
2017-02-27 14:00:00-05:00,0,2,14,0,0,284,1817,2101
2017-02-27 15:00:00-05:00,0,2,15,0,0,281,3590,3871
2017-02-27 16:00:00-05:00,0,2,16,0,0,564,9354,9918
2017-02-27 17:00:00-05:00,0,2,17,0,0,1445,15762,17207
2017-02-27 18:00:00-05:00,0,2,18,0,0,2041,19006,21047
2017-02-27 19:00:00-05:00,0,2,19,0,0,1798,16666,18464
2017-02-27 20:00:00-05:00,0,2,20,0,0,1582,14328,15910
2017-02-27 21:00:00-05:00,0,2,21,0,0,1316,13798,15114
2017-02-27 22:00:00-05:00,0,2,22,0,0,1335,14186,15521
2017-02-27 23:00:00-05:00,0,2,23,0,0,1461,14659,16120
2017-02-28 00:00:00-05:00,0,2,0,1,0,1551,16001,17552
2017-02-28 01:00:00-05:00,0,2,1,1,0,1728,16300,18028
2017-02-28 02:00:00-05:00,0,2,2,1,0,1918,15384,17302
2017-02-28 03:00:00-05:00,0,2,3,1,0,2182,18038,20220
2017-02-28 04:00:00-05:00,0,2,4,1,0,2395,20860,23255
2017-02-28 05:00:00-05:00,0,2,5,1,0,2293,19081,21374
2017-02-28 06:00:00-05:00,0,2,6,1,0,2039,18347,20386
2017-02-28 07:00:00-05:00,0,2,7,1,0,1632,17786,19418
2017-02-28 08:00:00-05:00,0,2,8,1,0,1405,15245,16650
2017-02-28 09:00:00-05:00,0,2,9,1,0,1089,10024,11113
2017-02-28 10:00:00-05:00,0,2,10,1,0,731,6059,6790
2017-02-28 11:00:00-05:00,0,2,11,1,0,513,3493,4006
2017-02-28 12:00:00-05:00,0,2,12,1,0,308,2042,2350
2017-02-28 13:00:00-05:00,0,2,13,1,0,210,1448,1658
2017-02-28 14:00:00-05:00,0,2,14,1,0,226,1462,1688
2017-02-28 15:00:00-05:00,0,2,15,1,0,199,3388,3587
2017-02-28 16:00:00-05:00,0,2,16,1,0,502,9016,9518
2017-02-28 17:00:00-05:00,0,2,17,1,0,1280,16036,17316
2017-02-28 18:00:00-05:00,0,2,18,1,0,1882,19127,21009
2017-02-28 19:00:00-05:00,0,2,19,1,0,1718,17167,18885
2017-02-28 20:00:00-05:00,0,2,20,1,0,1444,15028,16472
2017-02-28 21:00:00-05:00,0,2,21,1,0,1432,14571,16003
2017-02-28 22:00:00-05:00,0,2,22,1,0,1360,14865,16225
2017-02-28 23:00:00-05:00,0,2,23,1,0,1419,16083,17502
2017-03-01 00:00:00-05:00,0,3,0,2,0,1512,17487,18999
2017-03-01 01:00:00-05:00,0,3,1,2,0,1711,17867,19578
2017-03-01 02:00:00-05:00,0,3,2,2,0,2066,16449,18515
2017-03-01 03:00:00-05:00,0,3,3,2,0,2293,18715,21008
2017-03-01 04:00:00-05:00,0,3,4,2,0,2437,21751,24188
2017-03-01 05:00:00-05:00,0,3,5,2,0,2394,20846,23240
2017-03-01 06:00:00-05:00,0,3,6,2,0,2003,20238,22241
2017-03-01 07:00:00-05:00,0,3,7,2,0,1729,20205,21934
2017-03-01 08:00:00-05:00,0,3,8,2,0,1464,18144,19608
2017-03-01 09:00:00-05:00,0,3,9,2,0,1121,12877,13998
2017-03-01 10:00:00-05:00,0,3,10,2,0,902,8188,9090
2017-03-01 11:00:00-05:00,0.11,3,11,2,0,531,4783,5314
2017-03-01 12:00:00-05:00,0.01,3,12,2,0,413,3212,3625
2017-03-01 13:00:00-05:00,0,3,13,2,0,235,2058,2293
2017-03-01 14:00:00-05:00,0,3,14,2,0,247,1942,2189
2017-03-01 15:00:00-05:00,0,3,15,2,0,232,3388,3620
2017-03-01 16:00:00-05:00,0,3,16,2,0,510,9270,9780
2017-03-01 17:00:00-05:00,0,3,17,2,0,1334,16918,18252
2017-03-01 18:00:00-05:00,0,3,18,2,0,1984,20487,22471
2017-03-01 19:00:00-05:00,0,3,19,2,0,1818,18147,19965
2017-03-01 20:00:00-05:00,0,3,20,2,0,1687,17230,18917
2017-03-01 21:00:00-05:00,0,3,21,2,0,1803,18771,20574
2017-03-01 22:00:00-05:00,0,3,22,2,0,1519,15685,17204
2017-03-01 23:00:00-05:00,0,3,23,2,0,1494,15800,17294
2017-03-02 00:00:00-05:00,0,3,0,3,0,1782,17397,19179
2017-03-02 01:00:00-05:00,0,3,1,3,0,1979,18142,20121
2017-03-02 02:00:00-05:00,0,3,2,3,0,2075,15529,17604
2017-03-02 03:00:00-05:00,0,3,3,3,0,2372,18449,20821
2017-03-02 04:00:00-05:00,0,3,4,3,0,2567,22139,24706
2017-03-02 05:00:00-05:00,0,3,5,3,0,2421,21502,23923
2017-03-02 06:00:00-05:00,0,3,6,3,0,2137,20356,22493
2017-03-02 07:00:00-05:00,0,3,7,3,0,1960,19912,21872
2017-03-02 08:00:00-05:00,0,3,8,3,0,1599,18685,20284
2017-03-02 09:00:00-05:00,0,3,9,3,0,1369,14088,15457
2017-03-02 10:00:00-05:00,0,3,10,3,0,1002,8858,9860
2017-03-02 11:00:00-05:00,0,3,11,3,0,691,5267,5958
2017-03-02 12:00:00-05:00,0,3,12,3,0,448,3252,3700
2017-03-02 13:00:00-05:00,0,3,13,3,0,288,2189,2477
2017-03-02 14:00:00-05:00,0,3,14,3,0,262,2140,2402
2017-03-02 15:00:00-05:00,0,3,15,3,0,245,3449,3694
2017-03-02 16:00:00-05:00,0,3,16,3,0,525,9633,10158
2017-03-02 17:00:00-05:00,0,3,17,3,0,1356,17727,19083
2017-03-02 18:00:00-05:00,0,3,18,3,0,2052,20323,22375
2017-03-02 19:00:00-05:00,0,3,19,3,0,1907,18506,20413
2017-03-02 20:00:00-05:00,0,3,20,3,0,1677,16352,18029
2017-03-02 21:00:00-05:00,0,3,21,3,0,1590,16694,18284
2017-03-02 22:00:00-05:00,0,3,22,3,0,1470,17431,18901
2017-03-02 23:00:00-05:00,0,3,23,3,0,1650,17394,19044
2017-03-03 00:00:00-05:00,0,3,0,4,0,1779,19028,20807
2017-03-03 01:00:00-05:00,0,3,1,4,0,1971,19070,21041
2017-03-03 02:00:00-05:00,0,3,2,4,0,2460,17313,19773
2017-03-03 03:00:00-05:00,0,3,3,4,0,2820,20492,23312
2017-03-03 04:00:00-05:00,0,3,4,4,0,3105,24983,28088
2017-03-03 05:00:00-05:00,0,3,5,4,0,3026,24914,27940
2017-03-03 06:00:00-05:00,0,3,6,4,0,2670,23793,26463
2017-03-03 07:00:00-05:00,0,3,7,4,0,2404,23453,25857
2017-03-03 08:00:00-05:00,0,3,8,4,0,2056,22057,24113
2017-03-03 09:00:00-05:00,0,3,9,4,0,1739,18539,20278
2017-03-03 10:00:00-05:00,0,3,10,4,0,1394,12538,13932
2017-03-03 11:00:00-05:00,0,3,11,4,0,1017,7873,8890
2017-03-03 12:00:00-05:00,0,3,12,4,0,540,4867,5407
2017-03-03 13:00:00-05:00,0,3,13,4,0,422,3375,3797
2017-03-03 14:00:00-05:00,0,3,14,4,0,365,2794,3159
2017-03-03 15:00:00-05:00,0,3,15,4,0,277,3774,4051
2017-03-03 16:00:00-05:00,0,3,16,4,0,564,9621,10185
2017-03-03 17:00:00-05:00,0,3,17,4,0,1441,17093,18534
2017-03-03 18:00:00-05:00,0,3,18,4,0,2028,20245,22273
2017-03-03 19:00:00-05:00,0,3,19,4,0,1932,18603,20535
2017-03-03 20:00:00-05:00,0,3,20,4,0,1863,16592,18455
2017-03-03 21:00:00-05:00,0,3,21,4,0,1873,17378,19251
2017-03-03 22:00:00-05:00,0,3,22,4,0,1579,18162,19741
2017-03-03 23:00:00-05:00,0,3,23,4,0,1514,18705,20219
2017-03-04 00:00:00-05:00,0,3,0,5,0,2027,20623,22650
2017-03-04 01:00:00-05:00,0,3,1,5,0,2320,19713,22033
2017-03-04 02:00:00-05:00,0,3,2,5,0,2631,17417,20048
2017-03-04 03:00:00-05:00,0,3,3,5,0,3132,21331,24463
2017-03-04 04:00:00-05:00,0,3,4,5,0,3305,25009,28314
2017-03-04 05:00:00-05:00,0,3,5,5,0,3486,26649,30135
2017-03-04 06:00:00-05:00,0,3,6,5,0,3260,23939,27199
2017-03-04 07:00:00-05:00,0,3,7,5,0,3156,22834,25990
2017-03-04 08:00:00-05:00,0,3,8,5,0,3066,23378,26444
2017-03-04 09:00:00-05:00,0,3,9,5,0,3020,22891,25911
2017-03-04 10:00:00-05:00,0,3,10,5,0,2743,19387,22130
2017-03-04 11:00:00-05:00,0,3,11,5,0,2305,15964,18269
2017-03-04 12:00:00-05:00,0,3,12,5,0,1773,12777,14550
2017-03-04 13:00:00-05:00,0,3,13,5,0,1450,9338,10788
2017-03-04 14:00:00-05:00,0,3,14,5,0,1013,5986,6999
2017-03-04 15:00:00-05:00,0,3,15,5,0,445,2920,3365
2017-03-04 16:00:00-05:00,0,3,16,5,0,426,4241,4667
2017-03-04 17:00:00-05:00,0,3,17,5,0,673,6217,6890
2017-03-04 18:00:00-05:00,0,3,18,5,0,1036,9685,10721
2017-03-04 19:00:00-05:00,0,3,19,5,0,1418,14098,15516
2017-03-04 20:00:00-05:00,0,3,20,5,0,1609,17528,19137
2017-03-04 21:00:00-05:00,0,3,21,5,0,1880,19980,21860
2017-03-04 22:00:00-05:00,0,3,22,5,0,1985,21540,23525
2017-03-04 23:00:00-05:00,0,3,23,5,0,2136,21846,23982
2017-03-05 00:00:00-05:00,0,3,0,6,0,2255,21397,23652
2017-03-05 01:00:00-05:00,0,3,1,6,0,2368,21560,23928
2017-03-05 02:00:00-05:00,0,3,2,6,0,2753,20390,23143
2017-03-05 03:00:00-05:00,0,3,3,6,0,2805,22158,24963
2017-03-05 04:00:00-05:00,0,3,4,6,0,3105,25168,28273
2017-03-05 05:00:00-05:00,0,3,5,6,0,3305,26208,29513
2017-03-05 06:00:00-05:00,0,3,6,6,0,3204,20519,23723
2017-03-05 07:00:00-05:00,0,3,7,6,0,3070,20259,23329
2017-03-05 08:00:00-05:00,0,3,8,6,0,3153,22294,25447
2017-03-05 09:00:00-05:00,0,3,9,6,0,3232,22601,25833
2017-03-05 10:00:00-05:00,0,3,10,6,0,2858,19940,22798
2017-03-05 11:00:00-05:00,0,3,11,6,0,2385,17180,19565
2017-03-05 12:00:00-05:00,0,3,12,6,0,2034,14105,16139
2017-03-05 13:00:00-05:00,0,3,13,6,0,1569,10653,12222
2017-03-05 14:00:00-05:00,0,3,14,6,0,1206,6670,7876
2017-03-05 15:00:00-05:00,0,3,15,6,0,613,2970,3583
2017-03-05 16:00:00-05:00,0,3,16,6,0,442,3497,3939
2017-03-05 17:00:00-05:00,0,3,17,6,0,503,4888,5391
2017-03-05 18:00:00-05:00,0,3,18,6,0,676,8010,8686
2017-03-05 19:00:00-05:00,0,3,19,6,0,996,11923,12919
2017-03-05 20:00:00-05:00,0,3,20,6,0,1245,15937,17182
2017-03-05 21:00:00-05:00,0,3,21,6,0,1489,18801,20290
2017-03-05 22:00:00-05:00,0,3,22,6,0,1546,20164,21710
2017-03-05 23:00:00-05:00,0,3,23,6,0,1720,19544,21264
2017-03-06 00:00:00-05:00,0,3,0,0,0,1869,19483,21352
2017-03-06 01:00:00-05:00,0,3,1,0,0,1948,18204,20152
2017-03-06 02:00:00-05:00,0,3,2,0,0,2074,17116,19190
2017-03-06 03:00:00-05:00,0,3,3,0,0,2206,17290,19496
2017-03-06 04:00:00-05:00,0,3,4,0,0,2185,18800,20985
2017-03-06 05:00:00-05:00,0,3,5,0,0,2040,16052,18092
2017-03-06 06:00:00-05:00,0,3,6,0,0,1871,14133,16004
2017-03-06 07:00:00-05:00,0,3,7,0,0,1629,12870,14499
2017-03-06 08:00:00-05:00,0,3,8,0,0,1482,10714,12196
2017-03-06 09:00:00-05:00,0,3,9,0,0,1134,7998,9132
2017-03-06 10:00:00-05:00,0,3,10,0,0,847,5369,6216
2017-03-06 11:00:00-05:00,0,3,11,0,0,480,3025,3505
2017-03-06 12:00:00-05:00,0,3,12,0,0,334,1910,2244
2017-03-06 13:00:00-05:00,0,3,13,0,0,257,1408,1665
2017-03-06 14:00:00-05:00,0,3,14,0,0,281,1833,2114
2017-03-06 15:00:00-05:00,0,3,15,0,0,256,3719,3975
2017-03-06 16:00:00-05:00,0,3,16,0,0,511,9670,10181
2017-03-06 17:00:00-05:00,0,3,17,0,0,1336,16694,18030
2017-03-06 18:00:00-05:00,0,3,18,0,0,2069,19052,21121
2017-03-06 19:00:00-05:00,0,3,19,0,0,1772,16889,18661
2017-03-06 20:00:00-05:00,0,3,20,0,0,1488,14475,15963
2017-03-06 21:00:00-05:00,0,3,21,0,0,1428,14240,15668
2017-03-06 22:00:00-05:00,0,3,22,0,0,1408,15130,16538
2017-03-06 23:00:00-05:00,0,3,23,0,0,1428,14827,16255
2017-03-07 00:00:00-05:00,0,3,0,1,0,1589,16316,17905
2017-03-07 01:00:00-05:00,0,3,1,1,0,1808,17213,19021
2017-03-07 02:00:00-05:00,0,3,2,1,0,2028,16082,18110
2017-03-07 03:00:00-05:00,0,3,3,1,0,2291,18833,21124
2017-03-07 04:00:00-05:00,0,3,4,1,0,2554,22094,24648
2017-03-07 05:00:00-05:00,0,3,5,1,0,2303,20373,22676
2017-03-07 06:00:00-05:00,0,3,6,1,0,1944,18302,20246
2017-03-07 07:00:00-05:00,0,3,7,1,0,1550,17395,18945
2017-03-07 08:00:00-05:00,0,3,8,1,0,1282,14487,15769
2017-03-07 09:00:00-05:00,0.03,3,9,1,0,1033,10089,11122
2017-03-07 10:00:00-05:00,0.04,3,10,1,0,719,5870,6589
2017-03-07 11:00:00-05:00,0.03,3,11,1,0,487,3495,3982
2017-03-07 12:00:00-05:00,0,3,12,1,0,311,2109,2420
2017-03-07 13:00:00-05:00,0,3,13,1,0,208,1491,1699
2017-03-07 14:00:00-05:00,0,3,14,1,0,199,1580,1779
2017-03-07 15:00:00-05:00,0,3,15,1,0,235,3277,3512
2017-03-07 16:00:00-05:00,0,3,16,1,0,541,9441,9982
2017-03-07 17:00:00-05:00,0,3,17,1,0,1363,17104,18467
2017-03-07 18:00:00-05:00,0,3,18,1,0,2040,20901,22941
2017-03-07 19:00:00-05:00,0,3,19,1,0,1935,19507,21442
2017-03-07 20:00:00-05:00,0,3,20,1,0,1761,17154,18915
2017-03-07 21:00:00-05:00,0,3,21,1,0,1632,16205,17837
2017-03-07 22:00:00-05:00,0,3,22,1,0,1494,15876,17370
2017-03-07 23:00:00-05:00,0,3,23,1,0,1482,16115,17597
2017-03-08 00:00:00-05:00,0,3,0,2,0,1658,17514,19172
2017-03-08 01:00:00-05:00,0,3,1,2,0,1879,18149,20028
2017-03-08 02:00:00-05:00,0,3,2,2,0,1930,15706,17636
2017-03-08 03:00:00-05:00,0,3,3,2,0,2220,18526,20746
2017-03-08 04:00:00-05:00,0,3,4,2,0,2435,21616,24051
2017-03-08 05:00:00-05:00,0.03,3,5,2,0,2390,21524,23914
2017-03-08 06:00:00-05:00,0.03,3,6,2,0,1984,20386,22370
2017-03-08 07:00:00-05:00,0,3,7,2,0,1653,19745,21398
2017-03-08 08:00:00-05:00,0,3,8,2,0,1465,17439,18904
2017-03-08 09:00:00-05:00,0,3,9,2,0,1131,11606,12737
2017-03-08 10:00:00-05:00,0,3,10,2,0,927,7042,7969
2017-03-08 11:00:00-05:00,0,3,11,2,0,611,4151,4762
2017-03-08 12:00:00-05:00,0,3,12,2,0,315,2488,2803
2017-03-08 13:00:00-05:00,0,3,13,2,0,236,1716,1952
2017-03-08 14:00:00-05:00,0,3,14,2,0,227,1899,2126
2017-03-08 15:00:00-05:00,0,3,15,2,0,232,3523,3755
2017-03-08 16:00:00-05:00,0,3,16,2,0,506,10045,10551
2017-03-08 17:00:00-05:00,0,3,17,2,0,1211,17054,18265
2017-03-08 18:00:00-05:00,0,3,18,2,0,1931,20246,22177
2017-03-08 19:00:00-05:00,0,3,19,2,0,1739,17975,19714
2017-03-08 20:00:00-05:00,0,3,20,2,0,1474,15601,17075
2017-03-08 21:00:00-05:00,0,3,21,2,0,1496,15911,17407
2017-03-08 22:00:00-05:00,0,3,22,2,0,1454,16299,17753
2017-03-08 23:00:00-05:00,0,3,23,2,0,1469,16481,17950
2017-03-09 00:00:00-05:00,0,3,0,3,0,1718,18846,20564
2017-03-09 01:00:00-05:00,0,3,1,3,0,1773,17603,19376
2017-03-09 02:00:00-05:00,0,3,2,3,0,2101,15702,17803
2017-03-09 03:00:00-05:00,0,3,3,3,0,2350,18747,21097
2017-03-09 04:00:00-05:00,0,3,4,3,0,2610,22443,25053
2017-03-09 05:00:00-05:00,0,3,5,3,0,2470,22014,24484
2017-03-09 06:00:00-05:00,0,3,6,3,0,2248,21358,23606
2017-03-09 07:00:00-05:00,0,3,7,3,0,1941,21872,23813
2017-03-09 08:00:00-05:00,0,3,8,3,0,1661,19622,21283
2017-03-09 09:00:00-05:00,0,3,9,3,0,1413,13953,15366
2017-03-09 10:00:00-05:00,0,3,10,3,0,1073,8975,10048
2017-03-09 11:00:00-05:00,0,3,11,3,0,691,5194,5885
2017-03-09 12:00:00-05:00,0,3,12,3,0,418,3206,3624
2017-03-09 13:00:00-05:00,0,3,13,3,0,294,2149,2443
2017-03-09 14:00:00-05:00,0,3,14,3,0,264,2111,2375
2017-03-09 15:00:00-05:00,0,3,15,3,0,237,3511,3748
2017-03-09 16:00:00-05:00,0,3,16,3,0,550,9609,10159
2017-03-09 17:00:00-05:00,0,3,17,3,0,1337,16886,18223
2017-03-09 18:00:00-05:00,0,3,18,3,0,1913,19809,21722
2017-03-09 19:00:00-05:00,0,3,19,3,0,1852,18589,20441
2017-03-09 20:00:00-05:00,0,3,20,3,0,1609,16146,17755
2017-03-09 21:00:00-05:00,0,3,21,3,0,1680,16521,18201
2017-03-09 22:00:00-05:00,0,3,22,3,0,1538,17207,18745
2017-03-09 23:00:00-05:00,0,3,23,3,0,1579,17360,18939
2017-03-10 00:00:00-05:00,0,3,0,4,0,1723,18547,20270
2017-03-10 01:00:00-05:00,0,3,1,4,0,2006,18216,20222
2017-03-10 02:00:00-05:00,0,3,2,4,0,2323,16293,18616
2017-03-10 03:00:00-05:00,0,3,3,4,0,2692,19516,22208
2017-03-10 04:00:00-05:00,0,3,4,4,0,2763,23865,26628
2017-03-10 05:00:00-05:00,0,3,5,4,0,2792,23858,26650
2017-03-10 06:00:00-05:00,0,3,6,4,0,2499,22558,25057
2017-03-10 07:00:00-05:00,0.01,3,7,4,0,2279,22924,25203
2017-03-10 08:00:00-05:00,0.06,3,8,4,0,2052,21898,23950
2017-03-10 09:00:00-05:00,0.06,3,9,4,0,1862,18028,19890
2017-03-10 10:00:00-05:00,0.05,3,10,4,0,1395,13148,14543
2017-03-10 11:00:00-05:00,0.03,3,11,4,0,937,7844,8781
2017-03-10 12:00:00-05:00,0.02,3,12,4,0,637,5039,5676
2017-03-10 13:00:00-05:00,0.01,3,13,4,0,436,3477,3913
2017-03-10 14:00:00-05:00,0,3,14,4,0,362,3073,3435
2017-03-10 15:00:00-05:00,0,3,15,4,0,251,3972,4223
2017-03-10 16:00:00-05:00,0,3,16,4,0,510,9419,9929
2017-03-10 17:00:00-05:00,0,3,17,4,0,1413,17908,19321
2017-03-10 18:00:00-05:00,0,3,18,4,0,2078,20855,22933
2017-03-10 19:00:00-05:00,0,3,19,4,0,1920,18564,20484
2017-03-10 20:00:00-05:00,0,3,20,4,0,1624,15912,17536
2017-03-10 21:00:00-05:00,0,3,21,4,0,1584,16217,17801
2017-03-10 22:00:00-05:00,0,3,22,4,0,1439,16211,17650
2017-03-10 23:00:00-05:00,0,3,23,4,0,1403,16055,17458
2017-03-11 00:00:00-05:00,0,3,0,5,0,1644,17555,19199
2017-03-11 01:00:00-05:00,0,3,1,5,0,1940,18186,20126
2017-03-11 02:00:00-05:00,0,3,2,5,0,2397,17449,19846
2017-03-11 03:00:00-05:00,0,3,3,5,0,2970,21630,24600
2017-03-11 04:00:00-05:00,0,3,4,5,0,3368,25365,28733
2017-03-11 05:00:00-05:00,0,3,5,5,0,3334,24945,28279
2017-03-11 06:00:00-05:00,0,3,6,5,0,3097,21707,24804
2017-03-11 07:00:00-05:00,0,3,7,5,0,2982,21908,24890
2017-03-11 08:00:00-05:00,0,3,8,5,0,2899,22445,25344
2017-03-11 09:00:00-05:00,0,3,9,5,0,2917,21961,24878
2017-03-11 10:00:00-05:00,0,3,10,5,0,2534,18926,21460
2017-03-11 11:00:00-05:00,0,3,11,5,0,2060,15246,17306
2017-03-11 12:00:00-05:00,0,3,12,5,0,1637,12278,13915
2017-03-11 13:00:00-05:00,0,3,13,5,0,1368,9058,10426
2017-03-11 14:00:00-05:00,0,3,14,5,0,1001,5716,6717
2017-03-11 15:00:00-05:00,0,3,15,5,0,452,3007,3459
2017-03-11 16:00:00-05:00,0,3,16,5,0,430,4359,4789
2017-03-11 17:00:00-05:00,0,3,17,5,0,612,6353,6965
2017-03-11 18:00:00-05:00,0,3,18,5,0,949,9963,10912
2017-03-11 19:00:00-05:00,0,3,19,5,0,1377,14450,15827
2017-03-11 20:00:00-05:00,0,3,20,5,0,1565,17275,18840
2017-03-11 21:00:00-05:00,0,3,21,5,0,1814,19703,21517
2017-03-11 22:00:00-05:00,0,3,22,5,0,1861,21711,23572
2017-03-11 23:00:00-05:00,0,3,23,5,0,2150,22578,24728
2017-03-12 00:00:00-05:00,0,3,0,6,0,2282,21094,23376
2017-03-12 01:00:00-05:00,0,3,1,6,0,2374,21330,23704
2017-03-12 03:00:00-04:00,0,3,3,6,0,2639,20331,22970
2017-03-12 04:00:00-04:00,0,3,4,6,0,2877,22595,25472
2017-03-12 05:00:00-04:00,0,3,5,6,0,3056,24403,27459
2017-03-12 06:00:00-04:00,0,3,6,6,0,3222,25380,28602
2017-03-12 07:00:00-04:00,0,3,7,6,0,2977,20980,23957
2017-03-12 08:00:00-04:00,0,3,8,6,0,2844,19441,22285
2017-03-12 09:00:00-04:00,0,3,9,6,0,2910,21852,24762
2017-03-12 10:00:00-04:00,0,3,10,6,0,3124,23141,26265
2017-03-12 11:00:00-04:00,0,3,11,6,0,2696,20047,22743
2017-03-12 12:00:00-04:00,0,3,12,6,0,2243,17281,19524
2017-03-12 13:00:00-04:00,0,3,13,6,0,7,8,15
2017-03-12 14:00:00-04:00,0,3,14,6,0,2068,16048,18116
2017-03-12 15:00:00-04:00,0,3,15,6,0,1745,11318,13063
2017-03-12 16:00:00-04:00,0,3,16,6,0,879,4488,5367
2017-03-12 17:00:00-04:00,0,3,17,6,0,544,3738,4282
2017-03-12 18:00:00-04:00,0,3,18,6,0,530,4863,5393
2017-03-12 19:00:00-04:00,0,3,19,6,0,626,7778,8404
2017-03-12 20:00:00-04:00,0,3,20,6,0,913,11382,12295
2017-03-12 21:00:00-04:00,0,3,21,6,0,1133,15428,16561
2017-03-12 22:00:00-04:00,0,3,22,6,0,1443,18150,19593
2017-03-12 23:00:00-04:00,0,3,23,6,0,1638,20189,21827
2017-03-13 00:00:00-04:00,0,3,0,0,0,1722,20519,22241
2017-03-13 01:00:00-04:00,0,3,1,0,0,1827,20140,21967
2017-03-13 02:00:00-04:00,0,3,2,0,0,2048,19600,21648
2017-03-13 03:00:00-04:00,0,3,3,0,0,2111,18492,20603
2017-03-13 04:00:00-04:00,0,3,4,0,0,2131,19019,21150
2017-03-13 05:00:00-04:00,0,3,5,0,0,2289,19113,21402
2017-03-13 06:00:00-04:00,0,3,6,0,0,2245,17468,19713
2017-03-13 07:00:00-04:00,0,3,7,0,0,2032,15285,17317
2017-03-13 08:00:00-04:00,0,3,8,0,0,1841,14212,16053
2017-03-13 09:00:00-04:00,0,3,9,0,0,1667,12079,13746
2017-03-13 10:00:00-04:00,0,3,10,0,0,1355,8825,10180
2017-03-13 11:00:00-04:00,0,3,11,0,0,993,5478,6471
2017-03-13 12:00:00-04:00,0,3,12,0,0,620,3490,4110
2017-03-13 13:00:00-04:00,0,3,13,0,0,352,2096,2448
2017-03-13 14:00:00-04:00,0,3,14,0,0,328,1650,1978
2017-03-13 15:00:00-04:00,0,3,15,0,0,320,2022,2342
2017-03-13 16:00:00-04:00,0,3,16,0,0,280,3704,3984
2017-03-13 17:00:00-04:00,0,3,17,0,0,492,9813,10305
2017-03-13 18:00:00-04:00,0,3,18,0,0,1183,16653,17836
2017-03-13 19:00:00-04:00,0,3,19,0,0,2001,20059,22060
2017-03-13 20:00:00-04:00,0,3,20,0,0,1869,18411,20280
2017-03-13 21:00:00-04:00,0,3,21,0,0,1653,16584,18237
2017-03-13 22:00:00-04:00,0,3,22,0,0,1479,16220,17699
2017-03-13 23:00:00-04:00,0,3,23,0,0,1491,16423,17914
2017-03-14 00:00:00-04:00,0,3,0,1,0,1449,16571,18020
2017-03-14 01:00:00-04:00,0,3,1,1,0,1714,18378,20092
2017-03-14 02:00:00-04:00,0.03,3,2,1,0,1922,18826,20748
2017-03-14 03:00:00-04:00,0.04,3,3,1,0,2102,16762,18864
2017-03-14 04:00:00-04:00,0.06,3,4,1,0,2531,19405,21936
2017-03-14 05:00:00-04:00,0.07,3,5,1,0,2922,22425,25347
2017-03-14 06:00:00-04:00,0.04,3,6,1,0,2851,22701,25552
2017-03-14 07:00:00-04:00,0.08,3,7,1,0,2601,20882,23483
2017-03-14 08:00:00-04:00,0.09,3,8,1,0,2234,19079,21313
2017-03-14 09:00:00-04:00,0.15,3,9,1,0,2151,17051,19202
2017-03-14 10:00:00-04:00,0.14,3,10,1,0,1405,11741,13146
2017-03-14 11:00:00-04:00,0.1,3,11,1,0,1014,7088,8102
2017-03-14 12:00:00-04:00,0.12,3,12,1,0,584,4431,5015
2017-03-14 13:00:00-04:00,0.07,3,13,1,0,333,2821,3154
2017-03-14 14:00:00-04:00,0.02,3,14,1,0,183,1690,1873
2017-03-14 15:00:00-04:00,0,3,15,1,0,96,1013,1109
2017-03-14 16:00:00-04:00,0,3,16,1,0,73,999,1072
2017-03-14 17:00:00-04:00,0.01,3,17,1,0,86,1552,1638
2017-03-14 18:00:00-04:00,0.01,3,18,1,0,125,2435,2560
2017-03-14 19:00:00-04:00,0,3,19,1,0,164,2699,2863
2017-03-14 20:00:00-04:00,0,3,20,1,0,161,2830,2991
2017-03-14 21:00:00-04:00,0,3,21,1,0,158,2662,2820
2017-03-14 22:00:00-04:00,0,3,22,1,0,135,2797,2932
2017-03-14 23:00:00-04:00,0,3,23,1,0,141,3226,3367
2017-03-15 00:00:00-04:00,0,3,0,2,0,176,3314,3490
2017-03-15 01:00:00-04:00,0,3,1,2,0,250,3739,3989
2017-03-15 02:00:00-04:00,0,3,2,2,0,330,4228,4558
2017-03-15 03:00:00-04:00,0,3,3,2,0,371,4809,5180
2017-03-15 04:00:00-04:00,0,3,4,2,0,443,6232,6675
2017-03-15 05:00:00-04:00,0,3,5,2,0,509,7752,8261
2017-03-15 06:00:00-04:00,0,3,6,2,0,460,7211,7671
2017-03-15 07:00:00-04:00,0,3,7,2,0,471,6539,7010
2017-03-15 08:00:00-04:00,0,3,8,2,0,465,7135,7600
2017-03-15 09:00:00-04:00,0,3,9,2,0,458,7361,7819
2017-03-15 10:00:00-04:00,0,3,10,2,0,402,5762,6164
2017-03-15 11:00:00-04:00,0,3,11,2,0,271,3633,3904
2017-03-15 12:00:00-04:00,0,3,12,2,0,174,2202,2376
2017-03-15 13:00:00-04:00,0,3,13,2,0,127,1280,1407
2017-03-15 14:00:00-04:00,0,3,14,2,0,101,940,1041
2017-03-15 15:00:00-04:00,0,3,15,2,0,106,1375,1481
2017-03-15 16:00:00-04:00,0,3,16,2,0,173,3115,3288
2017-03-15 17:00:00-04:00,0,3,17,2,0,361,7878,8239
2017-03-15 18:00:00-04:00,0,3,18,2,0,921,13143,14064
2017-03-15 19:00:00-04:00,0,3,19,2,0,1561,15546,17107
2017-03-15 20:00:00-04:00,0,3,20,2,0,1768,14505,16273
2017-03-15 21:00:00-04:00,0,3,21,2,0,1651,13394,15045
2017-03-15 22:00:00-04:00,0,3,22,2,0,1564,13261,14825
2017-03-15 23:00:00-04:00,0,3,23,2,0,1585,13996,15581
2017-03-16 00:00:00-04:00,0,3,0,3,0,1682,14046,15728
2017-03-16 01:00:00-04:00,0,3,1,3,0,1814,15715,17529
2017-03-16 02:00:00-04:00,0,3,2,3,0,2188,16001,18189
2017-03-16 03:00:00-04:00,0,3,3,3,0,2370,14248,16618
2017-03-16 04:00:00-04:00,0,3,4,3,0,2900,17024,19924
2017-03-16 05:00:00-04:00,0,3,5,3,0,3188,19780,22968
2017-03-16 06:00:00-04:00,0,3,6,3,0,2956,19982,22938
2017-03-16 07:00:00-04:00,0,3,7,3,0,2558,19601,22159
2017-03-16 08:00:00-04:00,0,3,8,3,0,2069,19675,21744
2017-03-16 09:00:00-04:00,0,3,9,3,0,1789,17738,19527
2017-03-16 10:00:00-04:00,0,3,10,3,0,1412,14062,15474
2017-03-16 11:00:00-04:00,0,3,11,3,0,1011,8720,9731
2017-03-16 12:00:00-04:00,0,3,12,3,0,574,5009,5583
2017-03-16 13:00:00-04:00,0,3,13,3,0,332,3054,3386
2017-03-16 14:00:00-04:00,0,3,14,3,0,231,2071,2302
2017-03-16 15:00:00-04:00,0,3,15,3,0,250,2293,2543
2017-03-16 16:00:00-04:00,0,3,16,3,0,272,4132,4404
2017-03-16 17:00:00-04:00,0,3,17,3,0,506,9594,10100
2017-03-16 18:00:00-04:00,0,3,18,3,0,1372,16343,17715
2017-03-16 19:00:00-04:00,0,3,19,3,0,1999,18085,20084
2017-03-16 20:00:00-04:00,0,3,20,3,0,1995,16564,18559
2017-03-16 21:00:00-04:00,0,3,21,3,0,1743,14978,16721
2017-03-16 22:00:00-04:00,0,3,22,3,0,1669,15007,16676
2017-03-16 23:00:00-04:00,0,3,23,3,0,1637,14856,16493
2017-03-17 00:00:00-04:00,0,3,0,4,0,1617,14138,15755
2017-03-17 01:00:00-04:00,0,3,1,4,0,1902,14826,16728
2017-03-17 02:00:00-04:00,0,3,2,4,0,2116,13655,15771
2017-03-17 03:00:00-04:00,0,3,3,4,0,2331,11344,13675
2017-03-17 04:00:00-04:00,0,3,4,4,0,2747,14126,16873
2017-03-17 05:00:00-04:00,0,3,5,4,0,3001,18298,21299
2017-03-17 06:00:00-04:00,0,3,6,4,0,2950,19961,22911
2017-03-17 07:00:00-04:00,0,3,7,4,0,2873,20780,23653
2017-03-17 08:00:00-04:00,0,3,8,4,0,2526,21097,23623
2017-03-17 09:00:00-04:00,0,3,9,4,0,2252,19820,22072
2017-03-17 10:00:00-04:00,0,3,10,4,0,1742,18172,19914
2017-03-17 11:00:00-04:00,0,3,11,4,0,1332,13722,15054
2017-03-17 12:00:00-04:00,0,3,12,4,0,894,7917,8811
2017-03-17 13:00:00-04:00,0,3,13,4,0,578,5034,5612
2017-03-17 14:00:00-04:00,0,3,14,4,0,422,3465,3887
2017-03-17 15:00:00-04:00,0,3,15,4,0,359,3329,3688
2017-03-17 16:00:00-04:00,0,3,16,4,0,300,4074,4374
2017-03-17 17:00:00-04:00,0,3,17,4,0,511,9300,9811
2017-03-17 18:00:00-04:00,0,3,18,4,0,1315,15196,16511
2017-03-17 19:00:00-04:00,0,3,19,4,0,1948,16673,18621
2017-03-17 20:00:00-04:00,0,3,20,4,0,1927,14815,16742
2017-03-17 21:00:00-04:00,0,3,21,4,0,1655,13068,14723
2017-03-17 22:00:00-04:00,0,3,22,4,0,1667,12624,14291
2017-03-17 23:00:00-04:00,0,3,23,4,0,1454,11796,13250
2017-03-18 00:00:00-04:00,0,3,0,5,0,1352,11497,12849
2017-03-18 01:00:00-04:00,0,3,1,5,0,1744,13030,14774
2017-03-18 02:00:00-04:00,0,3,2,5,0,1993,11936,13929
2017-03-18 03:00:00-04:00,0,3,3,5,0,2305,10307,12612
2017-03-18 04:00:00-04:00,0,3,4,5,0,2879,14014,16893
2017-03-18 05:00:00-04:00,0,3,5,5,0,3145,18955,22100
2017-03-18 06:00:00-04:00,0,3,6,5,0,3192,21827,25019
2017-03-18 07:00:00-04:00,0,3,7,5,0,3177,21739,24916
2017-03-18 08:00:00-04:00,0,3,8,5,0,3104,21430,24534
2017-03-18 09:00:00-04:00,0,3,9,5,0,2965,22617,25582
2017-03-18 10:00:00-04:00,0,3,10,5,0,2923,20982,23905
2017-03-18 11:00:00-04:00,0,3,11,5,0,2777,20364,23141
2017-03-18 12:00:00-04:00,0,3,12,5,0,2320,17618,19938
2017-03-18 13:00:00-04:00,0,3,13,5,0,1875,14297,16172
2017-03-18 14:00:00-04:00,0,3,14,5,0,1581,11418,12999
2017-03-18 15:00:00-04:00,0.0001,3,15,5,0,1312,7882,9194
2017-03-18 16:00:00-04:00,0.02,3,16,5,0,618,3748,4366
2017-03-18 17:00:00-04:00,0.02,3,17,5,0,455,4570,5025
2017-03-18 18:00:00-04:00,0.02,3,18,5,0,554,5537,6091
2017-03-18 19:00:00-04:00,0.01,3,19,5,0,899,8670,9569
2017-03-18 20:00:00-04:00,0,3,20,5,0,1273,12705,13978
2017-03-18 21:00:00-04:00,0,3,21,5,0,1460,14850,16310
2017-03-18 22:00:00-04:00,0,3,22,5,0,1783,17181,18964
2017-03-18 23:00:00-04:00,0,3,23,5,0,1870,18789,20659
2017-03-19 00:00:00-04:00,0,3,0,6,0,1900,19082,20982
2017-03-19 01:00:00-04:00,0,3,1,6,0,2093,17819,19912
2017-03-19 02:00:00-04:00,0,3,2,6,0,2566,19520,22086
2017-03-19 03:00:00-04:00,0,3,3,6,0,2758,17606,20364
2017-03-19 04:00:00-04:00,0,3,4,6,0,2806,19153,21959
2017-03-19 05:00:00-04:00,0,3,5,6,0,3210,22138,25348
2017-03-19 06:00:00-04:00,0,3,6,6,0,2921,21496,24417
2017-03-19 07:00:00-04:00,0,3,7,6,0,2832,17238,20070
2017-03-19 08:00:00-04:00,0,3,8,6,0,2689,16781,19470
2017-03-19 09:00:00-04:00,0,3,9,6,0,2694,18738,21432
2017-03-19 10:00:00-04:00,0,3,10,6,0,2829,18464,21293
2017-03-19 11:00:00-04:00,0,3,11,6,0,2554,17367,19921
2017-03-19 12:00:00-04:00,0,3,12,6,0,2259,16852,19111
2017-03-19 13:00:00-04:00,0,3,13,6,0,1892,13430,15322
2017-03-19 14:00:00-04:00,0,3,14,6,0,1498,10180,11678
2017-03-19 15:00:00-04:00,0,3,15,6,0,1185,7221,8406
2017-03-19 16:00:00-04:00,0,3,16,6,0,633,3340,3973
2017-03-19 17:00:00-04:00,0,3,17,6,0,474,4902,5376
2017-03-19 18:00:00-04:00,0,3,18,6,0,473,5277,5750
2017-03-19 19:00:00-04:00,0,3,19,6,0,570,6583,7153
2017-03-19 20:00:00-04:00,0,3,20,6,0,887,10506,11393
2017-03-19 21:00:00-04:00,0,3,21,6,0,1156,13474,14630
2017-03-19 22:00:00-04:00,0,3,22,6,0,1438,15312,16750
2017-03-19 23:00:00-04:00,0,3,23,6,0,1557,16146,17703
2017-03-20 00:00:00-04:00,0,3,0,0,0,1599,16314,17913
2017-03-20 01:00:00-04:00,0,3,1,0,0,1741,16315,18056
2017-03-20 02:00:00-04:00,0,3,2,0,0,1943,15746,17689
2017-03-20 03:00:00-04:00,0,3,3,0,0,1936,15566,17502
2017-03-20 04:00:00-04:00,0,3,4,0,0,2066,16434,18500
2017-03-20 05:00:00-04:00,0,3,5,0,0,2160,16309,18469
2017-03-20 06:00:00-04:00,0,3,6,0,0,1981,15455,17436
2017-03-20 07:00:00-04:00,0,3,7,0,0,1947,13949,15896
2017-03-20 08:00:00-04:00,0,3,8,0,0,1732,12773,14505
2017-03-20 09:00:00-04:00,0,3,9,0,0,1534,11667,13201
2017-03-20 10:00:00-04:00,0,3,10,0,0,1259,9862,11121
2017-03-20 11:00:00-04:00,0,3,11,0,0,953,5990,6943
2017-03-20 12:00:00-04:00,0,3,12,0,0,582,3458,4040
2017-03-20 13:00:00-04:00,0,3,13,0,0,358,2101,2459
2017-03-20 14:00:00-04:00,0,3,14,0,0,302,1625,1927
2017-03-20 15:00:00-04:00,0,3,15,0,0,292,2183,2475
2017-03-20 16:00:00-04:00,0,3,16,0,0,305,3666,3971
2017-03-20 17:00:00-04:00,0,3,17,0,0,463,9305,9768
2017-03-20 18:00:00-04:00,0,3,18,0,0,1291,14232,15523
2017-03-20 19:00:00-04:00,0,3,19,0,0,1760,16719,18479
2017-03-20 20:00:00-04:00,0,3,20,0,0,1617,15334,16951
2017-03-20 21:00:00-04:00,0,3,21,0,0,1358,13502,14860
2017-03-20 22:00:00-04:00,0,3,22,0,0,1288,13220,14508
2017-03-20 23:00:00-04:00,0,3,23,0,0,1338,14086,15424
2017-03-21 00:00:00-04:00,0,3,0,1,0,1266,13925,15191
2017-03-21 01:00:00-04:00,0,3,1,1,0,1487,14842,16329
2017-03-21 02:00:00-04:00,0,3,2,1,0,1575,14488,16063
2017-03-21 03:00:00-04:00,0,3,3,1,0,1795,13881,15676
2017-03-21 04:00:00-04:00,0,3,4,1,0,2117,16337,18454
2017-03-21 05:00:00-04:00,0,3,5,1,0,2331,18991,21322
2017-03-21 06:00:00-04:00,0,3,6,1,0,2107,18461,20568
2017-03-21 07:00:00-04:00,0,3,7,1,0,1854,17240,19094
2017-03-21 08:00:00-04:00,0,3,8,1,0,1492,16473,17965
2017-03-21 09:00:00-04:00,0,3,9,1,0,1287,14310,15597
2017-03-21 10:00:00-04:00,0,3,10,1,0,1100,10614,11714
2017-03-21 11:00:00-04:00,0,3,11,1,0,672,6416,7088
2017-03-21 12:00:00-04:00,0,3,12,1,0,452,3519,3971
2017-03-21 13:00:00-04:00,0,3,13,1,0,257,2290,2547
2017-03-21 14:00:00-04:00,0,3,14,1,0,198,1508,1706
2017-03-21 15:00:00-04:00,0,3,15,1,0,230,1636,1866
2017-03-21 16:00:00-04:00,0,3,16,1,0,217,3276,3493
2017-03-21 17:00:00-04:00,0,3,17,1,0,439,8853,9292
2017-03-21 18:00:00-04:00,0,3,18,1,0,1145,14647,15792
2017-03-21 19:00:00-04:00,0,3,19,1,0,1760,17686,19446
2017-03-21 20:00:00-04:00,0,3,20,1,0,1687,16761,18448
2017-03-21 21:00:00-04:00,0,3,21,1,0,1441,14678,16119
2017-03-21 22:00:00-04:00,0,3,22,1,0,1329,14035,15364
2017-03-21 23:00:00-04:00,0,3,23,1,0,1312,14784,16096
2017-03-22 00:00:00-04:00,0,3,0,2,0,1268,14650,15918
2017-03-22 01:00:00-04:00,0,3,1,2,0,1509,15797,17306
2017-03-22 02:00:00-04:00,0,3,2,2,0,1695,15323,17018
2017-03-22 03:00:00-04:00,0,3,3,2,0,1859,13828,15687
2017-03-22 04:00:00-04:00,0,3,4,2,0,2176,16614,18790
2017-03-22 05:00:00-04:00,0,3,5,2,0,2383,20140,22523
2017-03-22 06:00:00-04:00,0,3,6,2,0,2402,20015,22417
2017-03-22 07:00:00-04:00,0,3,7,2,0,2041,19454,21495
2017-03-22 08:00:00-04:00,0,3,8,2,0,1864,19435,21299
2017-03-22 09:00:00-04:00,0,3,9,2,0,1480,17626,19106
2017-03-22 10:00:00-04:00,0,3,10,2,0,1274,12229,13503
2017-03-22 11:00:00-04:00,0,3,11,2,0,875,8424,9299
2017-03-22 12:00:00-04:00,0,3,12,2,0,571,4491,5062
2017-03-22 13:00:00-04:00,0,3,13,2,0,322,2671,2993
2017-03-22 14:00:00-04:00,0,3,14,2,0,236,1907,2143
2017-03-22 15:00:00-04:00,0,3,15,2,0,225,1944,2169
2017-03-22 16:00:00-04:00,0,3,16,2,0,201,3366,3567
2017-03-22 17:00:00-04:00,0,3,17,2,0,433,8894,9327
2017-03-22 18:00:00-04:00,0,3,18,2,0,1187,15100,16287
2017-03-22 19:00:00-04:00,0,3,19,2,0,1893,18759,20652
2017-03-22 20:00:00-04:00,0,3,20,2,0,1791,17813,19604
2017-03-22 21:00:00-04:00,0,3,21,2,0,1568,15631,17199
2017-03-22 22:00:00-04:00,0,3,22,2,0,1452,16151,17603
2017-03-22 23:00:00-04:00,0,3,23,2,0,1487,16922,18409
2017-03-23 00:00:00-04:00,0,3,0,3,0,1576,17396,18972
2017-03-23 01:00:00-04:00,0,3,1,3,0,1728,17800,19528
2017-03-23 02:00:00-04:00,0,3,2,3,0,1979,17659,19638
2017-03-23 03:00:00-04:00,0,3,3,3,0,2106,16023,18129
2017-03-23 04:00:00-04:00,0,3,4,3,0,2734,18616,21350
2017-03-23 05:00:00-04:00,0,3,5,3,0,3032,22387,25419
2017-03-23 06:00:00-04:00,0,3,6,3,0,3016,23277,26293
2017-03-23 07:00:00-04:00,0,3,7,3,0,2643,22857,25500
2017-03-23 08:00:00-04:00,0,3,8,3,0,2436,22745,25181
2017-03-23 09:00:00-04:00,0,3,9,3,0,1888,21182,23070
2017-03-23 10:00:00-04:00,0,3,10,3,0,1497,15360,16857
2017-03-23 11:00:00-04:00,0,3,11,3,0,985,9710,10695
2017-03-23 12:00:00-04:00,0,3,12,3,0,643,5420,6063
2017-03-23 13:00:00-04:00,0,3,13,3,0,362,3102,3464
2017-03-23 14:00:00-04:00,0,3,14,3,0,256,2078,2334
2017-03-23 15:00:00-04:00,0,3,15,3,0,246,1924,2170
2017-03-23 16:00:00-04:00,0,3,16,3,0,241,3558,3799
2017-03-23 17:00:00-04:00,0,3,17,3,0,467,9229,9696
2017-03-23 18:00:00-04:00,0,3,18,3,0,1234,15704,16938
2017-03-23 19:00:00-04:00,0,3,19,3,0,1905,19197,21102
2017-03-23 20:00:00-04:00,0,3,20,3,0,1794,18026,19820
2017-03-23 21:00:00-04:00,0,3,21,3,0,1597,15753,17350
2017-03-23 22:00:00-04:00,0,3,22,3,0,1491,15498,16989
2017-03-23 23:00:00-04:00,0,3,23,3,0,1445,16782,18227
2017-03-24 00:00:00-04:00,0,3,0,4,0,1431,16383,17814
2017-03-24 01:00:00-04:00,0,3,1,4,0,1668,17433,19101
2017-03-24 02:00:00-04:00,0,3,2,4,0,1819,16585,18404
2017-03-24 03:00:00-04:00,0,3,3,4,0,2088,14732,16820
2017-03-24 04:00:00-04:00,0,3,4,4,0,2380,18200,20580
2017-03-24 05:00:00-04:00,0,3,5,4,0,2649,21618,24267
2017-03-24 06:00:00-04:00,0,3,6,4,0,2669,21993,24662
2017-03-24 07:00:00-04:00,0,3,7,4,0,2511,21509,24020
2017-03-24 08:00:00-04:00,0,3,8,4,0,2247,22238,24485
2017-03-24 09:00:00-04:00,0,3,9,4,0,1941,21633,23574
2017-03-24 10:00:00-04:00,0,3,10,4,0,1630,17596,19226
2017-03-24 11:00:00-04:00,0,3,11,4,0,1247,12255,13502
2017-03-24 12:00:00-04:00,0,3,12,4,0,891,7983,8874
2017-03-24 13:00:00-04:00,0,3,13,4,0,563,5243,5806
2017-03-24 14:00:00-04:00,0,3,14,4,0,393,3446,3839
2017-03-24 15:00:00-04:00,0,3,15,4,0,339,2857,3196
2017-03-24 16:00:00-04:00,0,3,16,4,0,287,3738,4025
2017-03-24 17:00:00-04:00,0,3,17,4,0,513,8939,9452
2017-03-24 18:00:00-04:00,0,3,18,4,0,1226,14625,15851
2017-03-24 19:00:00-04:00,0,3,19,4,0,1917,17652,19569
2017-03-24 20:00:00-04:00,0,3,20,4,0,1796,16475,18271
2017-03-24 21:00:00-04:00,0,3,21,4,0,1578,14702,16280
2017-03-24 22:00:00-04:00,0,3,22,4,0,1545,15321,16866
2017-03-24 23:00:00-04:00,0,3,23,4,0,1480,16658,18138
2017-03-25 00:00:00-04:00,0,3,0,5,0,1427,17145,18572
2017-03-25 01:00:00-04:00,0,3,1,5,0,1833,17353,19186
2017-03-25 02:00:00-04:00,0,3,2,5,0,1997,16027,18024
2017-03-25 03:00:00-04:00,0,3,3,5,0,2087,14172,16259
2017-03-25 04:00:00-04:00,0,3,4,5,0,2592,17536,20128
2017-03-25 05:00:00-04:00,0,3,5,5,0,2957,20413,23370
2017-03-25 06:00:00-04:00,0,3,6,5,0,3058,21541,24599
2017-03-25 07:00:00-04:00,0,3,7,5,0,2776,19041,21817
2017-03-25 08:00:00-04:00,0,3,8,5,0,2503,18843,21346
2017-03-25 09:00:00-04:00,0,3,9,5,0,2627,19845,22472
2017-03-25 10:00:00-04:00,0,3,10,5,0,2490,19315,21805
2017-03-25 11:00:00-04:00,0,3,11,5,0,2370,18186,20556
2017-03-25 12:00:00-04:00,0,3,12,5,0,2084,16625,18709
2017-03-25 13:00:00-04:00,0,3,13,5,0,1772,12941,14713
2017-03-25 14:00:00-04:00,0,3,14,5,0,1394,9704,11098
2017-03-25 15:00:00-04:00,0,3,15,5,0,1066,6290,7356
2017-03-25 16:00:00-04:00,0,3,16,5,0,527,2935,3462
2017-03-25 17:00:00-04:00,0,3,17,5,0,464,4019,4483
2017-03-25 18:00:00-04:00,0,3,18,5,0,593,5403,5996
2017-03-25 19:00:00-04:00,0,3,19,5,0,871,8411,9282
2017-03-25 20:00:00-04:00,0,3,20,5,0,1217,11373,12590
2017-03-25 21:00:00-04:00,0,3,21,5,0,1400,13405,14805
2017-03-25 22:00:00-04:00,0,3,22,5,0,1577,14974,16551
2017-03-25 23:00:00-04:00,0,3,23,5,0,1716,16685,18401
2017-03-26 00:00:00-04:00,0,3,0,6,0,1808,17013,18821
2017-03-26 01:00:00-04:00,0,3,1,6,0,2027,16549,18576
2017-03-26 02:00:00-04:00,0,3,2,6,0,2284,18358,20642
2017-03-26 03:00:00-04:00,0.06,3,3,6,0,2422,16725,19147
2017-03-26 04:00:00-04:00,0.04,3,4,6,0,2441,18214,20655
2017-03-26 05:00:00-04:00,0,3,5,6,0,2757,19835,22592
2017-03-26 06:00:00-04:00,0,3,6,6,0,2758,22142,24900
2017-03-26 07:00:00-04:00,0,3,7,6,0,2810,17769,20579
2017-03-26 08:00:00-04:00,0,3,8,6,0,2705,17625,20330
2017-03-26 09:00:00-04:00,0,3,9,6,0,2823,19999,22822
2017-03-26 10:00:00-04:00,0,3,10,6,0,2929,21625,24554
2017-03-26 11:00:00-04:00,0,3,11,6,0,2819,20051,22870
2017-03-26 12:00:00-04:00,0,3,12,6,0,2457,18326,20783
2017-03-26 13:00:00-04:00,0,3,13,6,0,2149,15795,17944
2017-03-26 14:00:00-04:00,0,3,14,6,0,1927,12263,14190
2017-03-26 15:00:00-04:00,0,3,15,6,0,1334,7199,8533
2017-03-26 16:00:00-04:00,0,3,16,6,0,609,2885,3494
2017-03-26 17:00:00-04:00,0,3,17,6,0,393,3281,3674
2017-03-26 18:00:00-04:00,0,3,18,6,0,406,4134,4540
2017-03-26 19:00:00-04:00,0,3,19,6,0,579,6180,6759
2017-03-26 20:00:00-04:00,0,3,20,6,0,919,9712,10631
2017-03-26 21:00:00-04:00,0,3,21,6,0,1171,13325,14496
2017-03-26 22:00:00-04:00,0,3,22,6,0,1422,15417,16839
2017-03-26 23:00:00-04:00,0.01,3,23,6,0,1672,17264,18936
2017-03-27 00:00:00-04:00,0.01,3,0,0,0,1685,17641,19326
2017-03-27 01:00:00-04:00,0,3,1,0,0,1859,16586,18445
2017-03-27 02:00:00-04:00,0,3,2,0,0,1930,15632,17562
2017-03-27 03:00:00-04:00,0,3,3,0,0,1960,15224,17184
2017-03-27 04:00:00-04:00,0,3,4,0,0,2030,15980,18010
2017-03-27 05:00:00-04:00,0,3,5,0,0,2107,15701,17808
2017-03-27 06:00:00-04:00,0,3,6,0,0,1835,14564,16399
2017-03-27 07:00:00-04:00,0,3,7,0,0,1891,14187,16078
2017-03-27 08:00:00-04:00,0.01,3,8,0,0,1585,13080,14665
2017-03-27 09:00:00-04:00,0.14,3,9,0,0,1424,10899,12323
2017-03-27 10:00:00-04:00,0.05,3,10,0,0,1141,8506,9647
2017-03-27 11:00:00-04:00,0,3,11,0,0,844,5516,6360
2017-03-27 12:00:00-04:00,0,3,12,0,0,493,3814,4307
2017-03-27 13:00:00-04:00,0,3,13,0,0,370,2352,2722
2017-03-27 14:00:00-04:00,0,3,14,0,0,274,1576,1850
2017-03-27 15:00:00-04:00,0,3,15,0,0,252,1949,2201
2017-03-27 16:00:00-04:00,0,3,16,0,0,232,3638,3870
2017-03-27 17:00:00-04:00,0,3,17,0,0,467,9172,9639
2017-03-27 18:00:00-04:00,0,3,18,0,0,1362,14784,16146
2017-03-27 19:00:00-04:00,0,3,19,0,0,2093,18352,20445
2017-03-27 20:00:00-04:00,0,3,20,0,0,1982,18165,20147
2017-03-27 21:00:00-04:00,0,3,21,0,0,1604,14906,16510
2017-03-27 22:00:00-04:00,0,3,22,0,0,1261,13366,14627
2017-03-27 23:00:00-04:00,0,3,23,0,0,1208,13536,14744
2017-03-28 00:00:00-04:00,0,3,0,1,0,1205,13356,14561
2017-03-28 01:00:00-04:00,0.03,3,1,1,0,1381,14529,15910
2017-03-28 02:00:00-04:00,0.01,3,2,1,0,1622,14534,16156
2017-03-28 03:00:00-04:00,0,3,3,1,0,1724,13999,15723
2017-03-28 04:00:00-04:00,0.01,3,4,1,0,2042,15773,17815
2017-03-28 05:00:00-04:00,0.17,3,5,1,0,2155,18394,20549
2017-03-28 06:00:00-04:00,0,3,6,1,0,2007,17626,19633
2017-03-28 07:00:00-04:00,0,3,7,1,0,1818,16637,18455
2017-03-28 08:00:00-04:00,0,3,8,1,0,1523,16212,17735
2017-03-28 09:00:00-04:00,0,3,9,1,0,1299,14007,15306
2017-03-28 10:00:00-04:00,0,3,10,1,0,975,9775,10750
2017-03-28 11:00:00-04:00,0.04,3,11,1,0,712,6271,6983
2017-03-28 12:00:00-04:00,0.03,3,12,1,0,486,3426,3912
2017-03-28 13:00:00-04:00,0.05,3,13,1,0,338,2217,2555
2017-03-28 14:00:00-04:00,0.07,3,14,1,0,208,1450,1658
2017-03-28 15:00:00-04:00,0.01,3,15,1,0,189,1643,1832
2017-03-28 16:00:00-04:00,0,3,16,1,0,210,3317,3527
2017-03-28 17:00:00-04:00,0,3,17,1,0,495,9483,9978
2017-03-28 18:00:00-04:00,0.01,3,18,1,0,1228,14909,16137
2017-03-28 19:00:00-04:00,0.11,3,19,1,0,1770,18183,19953
2017-03-28 20:00:00-04:00,0.07,3,20,1,0,1728,16571,18299
2017-03-28 21:00:00-04:00,0.03,3,21,1,0,1500,15268,16768
2017-03-28 22:00:00-04:00,0.01,3,22,1,0,1631,17246,18877
2017-03-28 23:00:00-04:00,0,3,23,1,0,1516,16990,18506
2017-03-29 00:00:00-04:00,0,3,0,2,0,1443,17105,18548
2017-03-29 01:00:00-04:00,0,3,1,2,0,1788,18475,20263
2017-03-29 02:00:00-04:00,0,3,2,2,0,1788,15893,17681
2017-03-29 03:00:00-04:00,0,3,3,2,0,1853,14959,16812
2017-03-29 04:00:00-04:00,0,3,4,2,0,2294,18430,20724
2017-03-29 05:00:00-04:00,0,3,5,2,0,2838,23869,26707
2017-03-29 06:00:00-04:00,0,3,6,2,0,2958,25089,28047
2017-03-29 07:00:00-04:00,0,3,7,2,0,2415,21748,24163
2017-03-29 08:00:00-04:00,0,3,8,2,0,1902,20929,22831
2017-03-29 09:00:00-04:00,0,3,9,2,0,1626,17541,19167
2017-03-29 10:00:00-04:00,0,3,10,2,0,1160,12122,13282
2017-03-29 11:00:00-04:00,0,3,11,2,0,842,7438,8280
2017-03-29 12:00:00-04:00,0,3,12,2,0,451,4243,4694
2017-03-29 13:00:00-04:00,0,3,13,2,0,278,2618,2896
2017-03-29 14:00:00-04:00,0,3,14,2,0,206,1724,1930
2017-03-29 15:00:00-04:00,0,3,15,2,0,222,1786,2008
2017-03-29 16:00:00-04:00,0,3,16,2,0,194,3357,3551
2017-03-29 17:00:00-04:00,0,3,17,2,0,453,8902,9355
2017-03-29 18:00:00-04:00,0,3,18,2,0,1166,15334,16500
2017-03-29 19:00:00-04:00,0,3,19,2,0,1789,18498,20287
2017-03-29 20:00:00-04:00,0,3,20,2,0,1789,17377,19166
2017-03-29 21:00:00-04:00,0,3,21,2,0,1535,15478,17013
2017-03-29 22:00:00-04:00,0,3,22,2,0,1333,15456,16789
2017-03-29 23:00:00-04:00,0,3,23,2,0,1333,15846,17179
2017-03-30 00:00:00-04:00,0,3,0,3,0,1317,16045,17362
2017-03-30 01:00:00-04:00,0,3,1,3,0,1462,16733,18195
2017-03-30 02:00:00-04:00,0,3,2,3,0,1750,15784,17534
2017-03-30 03:00:00-04:00,0,3,3,3,0,1854,14475,16329
2017-03-30 04:00:00-04:00,0,3,4,3,0,2214,17668,19882
2017-03-30 05:00:00-04:00,0,3,5,3,0,2524,21517,24041
2017-03-30 06:00:00-04:00,0,3,6,3,0,2413,21906,24319
2017-03-30 07:00:00-04:00,0,3,7,3,0,2215,21470,23685
2017-03-30 08:00:00-04:00,0,3,8,3,0,2039,22151,24190
2017-03-30 09:00:00-04:00,0,3,9,3,0,1937,20524,22461
2017-03-30 10:00:00-04:00,0,3,10,3,0,1587,15332,16919
2017-03-30 11:00:00-04:00,0,3,11,3,0,1157,9652,10809
2017-03-30 12:00:00-04:00,0,3,12,3,0,718,5454,6172
2017-03-30 13:00:00-04:00,0,3,13,3,0,416,3473,3889
2017-03-30 14:00:00-04:00,0,3,14,3,0,314,2308,2622
2017-03-30 15:00:00-04:00,0,3,15,3,0,269,2233,2502
2017-03-30 16:00:00-04:00,0,3,16,3,0,217,3516,3733
2017-03-30 17:00:00-04:00,0,3,17,3,0,515,9466,9981
2017-03-30 18:00:00-04:00,0,3,18,3,0,1243,15134,16377
2017-03-30 19:00:00-04:00,0,3,19,3,0,1940,19249,21189
2017-03-30 20:00:00-04:00,0,3,20,3,0,1854,17773,19627
2017-03-30 21:00:00-04:00,0,3,21,3,0,1579,15741,17320
2017-03-30 22:00:00-04:00,0,3,22,3,0,1442,16077,17519
2017-03-30 23:00:00-04:00,0,3,23,3,0,1466,16711,18177
2017-03-31 00:00:00-04:00,0,3,0,4,0,1403,16250,17653
2017-03-31 01:00:00-04:00,0.02,3,1,4,0,1619,17666,19285
2017-03-31 02:00:00-04:00,0.06,3,2,4,0,1812,17074,18886
2017-03-31 03:00:00-04:00,0.12,3,3,4,0,2095,15185,17280
2017-03-31 04:00:00-04:00,0.12,3,4,4,0,2557,18547,21104
2017-03-31 05:00:00-04:00,0,3,5,4,0,2833,22543,25376
2017-03-31 06:00:00-04:00,0,3,6,4,0,2661,23612,26273
2017-03-31 07:00:00-04:00,0.01,3,7,4,0,2345,22596,24941
2017-03-31 08:00:00-04:00,0.04,3,8,4,0,2240,23039,25279
2017-03-31 09:00:00-04:00,0.02,3,9,4,0,2032,20949,22981
2017-03-31 10:00:00-04:00,0.06,3,10,4,0,1683,17884,19567
2017-03-31 11:00:00-04:00,0.05,3,11,4,0,1316,12643,13959
2017-03-31 12:00:00-04:00,0.11,3,12,4,0,945,8314,9259
2017-03-31 13:00:00-04:00,0.07,3,13,4,0,641,5364,6005
2017-03-31 14:00:00-04:00,0.08,3,14,4,0,425,3680,4105
2017-03-31 15:00:00-04:00,0.09,3,15,4,0,372,3117,3489
2017-03-31 16:00:00-04:00,0.15,3,16,4,0,257,4130,4387
2017-03-31 17:00:00-04:00,0.12,3,17,4,0,510,9789,10299
2017-03-31 18:00:00-04:00,0.3,3,18,4,0,1309,16384,17693
2017-03-31 19:00:00-04:00,0.22,3,19,4,0,2037,20550,22587
2017-03-31 20:00:00-04:00,0.2,3,20,4,0,2031,19166,21197
2017-03-31 21:00:00-04:00,0.18,3,21,4,0,1876,17302,19178
2017-03-31 22:00:00-04:00,0.07,3,22,4,0,1813,18208,20021
2017-03-31 23:00:00-04:00,0.01,3,23,4,0,1741,18353,20094
2017-04-01 00:00:00-04:00,0,4,0,5,0,1586,18095,19681
2017-04-01 01:00:00-04:00,0,4,1,5,0,2014,19854,21868
2017-04-01 02:00:00-04:00,0,4,2,5,0,2452,18505,20957
2017-04-01 03:00:00-04:00,0,4,3,5,0,2828,15893,18721
2017-04-01 04:00:00-04:00,0.01,4,4,5,0,3457,19749,23206
2017-04-01 05:00:00-04:00,0,4,5,5,0,3968,23225,27193
2017-04-01 06:00:00-04:00,0,4,6,5,0,3617,23626,27243
2017-04-01 07:00:00-04:00,0,4,7,5,0,3356,21784,25140
2017-04-01 08:00:00-04:00,0,4,8,5,0,2924,20109,23033
2017-04-01 09:00:00-04:00,0,4,9,5,0,2665,21021,23686
2017-04-01 10:00:00-04:00,0,4,10,5,0,2344,19692,22036
2017-04-01 11:00:00-04:00,0,4,11,5,0,2139,17470,19609
2017-04-01 12:00:00-04:00,0,4,12,5,0,1840,14505,16345
2017-04-01 13:00:00-04:00,0,4,13,5,0,1428,11518,12946
2017-04-01 14:00:00-04:00,0,4,14,5,0,1155,8527,9682
2017-04-01 15:00:00-04:00,0,4,15,5,0,841,5721,6562
2017-04-01 16:00:00-04:00,0,4,16,5,0,423,2818,3241
2017-04-01 17:00:00-04:00,0,4,17,5,0,437,4054,4491
2017-04-01 18:00:00-04:00,0,4,18,5,0,606,5904,6510
2017-04-01 19:00:00-04:00,0,4,19,5,0,918,9746,10664
2017-04-01 20:00:00-04:00,0,4,20,5,0,1288,13109,14397
2017-04-01 21:00:00-04:00,0,4,21,5,0,1431,15310,16741
2017-04-01 22:00:00-04:00,0,4,22,5,0,1722,16885,18607
2017-04-01 23:00:00-04:00,0,4,23,5,0,1914,18623,20537
2017-04-02 00:00:00-04:00,0,4,0,6,0,1904,19384,21288
2017-04-02 01:00:00-04:00,0,4,1,6,0,2149,18202,20351
2017-04-02 02:00:00-04:00,0,4,2,6,0,2194,17992,20186
2017-04-02 03:00:00-04:00,0,4,3,6,0,2317,17007,19324
2017-04-02 04:00:00-04:00,0,4,4,6,0,2537,19410,21947
2017-04-02 05:00:00-04:00,0,4,5,6,0,2789,20722,23511
2017-04-02 06:00:00-04:00,0,4,6,6,0,2753,21051,23804
2017-04-02 07:00:00-04:00,0,4,7,6,0,2762,18564,21326
2017-04-02 08:00:00-04:00,0,4,8,6,0,2683,17503,20186
2017-04-02 09:00:00-04:00,0,4,9,6,0,2841,20339,23180
2017-04-02 10:00:00-04:00,0,4,10,6,0,2971,21451,24422
2017-04-02 11:00:00-04:00,0,4,11,6,0,2832,19702,22534
2017-04-02 12:00:00-04:00,0,4,12,6,0,2477,17435,19912
2017-04-02 13:00:00-04:00,0,4,13,6,0,2204,15375,17579
2017-04-02 14:00:00-04:00,0,4,14,6,0,1704,11867,13571
2017-04-02 15:00:00-04:00,0,4,15,6,0,1246,7553,8799
2017-04-02 16:00:00-04:00,0,4,16,6,0,623,3239,3862
2017-04-02 17:00:00-04:00,0,4,17,6,0,456,3505,3961
2017-04-02 18:00:00-04:00,0,4,18,6,0,522,4743,5265
2017-04-02 19:00:00-04:00,0,4,19,6,0,584,7288,7872
2017-04-02 20:00:00-04:00,0,4,20,6,0,888,10827,11715
2017-04-02 21:00:00-04:00,0,4,21,6,0,1180,14347,15527
2017-04-02 22:00:00-04:00,0,4,22,6,0,1429,15684,17113
2017-04-02 23:00:00-04:00,0,4,23,6,0,1536,17413,18949
2017-04-03 00:00:00-04:00,0,4,0,0,0,1585,17107,18692
2017-04-03 01:00:00-04:00,0,4,1,0,0,1762,17610,19372
2017-04-03 02:00:00-04:00,0,4,2,0,0,1973,17100,19073
2017-04-03 03:00:00-04:00,0,4,3,0,0,2151,16527,18678
2017-04-03 04:00:00-04:00,0,4,4,0,0,2075,16748,18823
2017-04-03 05:00:00-04:00,0,4,5,0,0,2128,16733,18861
2017-04-03 06:00:00-04:00,0,4,6,0,0,1893,15229,17122
2017-04-03 07:00:00-04:00,0,4,7,0,0,2003,14002,16005
2017-04-03 08:00:00-04:00,0,4,8,0,0,1639,12943,14582
2017-04-03 09:00:00-04:00,0,4,9,0,0,1539,11449,12988
2017-04-03 10:00:00-04:00,0,4,10,0,0,1238,8475,9713
2017-04-03 11:00:00-04:00,0,4,11,0,0,944,5633,6577
2017-04-03 12:00:00-04:00,0,4,12,0,0,626,3311,3937
2017-04-03 13:00:00-04:00,0,4,13,0,0,401,2145,2546
2017-04-03 14:00:00-04:00,0,4,14,0,0,276,1421,1697
2017-04-03 15:00:00-04:00,0,4,15,0,0,301,2102,2403
2017-04-03 16:00:00-04:00,0,4,16,0,0,244,3733,3977
2017-04-03 17:00:00-04:00,0,4,17,0,0,518,9321,9839
2017-04-03 18:00:00-04:00,0,4,18,0,0,1217,15343,16560
2017-04-03 19:00:00-04:00,0,4,19,0,0,1782,17743,19525
2017-04-03 20:00:00-04:00,0,4,20,0,0,1692,15742,17434
2017-04-03 21:00:00-04:00,0,4,21,0,0,1470,13862,15332
2017-04-03 22:00:00-04:00,0,4,22,0,0,1336,13850,15186
2017-04-03 23:00:00-04:00,0,4,23,0,0,1331,14259,15590
2017-04-04 00:00:00-04:00,0.02,4,0,1,0,1277,14478,15755
2017-04-04 01:00:00-04:00,0.09,4,1,1,0,1517,15989,17506
2017-04-04 02:00:00-04:00,0.36,4,2,1,0,1658,16721,18379
2017-04-04 03:00:00-04:00,0.91,4,3,1,0,1774,15344,17118
2017-04-04 04:00:00-04:00,0.2,4,4,1,0,2293,18471,20764
2017-04-04 05:00:00-04:00,0.01,4,5,1,0,2524,21201,23725
2017-04-04 06:00:00-04:00,0,4,6,1,0,2209,20013,22222
2017-04-04 07:00:00-04:00,0.01,4,7,1,0,1916,19112,21028
2017-04-04 08:00:00-04:00,0,4,8,1,0,1535,17559,19094
2017-04-04 09:00:00-04:00,0,4,9,1,0,1228,14598,15826
2017-04-04 10:00:00-04:00,0.01,4,10,1,0,1135,12119,13254
2017-04-04 11:00:00-04:00,0,4,11,1,0,871,7656,8527
2017-04-04 12:00:00-04:00,0,4,12,1,0,595,4028,4623
2017-04-04 13:00:00-04:00,0,4,13,1,0,339,2378,2717
2017-04-04 14:00:00-04:00,0,4,14,1,0,184,1534,1718
2017-04-04 15:00:00-04:00,0.02,4,15,1,0,224,1670,1894
2017-04-04 16:00:00-04:00,0,4,16,1,0,220,3229,3449
2017-04-04 17:00:00-04:00,0,4,17,1,0,499,9627,10126
2017-04-04 18:00:00-04:00,0,4,18,1,0,1263,17071,18334
2017-04-04 19:00:00-04:00,0,4,19,1,0,1926,20175,22101
2017-04-04 20:00:00-04:00,0,4,20,1,0,1731,18176,19907
2017-04-04 21:00:00-04:00,0,4,21,1,0,1520,16320,17840
2017-04-04 22:00:00-04:00,0,4,22,1,0,1492,15950,17442
2017-04-04 23:00:00-04:00,0,4,23,1,0,1491,16173,17664
2017-04-05 00:00:00-04:00,0,4,0,2,0,1412,16201,17613
2017-04-05 01:00:00-04:00,0,4,1,2,0,1598,17995,19593
2017-04-05 02:00:00-04:00,0,4,2,2,0,1878,18932,20810
2017-04-05 03:00:00-04:00,0,4,3,2,0,1900,15423,17323
2017-04-05 04:00:00-04:00,0,4,4,2,0,2144,18520,20664
2017-04-05 05:00:00-04:00,0,4,5,2,0,2472,22262,24734
2017-04-05 06:00:00-04:00,0,4,6,2,0,2223,21176,23399
2017-04-05 07:00:00-04:00,0,4,7,2,0,1983,20508,22491
2017-04-05 08:00:00-04:00,0,4,8,2,0,1814,20790,22604
2017-04-05 09:00:00-04:00,0,4,9,2,0,1538,18244,19782
2017-04-05 10:00:00-04:00,0,4,10,2,0,1278,12133,13411
2017-04-05 11:00:00-04:00,0,4,11,2,0,904,7700,8604
2017-04-05 12:00:00-04:00,0,4,12,2,0,513,4183,4696
2017-04-05 13:00:00-04:00,0,4,13,2,0,307,2578,2885
2017-04-05 14:00:00-04:00,0,4,14,2,0,211,1654,1865
2017-04-05 15:00:00-04:00,0,4,15,2,0,217,1969,2186
2017-04-05 16:00:00-04:00,0,4,16,2,0,221,3414,3635
2017-04-05 17:00:00-04:00,0,4,17,2,0,474,9115,9589
2017-04-05 18:00:00-04:00,0,4,18,2,0,1197,16819,18016
2017-04-05 19:00:00-04:00,0,4,19,2,0,1802,19882,21684
2017-04-05 20:00:00-04:00,0,4,20,2,0,1705,17733,19438
2017-04-05 21:00:00-04:00,0,4,21,2,0,1588,16158,17746
2017-04-05 22:00:00-04:00,0,4,22,2,0,1427,16538,17965
2017-04-05 23:00:00-04:00,0,4,23,2,0,1454,17443,18897
2017-04-06 00:00:00-04:00,0,4,0,3,0,1422,17091,18513
2017-04-06 01:00:00-04:00,0,4,1,3,0,1571,17536,19107
2017-04-06 02:00:00-04:00,0,4,2,3,0,1774,17478,19252
2017-04-06 03:00:00-04:00,0,4,3,3,0,1895,15381,17276
2017-04-06 04:00:00-04:00,0,4,4,3,0,2258,18825,21083
2017-04-06 05:00:00-04:00,0,4,5,3,0,2639,22615,25254
2017-04-06 06:00:00-04:00,0.02,4,6,3,0,2515,23443,25958
2017-04-06 07:00:00-04:00,0,4,7,3,0,2383,22959,25342
2017-04-06 08:00:00-04:00,0.02,4,8,3,0,2093,22740,24833
2017-04-06 09:00:00-04:00,0.01,4,9,3,0,1899,21368,23267
2017-04-06 10:00:00-04:00,0.03,4,10,3,0,1626,15844,17470
2017-04-06 11:00:00-04:00,0.04,4,11,3,0,1109,9746,10855
2017-04-06 12:00:00-04:00,0.06,4,12,3,0,744,5389,6133
2017-04-06 13:00:00-04:00,0.01,4,13,3,0,425,3313,3738
2017-04-06 14:00:00-04:00,0,4,14,3,0,290,2227,2517
2017-04-06 15:00:00-04:00,0.08,4,15,3,0,257,2225,2482
2017-04-06 16:00:00-04:00,0.45,4,16,3,0,234,3835,4069
2017-04-06 17:00:00-04:00,0.13,4,17,3,0,517,10451,10968
2017-04-06 18:00:00-04:00,0,4,18,3,0,1320,18908,20228
2017-04-06 19:00:00-04:00,0,4,19,3,0,2101,22458,24559
2017-04-06 20:00:00-04:00,0,4,20,3,0,2022,19923,21945
2017-04-06 21:00:00-04:00,0,4,21,3,0,1797,18295,20092
2017-04-06 22:00:00-04:00,0,4,22,3,0,1760,18089,19849
2017-04-06 23:00:00-04:00,0,4,23,3,0,1732,18581,20313
2017-04-07 00:00:00-04:00,0,4,0,4,0,1601,17959,19560
2017-04-07 01:00:00-04:00,0,4,1,4,0,1776,18764,20540
2017-04-07 02:00:00-04:00,0,4,2,4,0,2385,19148,21533
2017-04-07 03:00:00-04:00,0,4,3,4,0,2930,15517,18447
2017-04-07 04:00:00-04:00,0,4,4,4,0,2454,17042,19496
2017-04-07 05:00:00-04:00,0,4,5,4,0,2474,20121,22595
2017-04-07 06:00:00-04:00,0,4,6,4,0,2428,21006,23434
2017-04-07 07:00:00-04:00,0,4,7,4,0,2242,21447,23689
2017-04-07 08:00:00-04:00,0,4,8,4,0,2033,21467,23500
2017-04-07 09:00:00-04:00,0,4,9,4,0,1802,20729,22531
2017-04-07 10:00:00-04:00,0,4,10,4,0,1612,16832,18444
2017-04-07 11:00:00-04:00,0,4,11,4,0,1303,11884,13187
2017-04-07 12:00:00-04:00,0,4,12,4,0,914,7852,8766
2017-04-07 13:00:00-04:00,0,4,13,4,0,555,5459,6014
2017-04-07 14:00:00-04:00,0,4,14,4,0,373,3623,3996
2017-04-07 15:00:00-04:00,0,4,15,4,0,359,2970,3329
2017-04-07 16:00:00-04:00,0,4,16,4,0,283,3761,4044
2017-04-07 17:00:00-04:00,0,4,17,4,0,505,9139,9644
2017-04-07 18:00:00-04:00,0,4,18,4,0,1336,16654,17990
2017-04-07 19:00:00-04:00,0,4,19,4,0,2003,19847,21850
2017-04-07 20:00:00-04:00,0,4,20,4,0,1915,18530,20445
2017-04-07 21:00:00-04:00,0,4,21,4,0,1726,17123,18849
2017-04-07 22:00:00-04:00,0,4,22,4,0,1656,17320,18976
2017-04-07 23:00:00-04:00,0,4,23,4,0,1635,18428,20063
2017-04-08 00:00:00-04:00,0,4,0,5,0,1417,17688,19105
2017-04-08 01:00:00-04:00,0,4,1,5,0,1771,19914,21685
2017-04-08 02:00:00-04:00,0,4,2,5,0,2253,19177,21430
2017-04-08 03:00:00-04:00,0,4,3,5,0,2413,16572,18985
2017-04-08 04:00:00-04:00,0,4,4,5,0,2759,20499,23258
2017-04-08 05:00:00-04:00,0,4,5,5,0,3257,24343,27600
2017-04-08 06:00:00-04:00,0,4,6,5,0,3124,25435,28559
2017-04-08 07:00:00-04:00,0,4,7,5,0,3056,22386,25442
2017-04-08 08:00:00-04:00,0,4,8,5,0,2912,21506,24418
2017-04-08 09:00:00-04:00,0,4,9,5,0,2797,21800,24597
2017-04-08 10:00:00-04:00,0,4,10,5,0,2813,21235,24048
2017-04-08 11:00:00-04:00,0,4,11,5,0,2680,18887,21567
2017-04-08 12:00:00-04:00,0,4,12,5,0,2197,15817,18014
2017-04-08 13:00:00-04:00,0,4,13,5,0,1728,13095,14823
2017-04-08 14:00:00-04:00,0,4,14,5,0,1384,9678,11062
2017-04-08 15:00:00-04:00,0,4,15,5,0,1087,6031,7118
2017-04-08 16:00:00-04:00,0,4,16,5,0,496,2856,3352
2017-04-08 17:00:00-04:00,0,4,17,5,0,437,4091,4528
2017-04-08 18:00:00-04:00,0,4,18,5,0,577,6519,7096
2017-04-08 19:00:00-04:00,0,4,19,5,0,910,9722,10632
2017-04-08 20:00:00-04:00,0,4,20,5,0,1285,13589,14874
2017-04-08 21:00:00-04:00,0,4,21,5,0,1498,15742,17240
2017-04-08 22:00:00-04:00,0,4,22,5,0,1675,17232,18907
2017-04-08 23:00:00-04:00,0,4,23,5,0,1818,18712,20530
2017-04-09 00:00:00-04:00,0,4,0,6,0,1816,18620,20436
2017-04-09 01:00:00-04:00,0,4,1,6,0,1942,17424,19366
2017-04-09 02:00:00-04:00,0,4,2,6,0,2254,17735,19989
2017-04-09 03:00:00-04:00,0,4,3,6,0,2361,16761,19122
2017-04-09 04:00:00-04:00,0,4,4,6,0,2446,19020,21466
2017-04-09 05:00:00-04:00,0,4,5,6,0,2751,20866,23617
2017-04-09 06:00:00-04:00,0,4,6,6,0,2766,22393,25159
2017-04-09 07:00:00-04:00,0,4,7,6,0,2810,19496,22306
2017-04-09 08:00:00-04:00,0,4,8,6,0,2892,18539,21431
2017-04-09 09:00:00-04:00,0,4,9,6,0,2795,20648,23443
2017-04-09 10:00:00-04:00,0,4,10,6,0,2924,21002,23926
2017-04-09 11:00:00-04:00,0,4,11,6,0,2759,19711,22470
2017-04-09 12:00:00-04:00,0,4,12,6,0,2421,17626,20047
2017-04-09 13:00:00-04:00,0,4,13,6,0,2066,14861,16927
2017-04-09 14:00:00-04:00,0,4,14,6,0,1738,11236,12974
2017-04-09 15:00:00-04:00,0,4,15,6,0,1261,7143,8404
2017-04-09 16:00:00-04:00,0,4,16,6,0,654,3107,3761
2017-04-09 17:00:00-04:00,0,4,17,6,0,442,3352,3794
2017-04-09 18:00:00-04:00,0,4,18,6,0,476,4754,5230
2017-04-09 19:00:00-04:00,0,4,19,6,0,638,7489,8127
2017-04-09 20:00:00-04:00,0,4,20,6,0,911,10522,11433
2017-04-09 21:00:00-04:00,0,4,21,6,0,1255,14283,15538
2017-04-09 22:00:00-04:00,0,4,22,6,0,1501,16178,17679
2017-04-09 23:00:00-04:00,0,4,23,6,0,1571,16933,18504
2017-04-10 00:00:00-04:00,0,4,0,0,0,1617,17139,18756
2017-04-10 01:00:00-04:00,0,4,1,0,0,1764,18049,19813
2017-04-10 02:00:00-04:00,0,4,2,0,0,1999,16807,18806
2017-04-10 03:00:00-04:00,0,4,3,0,0,2096,16869,18965
2017-04-10 04:00:00-04:00,0,4,4,0,0,1978,17258,19236
2017-04-10 05:00:00-04:00,0,4,5,0,0,2185,17701,19886
2017-04-10 06:00:00-04:00,0,4,6,0,0,2076,16598,18674
2017-04-10 07:00:00-04:00,0,4,7,0,0,1929,14942,16871
2017-04-10 08:00:00-04:00,0,4,8,0,0,1806,13861,15667
2017-04-10 09:00:00-04:00,0,4,9,0,0,1714,11785,13499
2017-04-10 10:00:00-04:00,0,4,10,0,0,1352,8740,10092
2017-04-10 11:00:00-04:00,0,4,11,0,0,889,5933,6822
2017-04-10 12:00:00-04:00,0,4,12,0,0,613,3503,4116
2017-04-10 13:00:00-04:00,0,4,13,0,0,365,2212,2577
2017-04-10 14:00:00-04:00,0,4,14,0,0,271,1446,1717
2017-04-10 15:00:00-04:00,0,4,15,0,0,286,1842,2128
2017-04-10 16:00:00-04:00,0,4,16,0,0,245,3516,3761
2017-04-10 17:00:00-04:00,0,4,17,0,0,469,8255,8724
2017-04-10 18:00:00-04:00,0,4,18,0,0,931,13633,14564
2017-04-10 19:00:00-04:00,0,4,19,0,0,1479,15609,17088
2017-04-10 20:00:00-04:00,0,4,20,0,0,1514,14967,16481
2017-04-10 21:00:00-04:00,0,4,21,0,0,1326,13786,15112
2017-04-10 22:00:00-04:00,0,4,22,0,0,1204,14074,15278
2017-04-10 23:00:00-04:00,0,4,23,0,0,1290,14482,15772
2017-04-11 00:00:00-04:00,0,4,0,1,0,1274,14705,15979
2017-04-11 01:00:00-04:00,0,4,1,1,0,1394,16276,17670
2017-04-11 02:00:00-04:00,0,4,2,1,0,1685,16490,18175
2017-04-11 03:00:00-04:00,0,4,3,1,0,1743,14886,16629
2017-04-11 04:00:00-04:00,0,4,4,1,0,1932,16870,18802
2017-04-11 05:00:00-04:00,0,4,5,1,0,2098,18805,20903
2017-04-11 06:00:00-04:00,0,4,6,1,0,1947,16400,18347
2017-04-11 07:00:00-04:00,0,4,7,1,0,1717,15711,17428
2017-04-11 08:00:00-04:00,0,4,8,1,0,1444,16407,17851
2017-04-11 09:00:00-04:00,0,4,9,1,0,1328,15529,16857
2017-04-11 10:00:00-04:00,0,4,10,1,0,1156,11343,12499
2017-04-11 11:00:00-04:00,0,4,11,1,0,827,6950,7777
2017-04-11 12:00:00-04:00,0,4,12,1,0,528,3809,4337
2017-04-11 13:00:00-04:00,0,4,13,1,0,371,2146,2517
2017-04-11 14:00:00-04:00,0,4,14,1,0,230,1508,1738
2017-04-11 15:00:00-04:00,0,4,15,1,0,217,1755,1972
2017-04-11 16:00:00-04:00,0,4,16,1,0,217,3080,3297
2017-04-11 17:00:00-04:00,0,4,17,1,0,420,7933,8353
2017-04-11 18:00:00-04:00,0,4,18,1,0,907,12237,13144
2017-04-11 19:00:00-04:00,0,4,19,1,0,1417,15035,16452
2017-04-11 20:00:00-04:00,0,4,20,1,0,1446,15190,16636
2017-04-11 21:00:00-04:00,0,4,21,1,0,1291,14281,15572
2017-04-11 22:00:00-04:00,0,4,22,1,0,1279,14858,16137
2017-04-11 23:00:00-04:00,0,4,23,1,0,1309,15965,17274
2017-04-12 00:00:00-04:00,0,4,0,2,0,1320,15891,17211
2017-04-12 01:00:00-04:00,0,4,1,2,0,1475,17230,18705
2017-04-12 02:00:00-04:00,0,4,2,2,0,1566,16633,18199
2017-04-12 03:00:00-04:00,0,4,3,2,0,1695,15392,17087
2017-04-12 04:00:00-04:00,0,4,4,2,0,2028,18208,20236
2017-04-12 05:00:00-04:00,0,4,5,2,0,2404,21868,24272
2017-04-12 06:00:00-04:00,0,4,6,2,0,2126,21049,23175
2017-04-12 07:00:00-04:00,0,4,7,2,0,2084,19421,21505
2017-04-12 08:00:00-04:00,0,4,8,2,0,1838,19745,21583
2017-04-12 09:00:00-04:00,0,4,9,2,0,1729,18435,20164
2017-04-12 10:00:00-04:00,0,4,10,2,0,1395,13405,14800
2017-04-12 11:00:00-04:00,0,4,11,2,0,1090,8059,9149
2017-04-12 12:00:00-04:00,0.02,4,12,2,0,649,4968,5617
2017-04-12 13:00:00-04:00,0.01,4,13,2,0,461,3008,3469
2017-04-12 14:00:00-04:00,0,4,14,2,0,297,1892,2189
2017-04-12 15:00:00-04:00,0,4,15,2,0,275,2115,2390
2017-04-12 16:00:00-04:00,0,4,16,2,0,226,3426,3652
2017-04-12 17:00:00-04:00,0,4,17,2,0,449,8529,8978
2017-04-12 18:00:00-04:00,0,4,18,2,0,849,14046,14895
2017-04-12 19:00:00-04:00,0,4,19,2,0,1427,17034,18461
2017-04-12 20:00:00-04:00,0,4,20,2,0,1543,15899,17442
2017-04-12 21:00:00-04:00,0,4,21,2,0,1335,15075,16410
2017-04-12 22:00:00-04:00,0,4,22,2,0,1409,17821,19230
2017-04-12 23:00:00-04:00,0,4,23,2,0,1415,17966,19381
2017-04-13 00:00:00-04:00,0,4,0,3,0,1284,16430,17714
2017-04-13 01:00:00-04:00,0,4,1,3,0,1440,16411,17851
2017-04-13 02:00:00-04:00,0,4,2,3,0,1603,16542,18145
2017-04-13 03:00:00-04:00,0,4,3,3,0,1794,15244,17038
2017-04-13 04:00:00-04:00,0,4,4,3,0,1977,17833,19810
2017-04-13 05:00:00-04:00,0,4,5,3,0,2270,20705,22975
2017-04-13 06:00:00-04:00,0,4,6,3,0,2015,20356,22371
2017-04-13 07:00:00-04:00,0,4,7,3,0,1821,18626,20447
2017-04-13 08:00:00-04:00,0,4,8,3,0,1752,19604,21356
2017-04-13 09:00:00-04:00,0,4,9,3,0,1633,18998,20631
2017-04-13 10:00:00-04:00,0,4,10,3,0,1494,14927,16421
2017-04-13 11:00:00-04:00,0,4,11,3,0,1052,9074,10126
2017-04-13 12:00:00-04:00,0,4,12,3,0,726,5474,6200
2017-04-13 13:00:00-04:00,0,4,13,3,0,478,3623,4101
2017-04-13 14:00:00-04:00,0,4,14,3,0,306,2407,2713
2017-04-13 15:00:00-04:00,0,4,15,3,0,273,2245,2518
2017-04-13 16:00:00-04:00,0,4,16,3,0,226,3629,3855
2017-04-13 17:00:00-04:00,0,4,17,3,0,442,8841,9283
2017-04-13 18:00:00-04:00,0,4,18,3,0,931,14951,15882
2017-04-13 19:00:00-04:00,0,4,19,3,0,1508,17735,19243
2017-04-13 20:00:00-04:00,0,4,20,3,0,1572,17309,18881
2017-04-13 21:00:00-04:00,0,4,21,3,0,1383,15838,17221
2017-04-13 22:00:00-04:00,0,4,22,3,0,1391,15779,17170
2017-04-13 23:00:00-04:00,0,4,23,3,0,1356,17005,18361
2017-04-14 00:00:00-04:00,0,4,0,4,0,1369,16926,18295
2017-04-14 01:00:00-04:00,0,4,1,4,0,1514,17529,19043
2017-04-14 02:00:00-04:00,0,4,2,4,0,1670,17150,18820
2017-04-14 03:00:00-04:00,0,4,3,4,0,1869,14732,16601
2017-04-14 04:00:00-04:00,0,4,4,4,0,2245,17130,19375
2017-04-14 05:00:00-04:00,0,4,5,4,0,2553,20814,23367
2017-04-14 06:00:00-04:00,0,4,6,4,0,2283,21370,23653
2017-04-14 07:00:00-04:00,0,4,7,4,0,2260,21044,23304
2017-04-14 08:00:00-04:00,0,4,8,4,0,2167,21249,23416
2017-04-14 09:00:00-04:00,0,4,9,4,0,2131,20685,22816
2017-04-14 10:00:00-04:00,0,4,10,4,0,1856,18731,20587
2017-04-14 11:00:00-04:00,0,4,11,4,0,1397,13404,14801
2017-04-14 12:00:00-04:00,0,4,12,4,0,1029,9211,10240
2017-04-14 13:00:00-04:00,0,4,13,4,0,762,6015,6777
2017-04-14 14:00:00-04:00,0,4,14,4,0,472,4102,4574
2017-04-14 15:00:00-04:00,0,4,15,4,0,409,3474,3883
2017-04-14 16:00:00-04:00,0,4,16,4,0,228,3370,3598
2017-04-14 17:00:00-04:00,0,4,17,4,0,358,6218,6576
2017-04-14 18:00:00-04:00,0,4,18,4,0,684,8777,9461
2017-04-14 19:00:00-04:00,0,4,19,4,0,1128,12914,14042
2017-04-14 20:00:00-04:00,0,4,20,4,0,1388,14932,16320
2017-04-14 21:00:00-04:00,0,4,21,4,0,1305,14625,15930
2017-04-14 22:00:00-04:00,0,4,22,4,0,1275,15614,16889
2017-04-14 23:00:00-04:00,0,4,23,4,0,1322,16600,17922
2017-04-15 00:00:00-04:00,0,4,0,5,0,1213,16763,17976
2017-04-15 01:00:00-04:00,0,4,1,5,0,1538,17825,19363
2017-04-15 02:00:00-04:00,0,4,2,5,0,1853,17434,19287
2017-04-15 03:00:00-04:00,0,4,3,5,0,2041,16204,18245
2017-04-15 04:00:00-04:00,0,4,4,5,0,2288,18711,20999
2017-04-15 05:00:00-04:00,0,4,5,5,0,2663,21589,24252
2017-04-15 06:00:00-04:00,0,4,6,5,0,2761,21655,24416
2017-04-15 07:00:00-04:00,0,4,7,5,0,2516,18462,20978
2017-04-15 08:00:00-04:00,0,4,8,5,0,2425,17442,19867
2017-04-15 09:00:00-04:00,0,4,9,5,0,2507,19150,21657
2017-04-15 10:00:00-04:00,0,4,10,5,0,2450,18695,21145
2017-04-15 11:00:00-04:00,0,4,11,5,0,2264,16386,18650
2017-04-15 12:00:00-04:00,0,4,12,5,0,2165,13860,16025
2017-04-15 13:00:00-04:00,0,4,13,5,0,1724,11263,12987
2017-04-15 14:00:00-04:00,0,4,14,5,0,1415,8205,9620
2017-04-15 15:00:00-04:00,0,4,15,5,0,1129,5561,6690
2017-04-15 16:00:00-04:00,0,4,16,5,0,519,2630,3149
2017-04-15 17:00:00-04:00,0,4,17,5,0,451,3608,4059
2017-04-15 18:00:00-04:00,0,4,18,5,0,532,5069,5601
2017-04-15 19:00:00-04:00,0,4,19,5,0,735,7646,8381
2017-04-15 20:00:00-04:00,0,4,20,5,0,1160,10945,12105
2017-04-15 21:00:00-04:00,0,4,21,5,0,1285,13630,14915
2017-04-15 22:00:00-04:00,0,4,22,5,0,1556,15344,16900
2017-04-15 23:00:00-04:00,0,4,23,5,0,1846,17139,18985
2017-04-16 00:00:00-04:00,0,4,0,6,0,1730,17033,18763
2017-04-16 01:00:00-04:00,0,4,1,6,0,1937,15625,17562
2017-04-16 02:00:00-04:00,0,4,2,6,0,2121,15834,17955
2017-04-16 03:00:00-04:00,0,4,3,6,0,2258,15461,17719
2017-04-16 04:00:00-04:00,0,4,4,6,0,2346,17387,19733
2017-04-16 05:00:00-04:00,0,4,5,6,0,2573,18212,20785
2017-04-16 06:00:00-04:00,0,4,6,6,0,2476,18294,20770
2017-04-16 07:00:00-04:00,0,4,7,6,0,2476,15008,17484
2017-04-16 08:00:00-04:00,0,4,8,6,0,2343,14669,17012
2017-04-16 09:00:00-04:00,0,4,9,6,0,2482,16997,19479
2017-04-16 10:00:00-04:00,0,4,10,6,0,2649,17006,19655
2017-04-16 11:00:00-04:00,0,4,11,6,0,2287,14281,16568
2017-04-16 12:00:00-04:00,0,4,12,6,0,2088,12184,14272
2017-04-16 13:00:00-04:00,0,4,13,6,0,1658,9944,11602
2017-04-16 14:00:00-04:00,0,4,14,6,0,1375,7665,9040
2017-04-16 15:00:00-04:00,0,4,15,6,0,1055,5260,6315
2017-04-16 16:00:00-04:00,0,4,16,6,0,570,2637,3207
2017-04-16 17:00:00-04:00,0,4,17,6,0,388,3077,3465
2017-04-16 18:00:00-04:00,0,4,18,6,0,495,4144,4639
2017-04-16 19:00:00-04:00,0,4,19,6,0,630,6446,7076
2017-04-16 20:00:00-04:00,0,4,20,6,0,957,9692,10649
2017-04-16 21:00:00-04:00,0,4,21,6,0,1286,14010,15296
2017-04-16 22:00:00-04:00,0,4,22,6,0,1630,14985,16615
2017-04-16 23:00:00-04:00,0,4,23,6,0,1769,16357,18126
2017-04-17 00:00:00-04:00,0,4,0,0,0,1790,16992,18782
2017-04-17 01:00:00-04:00,0,4,1,0,0,1929,16860,18789
2017-04-17 02:00:00-04:00,0,4,2,0,0,2177,16171,18348
2017-04-17 03:00:00-04:00,0,4,3,0,0,2234,16000,18234
2017-04-17 04:00:00-04:00,0,4,4,0,0,1913,14759,16672
2017-04-17 05:00:00-04:00,0,4,5,0,0,2012,15488,17500
2017-04-17 06:00:00-04:00,0,4,6,0,0,1890,14486,16376
2017-04-17 07:00:00-04:00,0,4,7,0,0,1972,14476,16448
2017-04-17 08:00:00-04:00,0,4,8,0,0,1914,13947,15861
2017-04-17 09:00:00-04:00,0,4,9,0,0,1844,12772,14616
2017-04-17 10:00:00-04:00,0,4,10,0,0,1382,9196,10578
2017-04-17 11:00:00-04:00,0,4,11,0,0,1104,6005,7109
2017-04-17 12:00:00-04:00,0,4,12,0,0,661,3441,4102
2017-04-17 13:00:00-04:00,0,4,13,0,0,444,2016,2460
2017-04-17 14:00:00-04:00,0,4,14,0,0,296,1503,1799
2017-04-17 15:00:00-04:00,0,4,15,0,0,315,1949,2264
2017-04-17 16:00:00-04:00,0,4,16,0,0,225,3394,3619
2017-04-17 17:00:00-04:00,0,4,17,0,0,431,7766,8197
2017-04-17 18:00:00-04:00,0,4,18,0,0,886,12758,13644
2017-04-17 19:00:00-04:00,0,4,19,0,0,1381,15207,16588
2017-04-17 20:00:00-04:00,0,4,20,0,0,1488,15023,16511
2017-04-17 21:00:00-04:00,0,4,21,0,0,1256,13928,15184
2017-04-17 22:00:00-04:00,0,4,22,0,0,1146,13454,14600
2017-04-17 23:00:00-04:00,0,4,23,0,0,1234,14251,15485
2017-04-18 00:00:00-04:00,0,4,0,1,0,1177,14506,15683
2017-04-18 01:00:00-04:00,0,4,1,1,0,1230,15630,16860
2017-04-18 02:00:00-04:00,0,4,2,1,0,1492,16212,17704
2017-04-18 03:00:00-04:00,0,4,3,1,0,1521,14708,16229
2017-04-18 04:00:00-04:00,0,4,4,1,0,1757,16858,18615
2017-04-18 05:00:00-04:00,0,4,5,1,0,1989,18931,20920
2017-04-18 06:00:00-04:00,0,4,6,1,0,1832,17946,19778
2017-04-18 07:00:00-04:00,0,4,7,1,0,1760,17180,18940
2017-04-18 08:00:00-04:00,0,4,8,1,0,1408,16116,17524
2017-04-18 09:00:00-04:00,0,4,9,1,0,1205,13735,14940
2017-04-18 10:00:00-04:00,0,4,10,1,0,1092,9864,10956
2017-04-18 11:00:00-04:00,0,4,11,1,0,672,6092,6764
2017-04-18 12:00:00-04:00,0,4,12,1,0,437,3532,3969
2017-04-18 13:00:00-04:00,0,4,13,1,0,286,2210,2496
2017-04-18 14:00:00-04:00,0,4,14,1,0,184,1397,1581
2017-04-18 15:00:00-04:00,0,4,15,1,0,192,1694,1886
2017-04-18 16:00:00-04:00,0,4,16,1,0,212,3325,3537
2017-04-18 17:00:00-04:00,0,4,17,1,0,451,8817,9268
2017-04-18 18:00:00-04:00,0,4,18,1,0,944,14707,15651
2017-04-18 19:00:00-04:00,0,4,19,1,0,1482,17365,18847
2017-04-18 20:00:00-04:00,0,4,20,1,0,1452,16395,17847
2017-04-18 21:00:00-04:00,0,4,21,1,0,1310,15177,16487
2017-04-18 22:00:00-04:00,0,4,22,1,0,1231,15045,16276
2017-04-18 23:00:00-04:00,0,4,23,1,0,1271,15822,17093
2017-04-19 00:00:00-04:00,0,4,0,2,0,1231,15776,17007
2017-04-19 01:00:00-04:00,0,4,1,2,0,1371,16650,18021
2017-04-19 02:00:00-04:00,0,4,2,2,0,1622,17067,18689
2017-04-19 03:00:00-04:00,0,4,3,2,0,1726,15694,17420
2017-04-19 04:00:00-04:00,0,4,4,2,0,2027,18935,20962
2017-04-19 05:00:00-04:00,0,4,5,2,0,2492,22781,25273
2017-04-19 06:00:00-04:00,0,4,6,2,0,2371,22211,24582
2017-04-19 07:00:00-04:00,0,4,7,2,0,2215,21851,24066
2017-04-19 08:00:00-04:00,0,4,8,2,0,1964,21344,23308
2017-04-19 09:00:00-04:00,0,4,9,2,0,1649,19262,20911
2017-04-19 10:00:00-04:00,0,4,10,2,0,1272,13667,14939
2017-04-19 11:00:00-04:00,0,4,11,2,0,868,7784,8652
2017-04-19 12:00:00-04:00,0,4,12,2,0,528,4407,4935
2017-04-19 13:00:00-04:00,0,4,13,2,0,332,2639,2971
2017-04-19 14:00:00-04:00,0,4,14,2,0,209,1849,2058
2017-04-19 15:00:00-04:00,0,4,15,2,0,214,1871,2085
2017-04-19 16:00:00-04:00,0,4,16,2,0,222,3402,3624
2017-04-19 17:00:00-04:00,0,4,17,2,0,538,9581,10119
2017-04-19 18:00:00-04:00,0,4,18,2,0,1281,16627,17908
2017-04-19 19:00:00-04:00,0,4,19,2,0,1801,19557,21358
2017-04-19 20:00:00-04:00,0,4,20,2,0,1707,18357,20064
2017-04-19 21:00:00-04:00,0,4,21,2,0,1448,16596,18044
2017-04-19 22:00:00-04:00,0,4,22,2,0,1382,16989,18371
2017-04-19 23:00:00-04:00,0,4,23,2,0,1369,17201,18570
2017-04-20 00:00:00-04:00,0,4,0,3,0,1393,17342,18735
2017-04-20 01:00:00-04:00,0,4,1,3,0,1541,18542,20083
2017-04-20 02:00:00-04:00,0,4,2,3,0,1743,18792,20535
2017-04-20 03:00:00-04:00,0,4,3,3,0,2180,16686,18866
2017-04-20 04:00:00-04:00,0.05,4,4,3,0,2637,19436,22073
2017-04-20 05:00:00-04:00,0,4,5,3,0,3055,22863,25918
2017-04-20 06:00:00-04:00,0.01,4,6,3,0,2687,23902,26589
2017-04-20 07:00:00-04:00,0.13,4,7,3,0,2335,22368,24703
2017-04-20 08:00:00-04:00,0.05,4,8,3,0,1988,21564,23552
2017-04-20 09:00:00-04:00,0,4,9,3,0,1658,19340,20998
2017-04-20 10:00:00-04:00,0,4,10,3,0,1284,14097,15381
2017-04-20 11:00:00-04:00,0,4,11,3,0,943,8821,9764
2017-04-20 12:00:00-04:00,0,4,12,3,0,591,5241,5832
2017-04-20 13:00:00-04:00,0,4,13,3,0,349,3033,3382
2017-04-20 14:00:00-04:00,0,4,14,3,0,231,2038,2269
2017-04-20 15:00:00-04:00,0,4,15,3,0,230,2015,2245
2017-04-20 16:00:00-04:00,0,4,16,3,0,245,3523,3768
2017-04-20 17:00:00-04:00,0,4,17,3,0,553,10389,10942
2017-04-20 18:00:00-04:00,0,4,18,3,0,1371,19426,20797
2017-04-20 19:00:00-04:00,0,4,19,3,0,1908,20692,22600
2017-04-20 20:00:00-04:00,0,4,20,3,0,1724,18307,20031
2017-04-20 21:00:00-04:00,0,4,21,3,0,1506,16539,18045
2017-04-20 22:00:00-04:00,0,4,22,3,0,1482,16528,18010
2017-04-20 23:00:00-04:00,0,4,23,3,0,1395,16989,18384
2017-04-21 00:00:00-04:00,0,4,0,4,0,1431,16768,18199
2017-04-21 01:00:00-04:00,0.21,4,1,4,0,1649,17934,19583
2017-04-21 02:00:00-04:00,0.01,4,2,4,0,1776,17795,19571
2017-04-21 03:00:00-04:00,0,4,3,4,0,2011,15536,17547
2017-04-21 04:00:00-04:00,0,4,4,4,0,2304,19277,21581
2017-04-21 05:00:00-04:00,0,4,5,4,0,2651,22843,25494
2017-04-21 06:00:00-04:00,0.01,4,6,4,0,2446,23008,25454
2017-04-21 07:00:00-04:00,0.02,4,7,4,0,2319,22440,24759
2017-04-21 08:00:00-04:00,0.02,4,8,4,0,2075,21842,23917
2017-04-21 09:00:00-04:00,0,4,9,4,0,1963,21672,23635
2017-04-21 10:00:00-04:00,0,4,10,4,0,1569,18671,20240
2017-04-21 11:00:00-04:00,0,4,11,4,0,1283,13573,14856
2017-04-21 12:00:00-04:00,0,4,12,4,0,1104,9212,10316
2017-04-21 13:00:00-04:00,0,4,13,4,0,599,5021,5620
2017-04-21 14:00:00-04:00,0,4,14,4,0,442,3207,3649
2017-04-21 15:00:00-04:00,0,4,15,4,0,362,2857,3219
2017-04-21 16:00:00-04:00,0,4,16,4,0,262,3832,4094
2017-04-21 17:00:00-04:00,0,4,17,4,0,557,10118,10675
2017-04-21 18:00:00-04:00,0,4,18,4,0,1332,17747,19079
2017-04-21 19:00:00-04:00,0,4,19,4,0,2088,21781,23869
2017-04-21 20:00:00-04:00,0,4,20,4,0,2164,19903,22067
2017-04-21 21:00:00-04:00,0,4,21,4,0,1809,18311,20120
2017-04-21 22:00:00-04:00,0,4,22,4,0,1532,17511,19043
2017-04-21 23:00:00-04:00,0,4,23,4,0,1509,17495,19004
2017-04-22 00:00:00-04:00,0,4,0,5,0,1325,17056,18381
2017-04-22 01:00:00-04:00,0,4,1,5,0,1625,18925,20550
2017-04-22 02:00:00-04:00,0,4,2,5,0,1898,17980,19878
2017-04-22 03:00:00-04:00,0,4,3,5,0,2199,15597,17796
2017-04-22 04:00:00-04:00,0,4,4,5,0,2551,18733,21284
2017-04-22 05:00:00-04:00,0,4,5,5,0,2901,22705,25606
2017-04-22 06:00:00-04:00,0,4,6,5,0,2978,24212,27190
2017-04-22 07:00:00-04:00,0,4,7,5,0,2792,21522,24314
2017-04-22 08:00:00-04:00,0,4,8,5,0,2643,20645,23288
2017-04-22 09:00:00-04:00,0,4,9,5,0,2668,21498,24166
2017-04-22 10:00:00-04:00,0,4,10,5,0,2641,20645,23286
2017-04-22 11:00:00-04:00,0,4,11,5,0,2432,18062,20494
2017-04-22 12:00:00-04:00,0.02,4,12,5,0,2134,15549,17683
2017-04-22 13:00:00-04:00,0.01,4,13,5,0,1631,12028,13659
2017-04-22 14:00:00-04:00,0.01,4,14,5,0,1303,8641,9944
2017-04-22 15:00:00-04:00,0.01,4,15,5,0,984,5619,6603
2017-04-22 16:00:00-04:00,0.02,4,16,5,0,487,2815,3302
2017-04-22 17:00:00-04:00,0,4,17,5,0,400,4269,4669
2017-04-22 18:00:00-04:00,0,4,18,5,0,567,6258,6825
2017-04-22 19:00:00-04:00,0,4,19,5,0,933,10538,11471
2017-04-22 20:00:00-04:00,0,4,20,5,0,1205,14128,15333
2017-04-22 21:00:00-04:00,0,4,21,5,0,1425,15953,17378
2017-04-22 22:00:00-04:00,0,4,22,5,0,1600,17228,18828
2017-04-22 23:00:00-04:00,0,4,23,5,0,1907,19453,21360
2017-04-23 00:00:00-04:00,0,4,0,6,0,1876,17859,19735
2017-04-23 01:00:00-04:00,0,4,1,6,0,2146,18162,20308
2017-04-23 02:00:00-04:00,0,4,2,6,0,2242,17382,19624
2017-04-23 03:00:00-04:00,0,4,3,6,0,2369,15478,17847
2017-04-23 04:00:00-04:00,0,4,4,6,0,2478,16733,19211
2017-04-23 05:00:00-04:00,0,4,5,6,0,2545,19589,22134
2017-04-23 06:00:00-04:00,0,4,6,6,0,2501,20696,23197
2017-04-23 07:00:00-04:00,0,4,7,6,0,2530,17480,20010
2017-04-23 08:00:00-04:00,0,4,8,6,0,2518,17621,20139
2017-04-23 09:00:00-04:00,0,4,9,6,0,2549,19846,22395
2017-04-23 10:00:00-04:00,0,4,10,6,0,2932,21543,24475
2017-04-23 11:00:00-04:00,0,4,11,6,0,2584,19599,22183
2017-04-23 12:00:00-04:00,0,4,12,6,0,2329,17721,20050
2017-04-23 13:00:00-04:00,0,4,13,6,0,1921,14984,16905
2017-04-23 14:00:00-04:00,0,4,14,6,0,1638,10806,12444
2017-04-23 15:00:00-04:00,0,4,15,6,0,1191,6747,7938
2017-04-23 16:00:00-04:00,0,4,16,6,0,553,3078,3631
2017-04-23 17:00:00-04:00,0,4,17,6,0,419,3693,4112
2017-04-23 18:00:00-04:00,0,4,18,6,0,465,5282,5747
2017-04-23 19:00:00-04:00,0,4,19,6,0,603,7465,8068
2017-04-23 20:00:00-04:00,0,4,20,6,0,899,11117,12016
2017-04-23 21:00:00-04:00,0,4,21,6,0,1121,14063,15184
2017-04-23 22:00:00-04:00,0,4,22,6,0,1350,15836,17186
2017-04-23 23:00:00-04:00,0,4,23,6,0,1566,17435,19001
2017-04-24 00:00:00-04:00,0,4,0,0,0,1612,17786,19398
2017-04-24 01:00:00-04:00,0,4,1,0,0,1816,18364,20180
2017-04-24 02:00:00-04:00,0,4,2,0,0,1846,17257,19103
2017-04-24 03:00:00-04:00,0,4,3,0,0,1905,16994,18899
2017-04-24 04:00:00-04:00,0,4,4,0,0,1960,17325,19285
2017-04-24 05:00:00-04:00,0,4,5,0,0,2081,17986,20067
2017-04-24 06:00:00-04:00,0,4,6,0,0,1996,16485,18481
2017-04-24 07:00:00-04:00,0,4,7,0,0,1862,15237,17099
2017-04-24 08:00:00-04:00,0,4,8,0,0,1685,14426,16111
2017-04-24 09:00:00-04:00,0,4,9,0,0,1571,12028,13599
2017-04-24 10:00:00-04:00,0,4,10,0,0,1238,9503,10741
2017-04-24 11:00:00-04:00,0,4,11,0,0,903,5884,6787
2017-04-24 12:00:00-04:00,0,4,12,0,0,484,3526,4010
2017-04-24 13:00:00-04:00,0,4,13,0,0,352,2149,2501
2017-04-24 14:00:00-04:00,0,4,14,0,0,266,1453,1719
2017-04-24 15:00:00-04:00,0,4,15,0,0,286,2130,2416
2017-04-24 16:00:00-04:00,0,4,16,0,0,268,3796,4064
2017-04-24 17:00:00-04:00,0,4,17,0,0,575,9388,9963
2017-04-24 18:00:00-04:00,0,4,18,0,0,1320,15497,16817
2017-04-24 19:00:00-04:00,0,4,19,0,0,1822,17720,19542
2017-04-24 20:00:00-04:00,0,4,20,0,0,1718,16615,18333
2017-04-24 21:00:00-04:00,0,4,21,0,0,1439,14270,15709
2017-04-24 22:00:00-04:00,0,4,22,0,0,1254,14111,15365
2017-04-24 23:00:00-04:00,0,4,23,0,0,1293,15235,16528
2017-04-25 00:00:00-04:00,0,4,0,1,0,1277,15068,16345
2017-04-25 01:00:00-04:00,0,4,1,1,0,1461,16644,18105
2017-04-25 02:00:00-04:00,0,4,2,1,0,1643,17523,19166
2017-04-25 03:00:00-04:00,0,4,3,1,0,1875,15756,17631
2017-04-25 04:00:00-04:00,0.01,4,4,1,0,2082,18873,20955
2017-04-25 05:00:00-04:00,0,4,5,1,0,2206,22255,24461
2017-04-25 06:00:00-04:00,0.05,4,6,1,0,2028,20526,22554
2017-04-25 07:00:00-04:00,0.01,4,7,1,0,1700,18529,20229
2017-04-25 08:00:00-04:00,0,4,8,1,0,1369,17666,19035
2017-04-25 09:00:00-04:00,0,4,9,1,0,1230,15090,16320
2017-04-25 10:00:00-04:00,0.01,4,10,1,0,1020,10798,11818
2017-04-25 11:00:00-04:00,0,4,11,1,0,814,7169,7983
2017-04-25 12:00:00-04:00,0,4,12,1,0,551,4108,4659
2017-04-25 13:00:00-04:00,0,4,13,1,0,287,2188,2475
2017-04-25 14:00:00-04:00,0,4,14,1,0,239,1479,1718
2017-04-25 15:00:00-04:00,0,4,15,1,0,203,1773,1976
2017-04-25 16:00:00-04:00,0.02,4,16,1,0,219,3586,3805
2017-04-25 17:00:00-04:00,0.05,4,17,1,0,571,9946,10517
2017-04-25 18:00:00-04:00,0.06,4,18,1,0,1306,17583,18889
2017-04-25 19:00:00-04:00,0.07,4,19,1,0,1898,19721,21619
2017-04-25 20:00:00-04:00,0.03,4,20,1,0,1701,18021,19722
2017-04-25 21:00:00-04:00,0.24,4,21,1,0,1485,16966,18451
2017-04-25 22:00:00-04:00,0.06,4,22,1,0,1280,15857,17137
2017-04-25 23:00:00-04:00,0.03,4,23,1,0,1380,16171,17551
2017-04-26 00:00:00-04:00,0,4,0,2,0,1281,16007,17288
2017-04-26 01:00:00-04:00,0,4,1,2,0,1567,18049,19616
2017-04-26 02:00:00-04:00,0,4,2,2,0,1867,18352,20219
2017-04-26 03:00:00-04:00,0,4,3,2,0,2339,16499,18838
2017-04-26 04:00:00-04:00,0.02,4,4,2,0,2880,20295,23175
2017-04-26 05:00:00-04:00,0.09,4,5,2,0,3203,23547,26750
2017-04-26 06:00:00-04:00,0.01,4,6,2,0,2886,22522,25408
2017-04-26 07:00:00-04:00,0.04,4,7,2,0,2563,23500,26063
2017-04-26 08:00:00-04:00,0.01,4,8,2,0,2223,21043,23266
2017-04-26 09:00:00-04:00,0.01,4,9,2,0,1568,17985,19553
2017-04-26 10:00:00-04:00,0,4,10,2,0,1150,12159,13309
2017-04-26 11:00:00-04:00,0.1,4,11,2,0,803,7846,8649
2017-04-26 12:00:00-04:00,0,4,12,2,0,443,4768,5211
2017-04-26 13:00:00-04:00,0,4,13,2,0,292,2921,3213
2017-04-26 14:00:00-04:00,0,4,14,2,0,181,1565,1746
2017-04-26 15:00:00-04:00,0,4,15,2,0,207,1899,2106
2017-04-26 16:00:00-04:00,0,4,16,2,0,204,3691,3895
2017-04-26 17:00:00-04:00,0,4,17,2,0,513,10271,10784
2017-04-26 18:00:00-04:00,0,4,18,2,0,1289,18696,19985
2017-04-26 19:00:00-04:00,0,4,19,2,0,1794,19592,21386
2017-04-26 20:00:00-04:00,0,4,20,2,0,1744,18600,20344
2017-04-26 21:00:00-04:00,0,4,21,2,0,1461,16001,17462
2017-04-26 22:00:00-04:00,0,4,22,2,0,1489,17627,19116
2017-04-26 23:00:00-04:00,0,4,23,2,0,1319,16355,17674
2017-04-27 00:00:00-04:00,0,4,0,3,0,1280,16502,17782
2017-04-27 01:00:00-04:00,0,4,1,3,0,1557,17763,19320
2017-04-27 02:00:00-04:00,0,4,2,3,0,1732,17801,19533
2017-04-27 03:00:00-04:00,0,4,3,3,0,1929,15437,17366
2017-04-27 04:00:00-04:00,0.01,4,4,3,0,2159,18750,20909
2017-04-27 05:00:00-04:00,0,4,5,3,0,2467,22364,24831
2017-04-27 06:00:00-04:00,0,4,6,3,0,2335,21082,23417
2017-04-27 07:00:00-04:00,0,4,7,3,0,2005,20407,22412
2017-04-27 08:00:00-04:00,0,4,8,3,0,1728,20476,22204
2017-04-27 09:00:00-04:00,0,4,9,3,0,1531,18904,20435
2017-04-27 10:00:00-04:00,0,4,10,3,0,1312,15385,16697
2017-04-27 11:00:00-04:00,0,4,11,3,0,955,9462,10417
2017-04-27 12:00:00-04:00,0,4,12,3,0,586,5483,6069
2017-04-27 13:00:00-04:00,0,4,13,3,0,416,3515,3931
2017-04-27 14:00:00-04:00,0,4,14,3,0,284,2178,2462
2017-04-27 15:00:00-04:00,0,4,15,3,0,256,2156,2412
2017-04-27 16:00:00-04:00,0,4,16,3,0,213,3742,3955
2017-04-27 17:00:00-04:00,0,4,17,3,0,519,9649,10168
2017-04-27 18:00:00-04:00,0,4,18,3,0,1239,16591,17830
2017-04-27 19:00:00-04:00,0,4,19,3,0,1832,19586,21418
2017-04-27 20:00:00-04:00,0,4,20,3,0,1717,17904,19621
2017-04-27 21:00:00-04:00,0,4,21,3,0,1458,16070,17528
2017-04-27 22:00:00-04:00,0,4,22,3,0,1381,15630,17011
2017-04-27 23:00:00-04:00,0,4,23,3,0,1378,16406,17784
2017-04-28 00:00:00-04:00,0,4,0,4,0,1373,16127,17500
2017-04-28 01:00:00-04:00,0,4,1,4,0,1590,17803,19393
2017-04-28 02:00:00-04:00,0,4,2,4,0,1792,17324,19116
2017-04-28 03:00:00-04:00,0,4,3,4,0,2016,14860,16876
2017-04-28 04:00:00-04:00,0,4,4,4,0,2330,17934,20264
2017-04-28 05:00:00-04:00,0,4,5,4,0,2631,22086,24717
2017-04-28 06:00:00-04:00,0,4,6,4,0,2608,23132,25740
2017-04-28 07:00:00-04:00,0,4,7,4,0,2203,21708,23911
2017-04-28 08:00:00-04:00,0,4,8,4,0,1993,21909,23902
2017-04-28 09:00:00-04:00,0,4,9,4,0,1878,21336,23214
2017-04-28 10:00:00-04:00,0,4,10,4,0,1628,17609,19237
2017-04-28 11:00:00-04:00,0,4,11,4,0,1273,12910,14183
2017-04-28 12:00:00-04:00,0,4,12,4,0,897,8918,9815
2017-04-28 13:00:00-04:00,0,4,13,4,0,619,6289,6908
2017-04-28 14:00:00-04:00,0,4,14,4,0,410,3956,4366
2017-04-28 15:00:00-04:00,0,4,15,4,0,317,3113,3430
2017-04-28 16:00:00-04:00,0,4,16,4,0,235,3948,4183
2017-04-28 17:00:00-04:00,0,4,17,4,0,538,9432,9970
2017-04-28 18:00:00-04:00,0,4,18,4,0,1279,15910,17189
2017-04-28 19:00:00-04:00,0,4,19,4,0,1837,18486,20323
2017-04-28 20:00:00-04:00,0,4,20,4,0,1703,17101,18804
2017-04-28 21:00:00-04:00,0,4,21,4,0,1463,15593,17056
2017-04-28 22:00:00-04:00,0,4,22,4,0,1447,16042,17489
2017-04-28 23:00:00-04:00,0,4,23,4,0,1347,16252,17599
2017-04-29 00:00:00-04:00,0,4,0,5,0,1341,16287,17628
2017-04-29 01:00:00-04:00,0,4,1,5,0,1735,18246,19981
2017-04-29 02:00:00-04:00,0,4,2,5,0,2000,16934,18934
2017-04-29 03:00:00-04:00,0,4,3,5,0,2211,14676,16887
2017-04-29 04:00:00-04:00,0,4,4,5,0,2555,17226,19781
2017-04-29 05:00:00-04:00,0.06,4,5,5,0,2905,21284,24189
2017-04-29 06:00:00-04:00,0,4,6,5,0,2797,23109,25906
2017-04-29 07:00:00-04:00,0,4,7,5,0,2894,21110,24004
2017-04-29 08:00:00-04:00,0,4,8,5,0,2584,20408,22992
2017-04-29 09:00:00-04:00,0,4,9,5,0,2635,21253,23888
2017-04-29 10:00:00-04:00,0,4,10,5,0,2663,20867,23530
2017-04-29 11:00:00-04:00,0,4,11,5,0,2406,18384,20790
2017-04-29 12:00:00-04:00,0,4,12,5,0,1949,15502,17451
2017-04-29 13:00:00-04:00,0,4,13,5,0,1725,12884,14609
2017-04-29 14:00:00-04:00,0,4,14,5,0,1474,9450,10924
2017-04-29 15:00:00-04:00,0,4,15,5,0,1087,6356,7443
2017-04-29 16:00:00-04:00,0,4,16,5,0,595,3398,3993
2017-04-29 17:00:00-04:00,0,4,17,5,0,412,4059,4471
2017-04-29 18:00:00-04:00,0,4,18,5,0,635,6426,7061
2017-04-29 19:00:00-04:00,0,4,19,5,0,934,10213,11147
2017-04-29 20:00:00-04:00,0,4,20,5,0,1206,13844,15050
2017-04-29 21:00:00-04:00,0,4,21,5,0,1297,15442,16739
2017-04-29 22:00:00-04:00,0,4,22,5,0,1610,17066,18676
2017-04-29 23:00:00-04:00,0,4,23,5,0,1676,18778,20454
2017-04-30 00:00:00-04:00,0,4,0,6,0,1779,19362,21141
2017-04-30 01:00:00-04:00,0,4,1,6,0,1960,18285,20245
2017-04-30 02:00:00-04:00,0,4,2,6,0,2223,18194,20417
2017-04-30 03:00:00-04:00,0,4,3,6,0,2340,16705,19045
2017-04-30 04:00:00-04:00,0,4,4,6,0,2389,18612,21001
2017-04-30 05:00:00-04:00,0,4,5,6,0,2654,20973,23627
2017-04-30 06:00:00-04:00,0,4,6,6,0,2730,22051,24781
2017-04-30 07:00:00-04:00,0,4,7,6,0,2701,18475,21176
2017-04-30 08:00:00-04:00,0,4,8,6,0,2547,18506,21053
2017-04-30 09:00:00-04:00,0,4,9,6,0,2814,20054,22868
2017-04-30 10:00:00-04:00,0,4,10,6,0,2816,20812,23628
2017-04-30 11:00:00-04:00,0,4,11,6,0,2693,18901,21594
2017-04-30 12:00:00-04:00,0,4,12,6,0,2432,16589,19021
2017-04-30 13:00:00-04:00,0,4,13,6,0,2067,13937,16004
2017-04-30 14:00:00-04:00,0,4,14,6,0,1673,10481,12154
2017-04-30 15:00:00-04:00,0,4,15,6,0,1187,6711,7898
2017-04-30 16:00:00-04:00,0,4,16,6,0,556,3099,3655
2017-04-30 17:00:00-04:00,0,4,17,6,0,431,3462,3893
2017-04-30 18:00:00-04:00,0,4,18,6,0,454,5385,5839
2017-04-30 19:00:00-04:00,0,4,19,6,0,546,7115,7661
2017-04-30 20:00:00-04:00,0,4,20,6,0,888,11090,11978
2017-04-30 21:00:00-04:00,0,4,21,6,0,1172,14748,15920
2017-04-30 22:00:00-04:00,0,4,22,6,0,1361,16439,17800
2017-04-30 23:00:00-04:00,0,4,23,6,0,1561,18003,19564
2017-05-01 00:00:00-04:00,0,5,0,0,0,1618,18083,19701
2017-05-01 01:00:00-04:00,0,5,1,0,0,1831,18459,20290
2017-05-01 02:00:00-04:00,0,5,2,0,0,1940,17516,19456
2017-05-01 03:00:00-04:00,0,5,3,0,0,2065,16820,18885
2017-05-01 04:00:00-04:00,0,5,4,0,0,2023,17449,19472
2017-05-01 05:00:00-04:00,0,5,5,0,0,2071,17525,19596
2017-05-01 06:00:00-04:00,0,5,6,0,0,1928,15327,17255
2017-05-01 07:00:00-04:00,0,5,7,0,0,1768,14903,16671
2017-05-01 08:00:00-04:00,0,5,8,0,0,1541,13400,14941
2017-05-01 09:00:00-04:00,0,5,9,0,0,1392,11498,12890
2017-05-01 10:00:00-04:00,0,5,10,0,0,1124,8813,9937
2017-05-01 11:00:00-04:00,0,5,11,0,0,799,5885,6684
2017-05-01 12:00:00-04:00,0,5,12,0,0,490,3735,4225
2017-05-01 13:00:00-04:00,0,5,13,0,0,372,2347,2719
2017-05-01 14:00:00-04:00,0,5,14,0,0,243,1629,1872
2017-05-01 15:00:00-04:00,0,5,15,0,0,261,2076,2337
2017-05-01 16:00:00-04:00,0,5,16,0,0,270,3535,3805
2017-05-01 17:00:00-04:00,0,5,17,0,0,478,8866,9344
2017-05-01 18:00:00-04:00,0,5,18,0,0,1181,15324,16505
2017-05-01 19:00:00-04:00,0,5,19,0,0,1753,17860,19613
2017-05-01 20:00:00-04:00,0,5,20,0,0,1704,16326,18030
2017-05-01 21:00:00-04:00,0,5,21,0,0,1458,14293,15751
2017-05-01 22:00:00-04:00,0,5,22,0,0,1347,14518,15865
2017-05-01 23:00:00-04:00,0,5,23,0,0,1335,14989,16324
2017-05-02 00:00:00-04:00,0,5,0,1,0,1293,15335,16628
2017-05-02 01:00:00-04:00,0,5,1,1,0,1506,16586,18092
2017-05-02 02:00:00-04:00,0,5,2,1,0,1679,16722,18401
2017-05-02 03:00:00-04:00,0,5,3,1,0,1731,15290,17021
2017-05-02 04:00:00-04:00,0,5,4,1,0,1957,17739,19696
2017-05-02 05:00:00-04:00,0,5,5,1,0,2214,20582,22796
2017-05-02 06:00:00-04:00,0,5,6,1,0,1967,18888,20855
2017-05-02 07:00:00-04:00,0,5,7,1,0,1673,18091,19764
2017-05-02 08:00:00-04:00,0,5,8,1,0,1512,17304,18816
2017-05-02 09:00:00-04:00,0,5,9,1,0,1362,14837,16199
2017-05-02 10:00:00-04:00,0,5,10,1,0,1089,10603,11692
2017-05-02 11:00:00-04:00,0,5,11,1,0,766,7661,8427
2017-05-02 12:00:00-04:00,0,5,12,1,0,534,4666,5200
2017-05-02 13:00:00-04:00,0,5,13,1,0,268,2544,2812
2017-05-02 14:00:00-04:00,0,5,14,1,0,198,1685,1883
2017-05-02 15:00:00-04:00,0,5,15,1,0,201,1722,1923
2017-05-02 16:00:00-04:00,0,5,16,1,0,212,3408,3620
2017-05-02 17:00:00-04:00,0,5,17,1,0,502,9400,9902
2017-05-02 18:00:00-04:00,0,5,18,1,0,1278,17575,18853
2017-05-02 19:00:00-04:00,0,5,19,1,0,1714,18955,20669
2017-05-02 20:00:00-04:00,0,5,20,1,0,1692,16972,18664
2017-05-02 21:00:00-04:00,0,5,21,1,0,1454,15599,17053
2017-05-02 22:00:00-04:00,0,5,22,1,0,1331,15809,17140
2017-05-02 23:00:00-04:00,0,5,23,1,0,1278,16161,17439
2017-05-03 00:00:00-04:00,0,5,0,2,0,1339,16383,17722
2017-05-03 01:00:00-04:00,0,5,1,2,0,1492,17479,18971
2017-05-03 02:00:00-04:00,0,5,2,2,0,1636,17250,18886
2017-05-03 03:00:00-04:00,0,5,3,2,0,1832,15364,17196
2017-05-03 04:00:00-04:00,0,5,4,2,0,2048,18326,20374
2017-05-03 05:00:00-04:00,0,5,5,2,0,2193,21184,23377
2017-05-03 06:00:00-04:00,0,5,6,2,0,2218,20648,22866
2017-05-03 07:00:00-04:00,0,5,7,2,0,1971,20365,22336
2017-05-03 08:00:00-04:00,0,5,8,2,0,1811,20924,22735
2017-05-03 09:00:00-04:00,0,5,9,2,0,1574,18744,20318
2017-05-03 10:00:00-04:00,0,5,10,2,0,1212,13742,14954
2017-05-03 11:00:00-04:00,0,5,11,2,0,852,8093,8945
2017-05-03 12:00:00-04:00,0,5,12,2,0,511,4487,4998
2017-05-03 13:00:00-04:00,0,5,13,2,0,341,2796,3137
2017-05-03 14:00:00-04:00,0,5,14,2,0,222,1880,2102
2017-05-03 15:00:00-04:00,0,5,15,2,0,182,2021,2203
2017-05-03 16:00:00-04:00,0,5,16,2,0,226,3615,3841
2017-05-03 17:00:00-04:00,0,5,17,2,0,508,9234,9742
2017-05-03 18:00:00-04:00,0,5,18,2,0,1154,16345,17499
2017-05-03 19:00:00-04:00,0,5,19,2,0,1642,18986,20628
2017-05-03 20:00:00-04:00,0,5,20,2,0,1636,17621,19257
2017-05-03 21:00:00-04:00,0,5,21,2,0,1442,16214,17656
2017-05-03 22:00:00-04:00,0,5,22,2,0,1391,16538,17929
2017-05-03 23:00:00-04:00,0,5,23,2,0,1428,17238,18666
2017-05-04 00:00:00-04:00,0,5,0,3,0,1449,16910,18359
2017-05-04 01:00:00-04:00,0,5,1,3,0,1592,17883,19475
2017-05-04 02:00:00-04:00,0,5,2,3,0,1732,17466,19198
2017-05-04 03:00:00-04:00,0,5,3,3,0,1853,15446,17299
2017-05-04 04:00:00-04:00,0,5,4,3,0,2167,18331,20498
2017-05-04 05:00:00-04:00,0,5,5,3,0,2458,22400,24858
2017-05-04 06:00:00-04:00,0,5,6,3,0,2395,22703,25098
2017-05-04 07:00:00-04:00,0,5,7,3,0,2131,22615,24746
2017-05-04 08:00:00-04:00,0,5,8,3,0,2016,21678,23694
2017-05-04 09:00:00-04:00,0,5,9,3,0,1904,20043,21947
2017-05-04 10:00:00-04:00,0,5,10,3,0,1466,15479,16945
2017-05-04 11:00:00-04:00,0,5,11,3,0,1021,9156,10177
2017-05-04 12:00:00-04:00,0,5,12,3,0,650,5186,5836
2017-05-04 13:00:00-04:00,0,5,13,3,0,388,3295,3683
2017-05-04 14:00:00-04:00,0,5,14,3,0,260,2116,2376
2017-05-04 15:00:00-04:00,0,5,15,3,0,226,2162,2388
2017-05-04 16:00:00-04:00,0,5,16,3,0,231,3693,3924
2017-05-04 17:00:00-04:00,0,5,17,3,0,512,9776,10288
2017-05-04 18:00:00-04:00,0,5,18,3,0,1245,16490,17735
2017-05-04 19:00:00-04:00,0,5,19,3,0,1872,19280,21152
2017-05-04 20:00:00-04:00,0,5,20,3,0,1654,17039,18693
2017-05-04 21:00:00-04:00,0,5,21,3,0,1437,15838,17275
2017-05-04 22:00:00-04:00,0,5,22,3,0,1486,15520,17006
2017-05-04 23:00:00-04:00,0,5,23,3,0,1386,16429,17815
2017-05-05 00:00:00-04:00,0,5,0,4,0,1369,16376,17745
2017-05-05 01:00:00-04:00,0,5,1,4,0,1545,17815,19360
2017-05-05 02:00:00-04:00,0,5,2,4,0,1849,17539,19388
2017-05-05 03:00:00-04:00,0,5,3,4,0,1985,15669,17654
2017-05-05 04:00:00-04:00,0,5,4,4,0,2369,19962,22331
2017-05-05 05:00:00-04:00,0,5,5,4,0,2908,23812,26720
2017-05-05 06:00:00-04:00,0,5,6,4,0,2702,23322,26024
2017-05-05 07:00:00-04:00,0.01,5,7,4,0,2283,22826,25109
2017-05-05 08:00:00-04:00,0.02,5,8,4,0,2146,22579,24725
2017-05-05 09:00:00-04:00,0,5,9,4,0,2143,21675,23818
2017-05-05 10:00:00-04:00,0.05,5,10,4,0,1741,18022,19763
2017-05-05 11:00:00-04:00,0.6,5,11,4,0,1296,12443,13739
2017-05-05 12:00:00-04:00,0.38,5,12,4,0,923,8472,9395
2017-05-05 13:00:00-04:00,0.92,5,13,4,0,559,5107,5666
2017-05-05 14:00:00-04:00,0.26,5,14,4,0,351,3318,3669
2017-05-05 15:00:00-04:00,0.01,5,15,4,0,311,2994,3305
2017-05-05 16:00:00-04:00,0,5,16,4,0,255,3917,4172
2017-05-05 17:00:00-04:00,0,5,17,4,0,569,9986,10555
2017-05-05 18:00:00-04:00,0,5,18,4,0,1297,17805,19102
2017-05-05 19:00:00-04:00,0,5,19,4,0,1972,20234,22206
2017-05-05 20:00:00-04:00,0,5,20,4,0,1944,18820,20764
2017-05-05 21:00:00-04:00,0,5,21,4,0,1802,18338,20140
2017-05-05 22:00:00-04:00,0.01,5,22,4,0,2057,20302,22359
2017-05-05 23:00:00-04:00,0.01,5,23,4,0,1798,18569,20367
2017-05-06 00:00:00-04:00,0,5,0,5,0,1625,16059,17684
2017-05-06 01:00:00-04:00,0.01,5,1,5,0,1869,15317,17186
2017-05-06 02:00:00-04:00,0.03,5,2,5,0,1933,14035,15968
2017-05-06 03:00:00-04:00,0.01,5,3,5,0,2197,13036,15233
2017-05-06 04:00:00-04:00,0,5,4,5,0,2604,17312,19916
2017-05-06 05:00:00-04:00,0,5,5,5,0,2971,22041,25012
2017-05-06 06:00:00-04:00,0,5,6,5,0,2772,21926,24698
2017-05-06 07:00:00-04:00,0,5,7,5,0,2408,19554,21962
2017-05-06 08:00:00-04:00,0,5,8,5,0,2338,19414,21752
2017-05-06 09:00:00-04:00,0,5,9,5,0,2655,22413,25068
2017-05-06 10:00:00-04:00,0,5,10,5,0,2542,21370,23912
2017-05-06 11:00:00-04:00,0,5,11,5,0,2362,19336,21698
2017-05-06 12:00:00-04:00,0,5,12,5,0,2102,17342,19444
2017-05-06 13:00:00-04:00,0,5,13,5,0,1745,13912,15657
2017-05-06 14:00:00-04:00,0,5,14,5,0,1361,9337,10698
2017-05-06 15:00:00-04:00,0,5,15,5,0,970,6094,7064
2017-05-06 16:00:00-04:00,0,5,16,5,0,531,3173,3704
2017-05-06 17:00:00-04:00,0,5,17,5,0,425,4297,4722
2017-05-06 18:00:00-04:00,0,5,18,5,0,563,6210,6773
2017-05-06 19:00:00-04:00,0,5,19,5,0,888,9455,10343
2017-05-06 20:00:00-04:00,0.01,5,20,5,0,1289,13669,14958
2017-05-06 21:00:00-04:00,0,5,21,5,0,1414,16254,17668
2017-05-06 22:00:00-04:00,0,5,22,5,0,1648,17541,19189
2017-05-06 23:00:00-04:00,0,5,23,5,0,1627,18351,19978
2017-05-07 00:00:00-04:00,0,5,0,6,0,1768,19057,20825
2017-05-07 01:00:00-04:00,0,5,1,6,0,2060,19016,21076
2017-05-07 02:00:00-04:00,0,5,2,6,0,2242,19205,21447
2017-05-07 03:00:00-04:00,0,5,3,6,0,2375,17195,19570
2017-05-07 04:00:00-04:00,0,5,4,6,0,2241,18410,20651
2017-05-07 05:00:00-04:00,0,5,5,6,0,2571,19884,22455
2017-05-07 06:00:00-04:00,0,5,6,6,0,2882,23064,25946
2017-05-07 07:00:00-04:00,0,5,7,6,0,2659,19351,22010
2017-05-07 08:00:00-04:00,0,5,8,6,0,2566,18603,21169
2017-05-07 09:00:00-04:00,0,5,9,6,0,2883,20786,23669
2017-05-07 10:00:00-04:00,0,5,10,6,0,2752,20957,23709
2017-05-07 11:00:00-04:00,0,5,11,6,0,2742,19118,21860
2017-05-07 12:00:00-04:00,0,5,12,6,0,2369,16356,18725
2017-05-07 13:00:00-04:00,0,5,13,6,0,1933,13183,15116
2017-05-07 14:00:00-04:00,0,5,14,6,0,1642,9931,11573
2017-05-07 15:00:00-04:00,0,5,15,6,0,1144,6423,7567
2017-05-07 16:00:00-04:00,0,5,16,6,0,613,3127,3740
2017-05-07 17:00:00-04:00,0,5,17,6,0,374,3549,3923
2017-05-07 18:00:00-04:00,0,5,18,6,0,434,5090,5524
2017-05-07 19:00:00-04:00,0,5,19,6,0,627,8324,8951
2017-05-07 20:00:00-04:00,0,5,20,6,0,845,11386,12231
2017-05-07 21:00:00-04:00,0,5,21,6,0,1102,14706,15808
2017-05-07 22:00:00-04:00,0,5,22,6,0,1305,17069,18374
2017-05-07 23:00:00-04:00,0,5,23,6,0,1553,17904,19457
2017-05-08 00:00:00-04:00,0,5,0,0,0,1673,19223,20896
2017-05-08 01:00:00-04:00,0,5,1,0,0,1955,19265,21220
2017-05-08 02:00:00-04:00,0,5,2,0,0,2094,18217,20311
2017-05-08 03:00:00-04:00,0,5,3,0,0,2164,17499,19663
2017-05-08 04:00:00-04:00,0,5,4,0,0,2009,16847,18856
2017-05-08 05:00:00-04:00,0,5,5,0,0,1998,16689,18687
2017-05-08 06:00:00-04:00,0,5,6,0,0,1824,15596,17420
2017-05-08 07:00:00-04:00,0,5,7,0,0,1718,14877,16595
2017-05-08 08:00:00-04:00,0,5,8,0,0,1555,13391,14946
2017-05-08 09:00:00-04:00,0,5,9,0,0,1348,11285,12633
2017-05-08 10:00:00-04:00,0,5,10,0,0,1115,8972,10087
2017-05-08 11:00:00-04:00,0,5,11,0,0,783,5600,6383
2017-05-08 12:00:00-04:00,0,5,12,0,0,487,3208,3695
2017-05-08 13:00:00-04:00,0,5,13,0,0,328,2003,2331
2017-05-08 14:00:00-04:00,0,5,14,0,0,238,1443,1681
2017-05-08 15:00:00-04:00,0,5,15,0,0,268,1893,2161
2017-05-08 16:00:00-04:00,0,5,16,0,0,256,3710,3966
2017-05-08 17:00:00-04:00,0,5,17,0,0,504,9222,9726
2017-05-08 18:00:00-04:00,0,5,18,0,0,1177,15252,16429
2017-05-08 19:00:00-04:00,0,5,19,0,0,1718,18313,20031
2017-05-08 20:00:00-04:00,0,5,20,0,0,1585,16228,17813
2017-05-08 21:00:00-04:00,0,5,21,0,0,1346,14439,15785
2017-05-08 22:00:00-04:00,0,5,22,0,0,1295,14905,16200
2017-05-08 23:00:00-04:00,0,5,23,0,0,1305,15470,16775
2017-05-09 00:00:00-04:00,0,5,0,1,0,1211,15419,16630
2017-05-09 01:00:00-04:00,0,5,1,1,0,1464,16953,18417
2017-05-09 02:00:00-04:00,0,5,2,1,0,1627,17312,18939
2017-05-09 03:00:00-04:00,0,5,3,1,0,1809,15953,17762
2017-05-09 04:00:00-04:00,0,5,4,1,0,1876,18476,20352
2017-05-09 05:00:00-04:00,0,5,5,1,0,2107,21051,23158
2017-05-09 06:00:00-04:00,0,5,6,1,0,1958,19199,21157
2017-05-09 07:00:00-04:00,0,5,7,1,0,1611,18058,19669
2017-05-09 08:00:00-04:00,0,5,8,1,0,1486,17128,18614
2017-05-09 09:00:00-04:00,0,5,9,1,0,1300,15456,16756
2017-05-09 10:00:00-04:00,0,5,10,1,0,1179,10288,11467
2017-05-09 11:00:00-04:00,0,5,11,1,0,775,6475,7250
2017-05-09 12:00:00-04:00,0,5,12,1,0,451,3696,4147
2017-05-09 13:00:00-04:00,0,5,13,1,0,305,2228,2533
2017-05-09 14:00:00-04:00,0,5,14,1,0,197,1517,1714
2017-05-09 15:00:00-04:00,0,5,15,1,0,205,1600,1805
2017-05-09 16:00:00-04:00,0,5,16,1,0,224,3397,3621
2017-05-09 17:00:00-04:00,0,5,17,1,0,468,9256,9724
2017-05-09 18:00:00-04:00,0,5,18,1,0,1189,16026,17215
2017-05-09 19:00:00-04:00,0,5,19,1,0,1719,18750,20469
2017-05-09 20:00:00-04:00,0,5,20,1,0,1902,18273,20175
2017-05-09 21:00:00-04:00,0,5,21,1,0,1533,16088,17621
2017-05-09 22:00:00-04:00,0,5,22,1,0,1245,15944,17189
2017-05-09 23:00:00-04:00,0,5,23,1,0,1300,16072,17372
2017-05-10 00:00:00-04:00,0,5,0,2,0,1307,15844,17151
2017-05-10 01:00:00-04:00,0,5,1,2,0,1481,17145,18626
2017-05-10 02:00:00-04:00,0,5,2,2,0,1700,17129,18829
2017-05-10 03:00:00-04:00,0,5,3,2,0,1847,15542,17389
2017-05-10 04:00:00-04:00,0,5,4,2,0,2176,18679,20855
2017-05-10 05:00:00-04:00,0,5,5,2,0,2349,21848,24197
2017-05-10 06:00:00-04:00,0,5,6,2,0,2209,20863,23072
2017-05-10 07:00:00-04:00,0,5,7,2,0,1826,20282,22108
2017-05-10 08:00:00-04:00,0,5,8,2,0,1762,20688,22450
2017-05-10 09:00:00-04:00,0,5,9,2,0,1576,19599,21175
2017-05-10 10:00:00-04:00,0,5,10,2,0,1346,13538,14884
2017-05-10 11:00:00-04:00,0,5,11,2,0,922,7673,8595
2017-05-10 12:00:00-04:00,0,5,12,2,0,578,4574,5152
2017-05-10 13:00:00-04:00,0,5,13,2,0,293,2737,3030
2017-05-10 14:00:00-04:00,0,5,14,2,0,207,1844,2051
2017-05-10 15:00:00-04:00,0,5,15,2,0,213,1899,2112
2017-05-10 16:00:00-04:00,0,5,16,2,0,241,3450,3691
2017-05-10 17:00:00-04:00,0,5,17,2,0,484,9320,9804
2017-05-10 18:00:00-04:00,0,5,18,2,0,1180,16709,17889
2017-05-10 19:00:00-04:00,0,5,19,2,0,1715,20084,21799
2017-05-10 20:00:00-04:00,0,5,20,2,0,1780,17826,19606
2017-05-10 21:00:00-04:00,0,5,21,2,0,1415,16215,17630
2017-05-10 22:00:00-04:00,0,5,22,2,0,1384,16055,17439
2017-05-10 23:00:00-04:00,0,5,23,2,0,1355,16285,17640
2017-05-11 00:00:00-04:00,0,5,0,3,0,1293,16708,18001
2017-05-11 01:00:00-04:00,0,5,1,3,0,1572,17476,19048
2017-05-11 02:00:00-04:00,0,5,2,3,0,1737,17035,18772
2017-05-11 03:00:00-04:00,0,5,3,3,0,1877,15083,16960
2017-05-11 04:00:00-04:00,0,5,4,3,0,2177,17684,19861
2017-05-11 05:00:00-04:00,0,5,5,3,0,2418,20885,23303
2017-05-11 06:00:00-04:00,0,5,6,3,0,2351,21734,24085
2017-05-11 07:00:00-04:00,0,5,7,3,0,2004,21323,23327
2017-05-11 08:00:00-04:00,0,5,8,3,0,1808,21976,23784
2017-05-11 09:00:00-04:00,0,5,9,3,0,1659,20470,22129
2017-05-11 10:00:00-04:00,0,5,10,3,0,1430,15324,16754
2017-05-11 11:00:00-04:00,0,5,11,3,0,1076,9374,10450
2017-05-11 12:00:00-04:00,0,5,12,3,0,627,5256,5883
2017-05-11 13:00:00-04:00,0,5,13,3,0,405,3162,3567
2017-05-11 14:00:00-04:00,0,5,14,3,0,231,2136,2367
2017-05-11 15:00:00-04:00,0,5,15,3,0,224,2052,2276
2017-05-11 16:00:00-04:00,0,5,16,3,0,229,3603,3832
2017-05-11 17:00:00-04:00,0,5,17,3,0,497,9716,10213
2017-05-11 18:00:00-04:00,0,5,18,3,0,1212,16503,17715
2017-05-11 19:00:00-04:00,0,5,19,3,0,1711,19031,20742
2017-05-11 20:00:00-04:00,0,5,20,3,0,1669,17418,19087
2017-05-11 21:00:00-04:00,0,5,21,3,0,1488,15967,17455
2017-05-11 22:00:00-04:00,0,5,22,3,0,1408,16638,18046
2017-05-11 23:00:00-04:00,0,5,23,3,0,1409,16990,18399
2017-05-12 00:00:00-04:00,0,5,0,4,0,1359,16979,18338
2017-05-12 01:00:00-04:00,0,5,1,4,0,1592,18001,19593
2017-05-12 02:00:00-04:00,0,5,2,4,0,1889,17345,19234
2017-05-12 03:00:00-04:00,0,5,3,4,0,2018,14823,16841
2017-05-12 04:00:00-04:00,0,5,4,4,0,2276,17605,19881
2017-05-12 05:00:00-04:00,0,5,5,4,0,2517,22115,24632
2017-05-12 06:00:00-04:00,0,5,6,4,0,2498,22350,24848
2017-05-12 07:00:00-04:00,0,5,7,4,0,2147,21788,23935
2017-05-12 08:00:00-04:00,0,5,8,4,0,2018,21382,23400
2017-05-12 09:00:00-04:00,0,5,9,4,0,1918,20061,21979
2017-05-12 10:00:00-04:00,0,5,10,4,0,1677,17951,19628
2017-05-12 11:00:00-04:00,0,5,11,4,0,1281,12442,13723
2017-05-12 12:00:00-04:00,0,5,12,4,0,810,7982,8792
2017-05-12 13:00:00-04:00,0,5,13,4,0,526,5149,5675
2017-05-12 14:00:00-04:00,0,5,14,4,0,414,3356,3770
2017-05-12 15:00:00-04:00,0,5,15,4,0,329,3076,3405
2017-05-12 16:00:00-04:00,0,5,16,4,0,261,3980,4241
2017-05-12 17:00:00-04:00,0,5,17,4,0,529,9310,9839
2017-05-12 18:00:00-04:00,0,5,18,4,0,1219,15869,17088
2017-05-12 19:00:00-04:00,0,5,19,4,0,1806,18574,20380
2017-05-12 20:00:00-04:00,0,5,20,4,0,1758,17172,18930
2017-05-12 21:00:00-04:00,0,5,21,4,0,1483,15506,16989
2017-05-12 22:00:00-04:00,0,5,22,4,0,1440,15793,17233
2017-05-12 23:00:00-04:00,0,5,23,4,0,1346,16293,17639
2017-05-13 00:00:00-04:00,0,5,0,5,0,1315,16008,17323
2017-05-13 01:00:00-04:00,0,5,1,5,0,1668,17846,19514
2017-05-13 02:00:00-04:00,0,5,2,5,0,1955,16611,18566
2017-05-13 03:00:00-04:00,0,5,3,5,0,2226,14620,16846
2017-05-13 04:00:00-04:00,0.01,5,4,5,0,2488,17733,20221
2017-05-13 05:00:00-04:00,0.02,5,5,5,0,2908,22332,25240
2017-05-13 06:00:00-04:00,0.05,5,6,5,0,2931,23403,26334
2017-05-13 07:00:00-04:00,0.05,5,7,5,0,2608,20712,23320
2017-05-13 08:00:00-04:00,0.03,5,8,5,0,2678,20121,22799
2017-05-13 09:00:00-04:00,0.07,5,9,5,0,2592,20537,23129
2017-05-13 10:00:00-04:00,0.08,5,10,5,0,2594,19667,22261
2017-05-13 11:00:00-04:00,0.05,5,11,5,0,2595,18152,20747
2017-05-13 12:00:00-04:00,0.05,5,12,5,0,2080,15137,17217
2017-05-13 13:00:00-04:00,0.15,5,13,5,0,1776,12812,14588
2017-05-13 14:00:00-04:00,0.15,5,14,5,0,1451,9325,10776
2017-05-13 15:00:00-04:00,0.16,5,15,5,0,1048,6125,7173
2017-05-13 16:00:00-04:00,0.08,5,16,5,0,576,3040,3616
2017-05-13 17:00:00-04:00,0.12,5,17,5,0,482,4361,4843
2017-05-13 18:00:00-04:00,0.23,5,18,5,0,616,6266,6882
2017-05-13 19:00:00-04:00,0.12,5,19,5,0,960,9918,10878
2017-05-13 20:00:00-04:00,0.04,5,20,5,0,1294,14762,16056
2017-05-13 21:00:00-04:00,0.04,5,21,5,0,1503,17991,19494
2017-05-13 22:00:00-04:00,0.13,5,22,5,0,1727,20597,22324
2017-05-13 23:00:00-04:00,0.09,5,23,5,0,1945,21185,23130
2017-05-14 00:00:00-04:00,0.02,5,0,6,0,2017,21746,23763
2017-05-14 01:00:00-04:00,0,5,1,6,0,2232,21319,23551
2017-05-14 02:00:00-04:00,0,5,2,6,0,2337,19952,22289
2017-05-14 03:00:00-04:00,0,5,3,6,0,2511,17870,20381
2017-05-14 04:00:00-04:00,0,5,4,6,0,2805,19760,22565
2017-05-14 05:00:00-04:00,0,5,5,6,0,3000,21127,24127
2017-05-14 06:00:00-04:00,0,5,6,6,0,2935,21064,23999
2017-05-14 07:00:00-04:00,0,5,7,6,0,2596,16953,19549
2017-05-14 08:00:00-04:00,0,5,8,6,0,2609,16771,19380
2017-05-14 09:00:00-04:00,0,5,9,6,0,2511,17730,20241
2017-05-14 10:00:00-04:00,0,5,10,6,0,2376,17187,19563
2017-05-14 11:00:00-04:00,0,5,11,6,0,2027,14450,16477
2017-05-14 12:00:00-04:00,0,5,12,6,0,1742,11903,13645
2017-05-14 13:00:00-04:00,0,5,13,6,0,1404,9511,10915
2017-05-14 14:00:00-04:00,0,5,14,6,0,1147,6968,8115
2017-05-14 15:00:00-04:00,0.01,5,15,6,0,903,4725,5628
2017-05-14 16:00:00-04:00,0,5,16,6,0,492,2408,2900
2017-05-14 17:00:00-04:00,0,5,17,6,0,329,3212,3541
2017-05-14 18:00:00-04:00,0,5,18,6,0,444,4742,5186
2017-05-14 19:00:00-04:00,0,5,19,6,0,611,7073,7684
2017-05-14 20:00:00-04:00,0,5,20,6,0,968,11180,12148
2017-05-14 21:00:00-04:00,0,5,21,6,0,1343,14558,15901
2017-05-14 22:00:00-04:00,0,5,22,6,0,1536,16501,18037
2017-05-14 23:00:00-04:00,0,5,23,6,0,1695,16942,18637
2017-05-15 00:00:00-04:00,0,5,0,0,0,1803,17396,19199
2017-05-15 01:00:00-04:00,0,5,1,0,0,2158,18931,21089
2017-05-15 02:00:00-04:00,0,5,2,0,0,2297,18108,20405
2017-05-15 03:00:00-04:00,0,5,3,0,0,2152,16052,18204
2017-05-15 04:00:00-04:00,0,5,4,0,0,2495,17457,19952
2017-05-15 05:00:00-04:00,0,5,5,0,0,2214,16196,18410
2017-05-15 06:00:00-04:00,0,5,6,0,0,2169,15762,17931
2017-05-15 07:00:00-04:00,0,5,7,0,0,1995,15524,17519
2017-05-15 08:00:00-04:00,0,5,8,0,0,2079,14900,16979
2017-05-15 09:00:00-04:00,0,5,9,0,0,1796,12652,14448
2017-05-15 10:00:00-04:00,0,5,10,0,0,1513,9922,11435
2017-05-15 11:00:00-04:00,0,5,11,0,0,1030,6144,7174
2017-05-15 12:00:00-04:00,0,5,12,0,0,607,3332,3939
2017-05-15 13:00:00-04:00,0,5,13,0,0,382,2294,2676
2017-05-15 14:00:00-04:00,0,5,14,0,0,289,1516,1805
2017-05-15 15:00:00-04:00,0,5,15,0,0,271,1872,2143
2017-05-15 16:00:00-04:00,0,5,16,0,0,273,3731,4004
2017-05-15 17:00:00-04:00,0,5,17,0,0,507,9358,9865
2017-05-15 18:00:00-04:00,0,5,18,0,0,1183,15454,16637
2017-05-15 19:00:00-04:00,0,5,19,0,0,1671,17447,19118
2017-05-15 20:00:00-04:00,0,5,20,0,0,1577,16146,17723
2017-05-15 21:00:00-04:00,0,5,21,0,0,1284,14735,16019
2017-05-15 22:00:00-04:00,0,5,22,0,0,1248,14958,16206
2017-05-15 23:00:00-04:00,0,5,23,0,0,1201,15179,16380
2017-05-16 00:00:00-04:00,0,5,0,1,0,1196,15370,16566
2017-05-16 01:00:00-04:00,0,5,1,1,0,1391,16913,18304
2017-05-16 02:00:00-04:00,0,5,2,1,0,1563,17418,18981
2017-05-16 03:00:00-04:00,0,5,3,1,0,1724,15565,17289
2017-05-16 04:00:00-04:00,0,5,4,1,0,1930,18480,20410
2017-05-16 05:00:00-04:00,0,5,5,1,0,2152,20870,23022
2017-05-16 06:00:00-04:00,0,5,6,1,0,1954,19387,21341
2017-05-16 07:00:00-04:00,0,5,7,1,0,1654,18924,20578
2017-05-16 08:00:00-04:00,0,5,8,1,0,1527,18584,20111
2017-05-16 09:00:00-04:00,0,5,9,1,0,1248,17181,18429
2017-05-16 10:00:00-04:00,0,5,10,1,0,1049,11586,12635
2017-05-16 11:00:00-04:00,0,5,11,1,0,784,7777,8561
2017-05-16 12:00:00-04:00,0,5,12,1,0,483,4530,5013
2017-05-16 13:00:00-04:00,0,5,13,1,0,272,2700,2972
2017-05-16 14:00:00-04:00,0,5,14,1,0,194,1676,1870
2017-05-16 15:00:00-04:00,0,5,15,1,0,180,1792,1972
2017-05-16 16:00:00-04:00,0,5,16,1,0,204,3660,3864
2017-05-16 17:00:00-04:00,0,5,17,1,0,486,9325,9811
2017-05-16 18:00:00-04:00,0,5,18,1,0,1120,16246,17366
2017-05-16 19:00:00-04:00,0,5,19,1,0,1574,18610,20184
2017-05-16 20:00:00-04:00,0,5,20,1,0,1556,17053,18609
2017-05-16 21:00:00-04:00,0,5,21,1,0,1348,15705,17053
2017-05-16 22:00:00-04:00,0,5,22,1,0,1314,15992,17306
2017-05-16 23:00:00-04:00,0,5,23,1,0,1386,16398,17784
2017-05-17 00:00:00-04:00,0,5,0,2,0,1334,16470,17804
2017-05-17 01:00:00-04:00,0,5,1,2,0,1503,17985,19488
2017-05-17 02:00:00-04:00,0,5,2,2,0,1666,17992,19658
2017-05-17 03:00:00-04:00,0,5,3,2,0,1808,15747,17555
2017-05-17 04:00:00-04:00,0,5,4,2,0,1995,18733,20728
2017-05-17 05:00:00-04:00,0,5,5,2,0,2319,21905,24224
2017-05-17 06:00:00-04:00,0,5,6,2,0,2174,20917,23091
2017-05-17 07:00:00-04:00,0,5,7,2,0,1716,20682,22398
2017-05-17 08:00:00-04:00,0,5,8,2,0,1642,21198,22840
2017-05-17 09:00:00-04:00,0,5,9,2,0,1552,19453,21005
2017-05-17 10:00:00-04:00,0,5,10,2,0,1312,14672,15984
2017-05-17 11:00:00-04:00,0,5,11,2,0,914,9266,10180
2017-05-17 12:00:00-04:00,0,5,12,2,0,532,5516,6048
2017-05-17 13:00:00-04:00,0,5,13,2,0,366,3245,3611
2017-05-17 14:00:00-04:00,0,5,14,2,0,262,2012,2274
2017-05-17 15:00:00-04:00,0,5,15,2,0,216,2098,2314
2017-05-17 16:00:00-04:00,0,5,16,2,0,256,3590,3846
2017-05-17 17:00:00-04:00,0,5,17,2,0,506,9340,9846
2017-05-17 18:00:00-04:00,0,5,18,2,0,1192,16726,17918
2017-05-17 19:00:00-04:00,0,5,19,2,0,1626,19253,20879
2017-05-17 20:00:00-04:00,0,5,20,2,0,1521,17942,19463
2017-05-17 21:00:00-04:00,0,5,21,2,0,1425,16073,17498
2017-05-17 22:00:00-04:00,0,5,22,2,0,1319,16798,18117
2017-05-17 23:00:00-04:00,0,5,23,2,0,1501,17396,18897
2017-05-18 00:00:00-04:00,0,5,0,3,0,1463,17985,19448
2017-05-18 01:00:00-04:00,0,5,1,3,0,1618,18963,20581
2017-05-18 02:00:00-04:00,0,5,2,3,0,1760,17464,19224
2017-05-18 03:00:00-04:00,0,5,3,3,0,2037,14615,16652
2017-05-18 04:00:00-04:00,0,5,4,3,0,2278,17725,20003
2017-05-18 05:00:00-04:00,0,5,5,3,0,2411,21338,23749
2017-05-18 06:00:00-04:00,0,5,6,3,0,2283,22687,24970
2017-05-18 07:00:00-04:00,0,5,7,3,0,1958,22066,24024
2017-05-18 08:00:00-04:00,0,5,8,3,0,1928,22174,24102
2017-05-18 09:00:00-04:00,0,5,9,3,0,1697,20928,22625
2017-05-18 10:00:00-04:00,0,5,10,3,0,1468,16876,18344
2017-05-18 11:00:00-04:00,0,5,11,3,0,1124,11344,12468
2017-05-18 12:00:00-04:00,0,5,12,3,0,708,6547,7255
2017-05-18 13:00:00-04:00,0,5,13,3,0,448,4218,4666
2017-05-18 14:00:00-04:00,0,5,14,3,0,289,2754,3043
2017-05-18 15:00:00-04:00,0,5,15,3,0,250,2423,2673
2017-05-18 16:00:00-04:00,0,5,16,3,0,232,3823,4055
2017-05-18 17:00:00-04:00,0,5,17,3,0,515,9639,10154
2017-05-18 18:00:00-04:00,0,5,18,3,0,1189,17284,18473
2017-05-18 19:00:00-04:00,0,5,19,3,0,1744,19503,21247
2017-05-18 20:00:00-04:00,0,5,20,3,0,1719,18156,19875
2017-05-18 21:00:00-04:00,0,5,21,3,0,1580,17128,18708
2017-05-18 22:00:00-04:00,0,5,22,3,0,1526,17638,19164
2017-05-18 23:00:00-04:00,0,5,23,3,0,1486,17477,18963
2017-05-19 00:00:00-04:00,0,5,0,4,0,1570,16414,17984
2017-05-19 01:00:00-04:00,0,5,1,4,0,1667,16890,18557
2017-05-19 02:00:00-04:00,0,5,2,4,0,1828,15300,17128
2017-05-19 03:00:00-04:00,0,5,3,4,0,2023,13085,15108
2017-05-19 04:00:00-04:00,0,5,4,4,0,2309,15997,18306
2017-05-19 05:00:00-04:00,0,5,5,4,0,2886,19959,22845
2017-05-19 06:00:00-04:00,0,5,6,4,0,2831,21095,23926
2017-05-19 07:00:00-04:00,0,5,7,4,0,2343,21601,23944
2017-05-19 08:00:00-04:00,0,5,8,4,0,2288,21756,24044
2017-05-19 09:00:00-04:00,0,5,9,4,0,2063,20490,22553
2017-05-19 10:00:00-04:00,0,5,10,4,0,1915,18667,20582
2017-05-19 11:00:00-04:00,0,5,11,4,0,1450,14577,16027
2017-05-19 12:00:00-04:00,0,5,12,4,0,1067,9443,10510
2017-05-19 13:00:00-04:00,0,5,13,4,0,653,5641,6294
2017-05-19 14:00:00-04:00,0,5,14,4,0,438,3615,4053
2017-05-19 15:00:00-04:00,0,5,15,4,0,335,3239,3574
2017-05-19 16:00:00-04:00,0,5,16,4,0,296,4252,4548
2017-05-19 17:00:00-04:00,0,5,17,4,0,539,9445,9984
2017-05-19 18:00:00-04:00,0,5,18,4,0,1201,16161,17362
2017-05-19 19:00:00-04:00,0,5,19,4,0,1738,18883,20621
2017-05-19 20:00:00-04:00,0,5,20,4,0,1911,18442,20353
2017-05-19 21:00:00-04:00,0,5,21,4,0,1590,16869,18459
2017-05-19 22:00:00-04:00,0,5,22,4,0,1463,17175,18638
2017-05-19 23:00:00-04:00,0,5,23,4,0,1541,17304,18845
2017-05-20 00:00:00-04:00,0,5,0,5,0,1327,16299,17626
2017-05-20 01:00:00-04:00,0,5,1,5,0,1705,17480,19185
2017-05-20 02:00:00-04:00,0,5,2,5,0,2063,15571,17634
2017-05-20 03:00:00-04:00,0,5,3,5,0,2176,13517,15693
2017-05-20 04:00:00-04:00,0,5,4,5,0,2500,17116,19616
2017-05-20 05:00:00-04:00,0,5,5,5,0,2805,22050,24855
2017-05-20 06:00:00-04:00,0.01,5,6,5,0,2992,24145,27137
2017-05-20 07:00:00-04:00,0,5,7,5,0,2587,21156,23743
2017-05-20 08:00:00-04:00,0,5,8,5,0,2640,20337,22977
2017-05-20 09:00:00-04:00,0,5,9,5,0,2655,21421,24076
2017-05-20 10:00:00-04:00,0,5,10,5,0,2673,20148,22821
2017-05-20 11:00:00-04:00,0,5,11,5,0,2639,18494,21133
2017-05-20 12:00:00-04:00,0,5,12,5,0,2143,15760,17903
2017-05-20 13:00:00-04:00,0,5,13,5,0,1841,12818,14659
2017-05-20 14:00:00-04:00,0,5,14,5,0,1465,9667,11132
2017-05-20 15:00:00-04:00,0,5,15,5,0,1032,6496,7528
2017-05-20 16:00:00-04:00,0,5,16,5,0,708,4343,5051
2017-05-20 17:00:00-04:00,0,5,17,5,0,583,5438,6021
2017-05-20 18:00:00-04:00,0,5,18,5,0,684,6819,7503
2017-05-20 19:00:00-04:00,0,5,19,5,0,1011,10671,11682
2017-05-20 20:00:00-04:00,0,5,20,5,0,1287,14746,16033
2017-05-20 21:00:00-04:00,0,5,21,5,0,1518,17381,18899
2017-05-20 22:00:00-04:00,0,5,22,5,0,1711,18178,19889
2017-05-20 23:00:00-04:00,0,5,23,5,0,1910,19483,21393
2017-05-21 00:00:00-04:00,0,5,0,6,0,1835,19123,20958
2017-05-21 01:00:00-04:00,0,5,1,6,0,2070,18176,20246
2017-05-21 02:00:00-04:00,0,5,2,6,0,2219,17458,19677
2017-05-21 03:00:00-04:00,0,5,3,6,0,2453,15628,18081
2017-05-21 04:00:00-04:00,0,5,4,6,0,2394,17663,20057
2017-05-21 05:00:00-04:00,0,5,5,6,0,2751,20453,23204
2017-05-21 06:00:00-04:00,0,5,6,6,0,2750,21136,23886
2017-05-21 07:00:00-04:00,0,5,7,6,0,2606,18521,21127
2017-05-21 08:00:00-04:00,0,5,8,6,0,2717,18230,20947
2017-05-21 09:00:00-04:00,0,5,9,6,0,2831,20269,23100
2017-05-21 10:00:00-04:00,0,5,10,6,0,2902,20714,23616
2017-05-21 11:00:00-04:00,0,5,11,6,0,2608,18901,21509
2017-05-21 12:00:00-04:00,0,5,12,6,0,2230,16615,18845
2017-05-21 13:00:00-04:00,0,5,13,6,0,1941,13713,15654
2017-05-21 14:00:00-04:00,0,5,14,6,0,1594,10566,12160
2017-05-21 15:00:00-04:00,0,5,15,6,0,1118,7189,8307
2017-05-21 16:00:00-04:00,0,5,16,6,0,560,3390,3950
2017-05-21 17:00:00-04:00,0,5,17,6,0,373,3501,3874
2017-05-21 18:00:00-04:00,0,5,18,6,0,429,5213,5642
2017-05-21 19:00:00-04:00,0,5,19,6,0,633,7994,8627
2017-05-21 20:00:00-04:00,0,5,20,6,0,968,11575,12543
2017-05-21 21:00:00-04:00,0,5,21,6,0,1175,14335,15510
2017-05-21 22:00:00-04:00,0,5,22,6,0,1365,16272,17637
2017-05-21 23:00:00-04:00,0,5,23,6,0,1536,17219,18755
2017-05-22 00:00:00-04:00,0,5,0,0,0,1543,17456,18999
2017-05-22 01:00:00-04:00,0,5,1,0,0,1763,18061,19824
2017-05-22 02:00:00-04:00,0,5,2,0,0,1863,16604,18467
2017-05-22 03:00:00-04:00,0.01,5,3,0,0,1937,15912,17849
2017-05-22 04:00:00-04:00,0.1,5,4,0,0,2023,16354,18377
2017-05-22 05:00:00-04:00,0,5,5,0,0,2162,17315,19477
2017-05-22 06:00:00-04:00,0,5,6,0,0,2175,17097,19272
2017-05-22 07:00:00-04:00,0,5,7,0,0,2013,15558,17571
2017-05-22 08:00:00-04:00,0,5,8,0,0,1844,14982,16826
2017-05-22 09:00:00-04:00,0,5,9,0,0,1608,13012,14620
2017-05-22 10:00:00-04:00,0.03,5,10,0,0,1431,10573,12004
2017-05-22 11:00:00-04:00,0.04,5,11,0,0,1062,6193,7255
2017-05-22 12:00:00-04:00,0.03,5,12,0,0,695,3987,4682
2017-05-22 13:00:00-04:00,0.06,5,13,0,0,371,2297,2668
2017-05-22 14:00:00-04:00,0.06,5,14,0,0,287,1614,1901
2017-05-22 15:00:00-04:00,0.16,5,15,0,0,311,2177,2488
2017-05-22 16:00:00-04:00,0.09,5,16,0,0,268,3997,4265
2017-05-22 17:00:00-04:00,0.05,5,17,0,0,512,9145,9657
2017-05-22 18:00:00-04:00,0.01,5,18,0,0,1145,15452,16597
2017-05-22 19:00:00-04:00,0,5,19,0,0,1694,18308,20002
2017-05-22 20:00:00-04:00,0,5,20,0,0,1725,18010,19735
2017-05-22 21:00:00-04:00,0,5,21,0,0,1418,16220,17638
2017-05-22 22:00:00-04:00,0,5,22,0,0,1452,16211,17663
2017-05-22 23:00:00-04:00,0,5,23,0,0,1426,15882,17308
2017-05-23 00:00:00-04:00,0,5,0,1,0,1306,16039,17345
2017-05-23 01:00:00-04:00,0,5,1,1,0,1655,17707,19362
2017-05-23 02:00:00-04:00,0,5,2,1,0,1943,17247,19190
2017-05-23 03:00:00-04:00,0,5,3,1,0,1926,14859,16785
2017-05-23 04:00:00-04:00,0,5,4,1,0,2194,17330,19524
2017-05-23 05:00:00-04:00,0,5,5,1,0,2190,18244,20434
2017-05-23 06:00:00-04:00,0,5,6,1,0,1825,18062,19887
2017-05-23 07:00:00-04:00,0,5,7,1,0,1456,17348,18804
2017-05-23 08:00:00-04:00,0,5,8,1,0,1272,16438,17710
2017-05-23 09:00:00-04:00,0,5,9,1,0,1145,14218,15363
2017-05-23 10:00:00-04:00,0,5,10,1,0,951,10324,11275
2017-05-23 11:00:00-04:00,0,5,11,1,0,718,6849,7567
2017-05-23 12:00:00-04:00,0,5,12,1,0,408,4075,4483
2017-05-23 13:00:00-04:00,0,5,13,1,0,261,2400,2661
2017-05-23 14:00:00-04:00,0,5,14,1,0,208,1562,1770
2017-05-23 15:00:00-04:00,0,5,15,1,0,191,1697,1888
2017-05-23 16:00:00-04:00,0,5,16,1,0,265,3442,3707
2017-05-23 17:00:00-04:00,0,5,17,1,0,469,8900,9369
2017-05-23 18:00:00-04:00,0,5,18,1,0,1093,15551,16644
2017-05-23 19:00:00-04:00,0,5,19,1,0,1646,18070,19716
2017-05-23 20:00:00-04:00,0,5,20,1,0,1485,16969,18454
2017-05-23 21:00:00-04:00,0,5,21,1,0,1350,15228,16578
2017-05-23 22:00:00-04:00,0,5,22,1,0,1260,15562,16822
2017-05-23 23:00:00-04:00,0,5,23,1,0,1265,15932,17197
2017-05-24 00:00:00-04:00,0,5,0,2,0,1201,15813,17014
2017-05-24 01:00:00-04:00,0,5,1,2,0,1397,17345,18742
2017-05-24 02:00:00-04:00,0,5,2,2,0,1571,16890,18461
2017-05-24 03:00:00-04:00,0,5,3,2,0,1788,14902,16690
2017-05-24 04:00:00-04:00,0,5,4,2,0,2003,17939,19942
2017-05-24 05:00:00-04:00,0.03,5,5,2,0,2175,21322,23497
2017-05-24 06:00:00-04:00,0,5,6,2,0,2142,20808,22950
2017-05-24 07:00:00-04:00,0,5,7,2,0,1719,19839,21558
2017-05-24 08:00:00-04:00,0,5,8,2,0,1692,20563,22255
2017-05-24 09:00:00-04:00,0,5,9,2,0,1503,18648,20151
2017-05-24 10:00:00-04:00,0,5,10,2,0,1244,13328,14572
2017-05-24 11:00:00-04:00,0,5,11,2,0,913,8505,9418
2017-05-24 12:00:00-04:00,0,5,12,2,0,611,4759,5370
2017-05-24 13:00:00-04:00,0,5,13,2,0,335,2926,3261
2017-05-24 14:00:00-04:00,0,5,14,2,0,253,2044,2297
2017-05-24 15:00:00-04:00,0,5,15,2,0,265,2126,2391
2017-05-24 16:00:00-04:00,0,5,16,2,0,239,3776,4015
2017-05-24 17:00:00-04:00,0,5,17,2,0,500,10154,10654
2017-05-24 18:00:00-04:00,0,5,18,2,0,1105,16281,17386
2017-05-24 19:00:00-04:00,0,5,19,2,0,1669,18880,20549
2017-05-24 20:00:00-04:00,0,5,20,2,0,1639,17835,19474
2017-05-24 21:00:00-04:00,0,5,21,2,0,1441,16040,17481
2017-05-24 22:00:00-04:00,0,5,22,2,0,1375,16255,17630
2017-05-24 23:00:00-04:00,0,5,23,2,0,1422,17001,18423
2017-05-25 00:00:00-04:00,0,5,0,3,0,1293,16483,17776
2017-05-25 01:00:00-04:00,0,5,1,3,0,1524,17422,18946
2017-05-25 02:00:00-04:00,0,5,2,3,0,1603,16411,18014
2017-05-25 03:00:00-04:00,0,5,3,3,0,1852,14694,16546
2017-05-25 04:00:00-04:00,0.01,5,4,3,0,2110,16855,18965
2017-05-25 05:00:00-04:00,0.02,5,5,3,0,2405,19812,22217
2017-05-25 06:00:00-04:00,0.02,5,6,3,0,2256,20686,22942
2017-05-25 07:00:00-04:00,0.05,5,7,3,0,1922,20611,22533
2017-05-25 08:00:00-04:00,0.09,5,8,3,0,1872,21621,23493
2017-05-25 09:00:00-04:00,0.13,5,9,3,0,1672,19778,21450
2017-05-25 10:00:00-04:00,0.06,5,10,3,0,1378,15623,17001
2017-05-25 11:00:00-04:00,0.07,5,11,3,0,1056,9883,10939
2017-05-25 12:00:00-04:00,0.16,5,12,3,0,632,5824,6456
2017-05-25 13:00:00-04:00,0.04,5,13,3,0,405,3498,3903
2017-05-25 14:00:00-04:00,0.03,5,14,3,0,271,2387,2658
2017-05-25 15:00:00-04:00,0.01,5,15,3,0,240,2343,2583
2017-05-25 16:00:00-04:00,0,5,16,3,0,251,3884,4135
2017-05-25 17:00:00-04:00,0,5,17,3,0,488,10256,10744
2017-05-25 18:00:00-04:00,0,5,18,3,0,1246,18199,19445
2017-05-25 19:00:00-04:00,0.01,5,19,3,0,1919,20321,22240
2017-05-25 20:00:00-04:00,0,5,20,3,0,1957,18971,20928
2017-05-25 21:00:00-04:00,0,5,21,3,0,1652,16930,18582
2017-05-25 22:00:00-04:00,0,5,22,3,0,1584,17195,18779
2017-05-25 23:00:00-04:00,0.04,5,23,3,0,1497,16510,18007
2017-05-26 00:00:00-04:00,0.13,5,0,4,0,1429,16257,17686
2017-05-26 01:00:00-04:00,0,5,1,4,0,1594,16823,18417
2017-05-26 02:00:00-04:00,0.01,5,2,4,0,1704,15706,17410
2017-05-26 03:00:00-04:00,0.02,5,3,4,0,1746,13107,14853
2017-05-26 04:00:00-04:00,0.07,5,4,4,0,1899,15530,17429
2017-05-26 05:00:00-04:00,0.01,5,5,4,0,2244,18832,21076
2017-05-26 06:00:00-04:00,0.01,5,6,4,0,2212,19675,21887
2017-05-26 07:00:00-04:00,0,5,7,4,0,2140,20915,23055
2017-05-26 08:00:00-04:00,0,5,8,4,0,2216,21542,23758
2017-05-26 09:00:00-04:00,0,5,9,4,0,1878,20131,22009
2017-05-26 10:00:00-04:00,0,5,10,4,0,1801,17726,19527
2017-05-26 11:00:00-04:00,0,5,11,4,0,1396,11941,13337
2017-05-26 12:00:00-04:00,0,5,12,4,0,971,8464,9435
2017-05-26 13:00:00-04:00,0,5,13,4,0,680,6124,6804
2017-05-26 14:00:00-04:00,0,5,14,4,0,444,3849,4293
2017-05-26 15:00:00-04:00,0,5,15,4,0,401,3354,3755
2017-05-26 16:00:00-04:00,0,5,16,4,0,313,4156,4469
2017-05-26 17:00:00-04:00,0,5,17,4,0,504,9460,9964
2017-05-26 18:00:00-04:00,0,5,18,4,0,1123,14097,15220
2017-05-26 19:00:00-04:00,0,5,19,4,0,1650,16044,17694
2017-05-26 20:00:00-04:00,0,5,20,4,0,1526,14925,16451
2017-05-26 21:00:00-04:00,0,5,21,4,0,1421,13888,15309
2017-05-26 22:00:00-04:00,0,5,22,4,0,1423,14423,15846
2017-05-26 23:00:00-04:00,0,5,23,4,0,1392,15652,17044
2017-05-27 00:00:00-04:00,0,5,0,5,0,1365,15351,16716
2017-05-27 01:00:00-04:00,0,5,1,5,0,1649,16664,18313
2017-05-27 02:00:00-04:00,0,5,2,5,0,1950,15352,17302
2017-05-27 03:00:00-04:00,0,5,3,5,0,2111,13558,15669
2017-05-27 04:00:00-04:00,0,5,4,5,0,2312,15170,17482
2017-05-27 05:00:00-04:00,0,5,5,5,0,2471,16891,19362
2017-05-27 06:00:00-04:00,0,5,6,5,0,2419,16326,18745
2017-05-27 07:00:00-04:00,0,5,7,5,0,2178,14321,16499
2017-05-27 08:00:00-04:00,0,5,8,5,0,2066,14768,16834
2017-05-27 09:00:00-04:00,0,5,9,5,0,1902,15936,17838
2017-05-27 10:00:00-04:00,0,5,10,5,0,2059,15343,17402
2017-05-27 11:00:00-04:00,0,5,11,5,0,2135,14199,16334
2017-05-27 12:00:00-04:00,0,5,12,5,0,1803,11717,13520
2017-05-27 13:00:00-04:00,0,5,13,5,0,1383,9381,10764
2017-05-27 14:00:00-04:00,0,5,14,5,0,919,7229,8148
2017-05-27 15:00:00-04:00,0,5,15,5,0,767,5143,5910
2017-05-27 16:00:00-04:00,0,5,16,5,0,479,2863,3342
2017-05-27 17:00:00-04:00,0,5,17,5,0,483,3632,4115
2017-05-27 18:00:00-04:00,0,5,18,5,0,561,5167,5728
2017-05-27 19:00:00-04:00,0,5,19,5,0,818,6979,7797
2017-05-27 20:00:00-04:00,0,5,20,5,0,1106,9890,10996
2017-05-27 21:00:00-04:00,0,5,21,5,0,1323,11876,13199
2017-05-27 22:00:00-04:00,0,5,22,5,0,1562,12764,14326
2017-05-27 23:00:00-04:00,0,5,23,5,0,1723,13404,15127
2017-05-28 00:00:00-04:00,0,5,0,6,0,1642,14212,15854
2017-05-28 01:00:00-04:00,0,5,1,6,0,1882,13241,15123
2017-05-28 02:00:00-04:00,0,5,2,6,0,2063,13520,15583
2017-05-28 03:00:00-04:00,0,5,3,6,0,2238,13205,15443
2017-05-28 04:00:00-04:00,0,5,4,6,0,2252,14053,16305
2017-05-28 05:00:00-04:00,0,5,5,6,0,2176,14668,16844
2017-05-28 06:00:00-04:00,0,5,6,6,0,2010,15374,17384
2017-05-28 07:00:00-04:00,0,5,7,6,0,1494,12817,14311
2017-05-28 08:00:00-04:00,0,5,8,6,0,1696,13141,14837
2017-05-28 09:00:00-04:00,0,5,9,6,0,1877,14672,16549
2017-05-28 10:00:00-04:00,0,5,10,6,0,2039,14258,16297
2017-05-28 11:00:00-04:00,0,5,11,6,0,1936,12201,14137
2017-05-28 12:00:00-04:00,0,5,12,6,0,1760,10127,11887
2017-05-28 13:00:00-04:00,0,5,13,6,0,1453,8532,9985
2017-05-28 14:00:00-04:00,0,5,14,6,0,934,6834,7768
2017-05-28 15:00:00-04:00,0,5,15,6,0,780,4867,5647
2017-05-28 16:00:00-04:00,0,5,16,6,0,458,2257,2715
2017-05-28 17:00:00-04:00,0,5,17,6,0,352,2424,2776
2017-05-28 18:00:00-04:00,0,5,18,6,0,403,3500,3903
2017-05-28 19:00:00-04:00,0,5,19,6,0,500,4882,5382
2017-05-28 20:00:00-04:00,0,5,20,6,0,810,7377,8187
2017-05-28 21:00:00-04:00,0,5,21,6,0,1060,9837,10897
2017-05-28 22:00:00-04:00,0,5,22,6,0,1253,11484,12737
2017-05-28 23:00:00-04:00,0,5,23,6,0,1487,12484,13971
2017-05-29 00:00:00-04:00,0,5,0,0,1,1380,12981,14361
2017-05-29 01:00:00-04:00,0.01,5,1,0,1,1717,13185,14902
2017-05-29 02:00:00-04:00,0,5,2,0,1,1887,12757,14644
2017-05-29 03:00:00-04:00,0,5,3,0,1,1955,13109,15064
2017-05-29 04:00:00-04:00,0.06,5,4,0,1,1963,14757,16720
2017-05-29 05:00:00-04:00,0.03,5,5,0,1,2109,14589,16698
2017-05-29 06:00:00-04:00,0.03,5,6,0,1,1709,13620,15329
2017-05-29 07:00:00-04:00,0,5,7,0,1,1220,12745,13965
2017-05-29 08:00:00-04:00,0,5,8,0,1,1466,13195,14661
2017-05-29 09:00:00-04:00,0,5,9,0,1,1459,12399,13858
2017-05-29 10:00:00-04:00,0,5,10,0,1,1598,11267,12865
2017-05-29 11:00:00-04:00,0.01,5,11,0,1,1470,8962,10432
2017-05-29 12:00:00-04:00,0.02,5,12,0,1,1141,6424,7565
2017-05-29 13:00:00-04:00,0,5,13,0,1,797,4924,5721
2017-05-29 14:00:00-04:00,0,5,14,0,1,472,3550,4022
2017-05-29 15:00:00-04:00,0,5,15,0,1,476,2903,3379
2017-05-29 16:00:00-04:00,0,5,16,0,1,313,1970,2283
2017-05-29 17:00:00-04:00,0,5,17,0,1,346,2678,3024
2017-05-29 18:00:00-04:00,0,5,18,0,1,401,3357,3758
2017-05-29 19:00:00-04:00,0,5,19,0,1,441,4384,4825
2017-05-29 20:00:00-04:00,0,5,20,0,1,634,6289,6923
2017-05-29 21:00:00-04:00,0,5,21,0,1,818,9316,10134
2017-05-29 22:00:00-04:00,0,5,22,0,1,982,11108,12090
2017-05-29 23:00:00-04:00,0,5,23,0,1,1104,12899,14003
2017-05-30 00:00:00-04:00,0,5,0,1,0,1096,11848,12944
2017-05-30 01:00:00-04:00,0,5,1,1,0,1409,12987,14396
2017-05-30 02:00:00-04:00,0,5,2,1,0,1577,13689,15266
2017-05-30 03:00:00-04:00,0,5,3,1,0,1614,13092,14706
2017-05-30 04:00:00-04:00,0,5,4,1,0,1659,13885,15544
2017-05-30 05:00:00-04:00,0,5,5,1,0,1637,14284,15921
2017-05-30 06:00:00-04:00,0,5,6,1,0,1421,13009,14430
2017-05-30 07:00:00-04:00,0,5,7,1,0,999,11795,12794
2017-05-30 08:00:00-04:00,0,5,8,1,0,1131,12042,13173
2017-05-30 09:00:00-04:00,0,5,9,1,0,958,10407,11365
2017-05-30 10:00:00-04:00,0,5,10,1,0,833,7552,8385
2017-05-30 11:00:00-04:00,0,5,11,1,0,629,4744,5373
2017-05-30 12:00:00-04:00,0,5,12,1,0,424,2653,3077
2017-05-30 13:00:00-04:00,0,5,13,1,0,232,1703,1935
2017-05-30 14:00:00-04:00,0,5,14,1,0,134,1133,1267
2017-05-30 15:00:00-04:00,0.01,5,15,1,0,189,1652,1841
2017-05-30 16:00:00-04:00,0,5,16,1,0,224,3309,3533
2017-05-30 17:00:00-04:00,0,5,17,1,0,530,8756,9286
2017-05-30 18:00:00-04:00,0,5,18,1,0,1097,14362,15459
2017-05-30 19:00:00-04:00,0,5,19,1,0,1620,16917,18537
2017-05-30 20:00:00-04:00,0,5,20,1,0,1607,15916,17523
2017-05-30 21:00:00-04:00,0,5,21,1,0,1486,14372,15858
2017-05-30 22:00:00-04:00,0,5,22,1,0,1312,14554,15866
2017-05-30 23:00:00-04:00,0.01,5,23,1,0,1350,15119,16469
2017-05-31 00:00:00-04:00,0.01,5,0,2,0,1313,15408,16721
2017-05-31 01:00:00-04:00,0,5,1,2,0,1743,20278,22021
2017-05-31 02:00:00-04:00,0,5,2,2,0,1684,15967,17651
2017-05-31 03:00:00-04:00,0,5,3,2,0,1740,13927,15667
2017-05-31 04:00:00-04:00,0,5,4,2,0,1939,16184,18123
2017-05-31 05:00:00-04:00,0,5,5,2,0,2107,19673,21780
2017-05-31 06:00:00-04:00,0.02,5,6,2,0,1808,18529,20337
2017-05-31 07:00:00-04:00,0.03,5,7,2,0,1223,17348,18571
2017-05-31 08:00:00-04:00,0,5,8,2,0,1298,17460,18758
2017-05-31 09:00:00-04:00,0,5,9,2,0,1177,16134,17311
2017-05-31 10:00:00-04:00,0,5,10,2,0,1012,10540,11552
2017-05-31 11:00:00-04:00,0,5,11,2,0,718,6567,7285
2017-05-31 12:00:00-04:00,0,5,12,2,0,442,4198,4640
2017-05-31 13:00:00-04:00,0,5,13,2,0,263,2629,2892
2017-05-31 14:00:00-04:00,0,5,14,2,0,165,1649,1814
2017-05-31 15:00:00-04:00,0,5,15,2,0,165,1803,1968
2017-05-31 16:00:00-04:00,0,5,16,2,0,213,3329,3542
2017-05-31 17:00:00-04:00,0,5,17,2,0,490,9596,10086
2017-05-31 18:00:00-04:00,0,5,18,2,0,1016,16313,17329
2017-05-31 19:00:00-04:00,0,5,19,2,0,1593,18904,20497
2017-05-31 20:00:00-04:00,0,5,20,2,0,1589,16629,18218
2017-05-31 21:00:00-04:00,0,5,21,2,0,1378,15140,16518
2017-05-31 22:00:00-04:00,0,5,22,2,0,1330,14981,16311
2017-05-31 23:00:00-04:00,0,5,23,2,0,1571,16254,17825
2017-06-01 00:00:00-04:00,0,6,0,3,0,1400,16245,17645
2017-06-01 01:00:00-04:00,0,6,1,3,0,1558,16569,18127
2017-06-01 02:00:00-04:00,0,6,2,3,0,1748,16437,18185
2017-06-01 03:00:00-04:00,0,6,3,3,0,1944,15144,17088
2017-06-01 04:00:00-04:00,0,6,4,3,0,2265,18388,20653
2017-06-01 05:00:00-04:00,0,6,5,3,0,2269,21600,23869
2017-06-01 06:00:00-04:00,0,6,6,3,0,2028,21055,23083
2017-06-01 07:00:00-04:00,0,6,7,3,0,1330,19285,20615
2017-06-01 08:00:00-04:00,0,6,8,3,0,1560,22659,24219
2017-06-01 09:00:00-04:00,0,6,9,3,0,1334,18714,20048
2017-06-01 10:00:00-04:00,0,6,10,3,0,1184,13701,14885
2017-06-01 11:00:00-04:00,0,6,11,3,0,896,8474,9370
2017-06-01 12:00:00-04:00,0,6,12,3,0,577,5083,5660
2017-06-01 13:00:00-04:00,0,6,13,3,0,345,3215,3560
2017-06-01 14:00:00-04:00,0,6,14,3,0,212,2187,2399
2017-06-01 15:00:00-04:00,0,6,15,3,0,181,2012,2193
2017-06-01 16:00:00-04:00,0,6,16,3,0,279,3477,3756
2017-06-01 17:00:00-04:00,0,6,17,3,0,513,8581,9094
2017-06-01 18:00:00-04:00,0,6,18,3,0,1146,15821,16967
2017-06-01 19:00:00-04:00,0,6,19,3,0,1688,18514,20202
2017-06-01 20:00:00-04:00,0,6,20,3,0,1678,17009,18687
2017-06-01 21:00:00-04:00,0,6,21,3,0,1474,15778,17252
2017-06-01 22:00:00-04:00,0,6,22,3,0,1380,15863,17243
2017-06-01 23:00:00-04:00,0,6,23,3,0,1458,16635,18093
2017-06-02 00:00:00-04:00,0,6,0,4,0,1404,16465,17869
2017-06-02 01:00:00-04:00,0,6,1,4,0,1706,17834,19540
2017-06-02 02:00:00-04:00,0,6,2,4,0,1854,17195,19049
2017-06-02 03:00:00-04:00,0,6,3,4,0,2079,15359,17438
2017-06-02 04:00:00-04:00,0,6,4,4,0,2382,18153,20535
2017-06-02 05:00:00-04:00,0,6,5,4,0,2585,21824,24409
2017-06-02 06:00:00-04:00,0,6,6,4,0,2147,21947,24094
2017-06-02 07:00:00-04:00,0,6,7,4,0,1560,20434,21994
2017-06-02 08:00:00-04:00,0,6,8,4,0,1611,22779,24390
2017-06-02 09:00:00-04:00,0,6,9,4,0,1511,21444,22955
2017-06-02 10:00:00-04:00,0,6,10,4,0,1525,18424,19949
2017-06-02 11:00:00-04:00,0,6,11,4,0,1321,12558,13879
2017-06-02 12:00:00-04:00,0,6,12,4,0,919,8047,8966
2017-06-02 13:00:00-04:00,0,6,13,4,0,577,5098,5675
2017-06-02 14:00:00-04:00,0,6,14,4,0,327,3391,3718
2017-06-02 15:00:00-04:00,0,6,15,4,0,299,3040,3339
2017-06-02 16:00:00-04:00,0,6,16,4,0,288,3782,4070
2017-06-02 17:00:00-04:00,0,6,17,4,0,549,8622,9171
2017-06-02 18:00:00-04:00,0,6,18,4,0,1189,15345,16534
2017-06-02 19:00:00-04:00,0,6,19,4,0,1617,18211,19828
2017-06-02 20:00:00-04:00,0,6,20,4,0,1716,16698,18414
2017-06-02 21:00:00-04:00,0,6,21,4,0,1507,15790,17297
2017-06-02 22:00:00-04:00,0,6,22,4,0,1521,16521,18042
2017-06-02 23:00:00-04:00,0,6,23,4,0,1522,16646,18168
2017-06-03 00:00:00-04:00,0,6,0,5,0,1413,15952,17365
2017-06-03 01:00:00-04:00,0,6,1,5,0,1847,17492,19339
2017-06-03 02:00:00-04:00,0,6,2,5,0,2109,16458,18567
2017-06-03 03:00:00-04:00,0,6,3,5,0,2410,14714,17124
2017-06-03 04:00:00-04:00,0,6,4,5,0,2539,17194,19733
2017-06-03 05:00:00-04:00,0,6,5,5,0,2762,21187,23949
2017-06-03 06:00:00-04:00,0,6,6,5,0,2488,21106,23594
2017-06-03 07:00:00-04:00,0,6,7,5,0,1755,18791,20546
2017-06-03 08:00:00-04:00,0,6,8,5,0,2061,19732,21793
2017-06-03 09:00:00-04:00,0,6,9,5,0,2280,20762,23042
2017-06-03 10:00:00-04:00,0,6,10,5,0,2512,20267,22779
2017-06-03 11:00:00-04:00,0,6,11,5,0,2391,18711,21102
2017-06-03 12:00:00-04:00,0,6,12,5,0,1968,14383,16351
2017-06-03 13:00:00-04:00,0,6,13,5,0,1460,11156,12616
2017-06-03 14:00:00-04:00,0,6,14,5,0,993,8155,9148
2017-06-03 15:00:00-04:00,0,6,15,5,0,769,5315,6084
2017-06-03 16:00:00-04:00,0,6,16,5,0,434,2803,3237
2017-06-03 17:00:00-04:00,0,6,17,5,0,447,4028,4475
2017-06-03 18:00:00-04:00,0,6,18,5,0,636,7905,8541
2017-06-03 19:00:00-04:00,0,6,19,5,0,858,9324,10182
2017-06-03 20:00:00-04:00,0,6,20,5,0,1211,12875,14086
2017-06-03 21:00:00-04:00,0,6,21,5,0,1442,15014,16456
2017-06-03 22:00:00-04:00,0,6,22,5,0,1669,16247,17916
2017-06-03 23:00:00-04:00,0,6,23,5,0,1840,17466,19306
2017-06-04 00:00:00-04:00,0,6,0,6,0,1938,18067,20005
2017-06-04 01:00:00-04:00,0,6,1,6,0,2241,17471,19712
2017-06-04 02:00:00-04:00,0,6,2,6,0,2364,16635,18999
2017-06-04 03:00:00-04:00,0,6,3,6,0,2495,16011,18506
2017-06-04 04:00:00-04:00,0,6,4,6,0,2428,18034,20462
2017-06-04 05:00:00-04:00,0,6,5,6,0,2657,18946,21603
2017-06-04 06:00:00-04:00,0,6,6,6,0,2383,19491,21874
2017-06-04 07:00:00-04:00,0,6,7,6,0,1675,16200,17875
2017-06-04 08:00:00-04:00,0,6,8,6,0,2088,17317,19405
2017-06-04 09:00:00-04:00,0,6,9,6,0,2338,19569,21907
2017-06-04 10:00:00-04:00,0,6,10,6,0,2494,20684,23178
2017-06-04 11:00:00-04:00,0,6,11,6,0,2487,18558,21045
2017-06-04 12:00:00-04:00,0,6,12,6,0,2320,15532,17852
2017-06-04 13:00:00-04:00,0,6,13,6,0,1706,12628,14334
2017-06-04 14:00:00-04:00,0,6,14,6,0,1143,9536,10679
2017-06-04 15:00:00-04:00,0,6,15,6,0,968,6226,7194
2017-06-04 16:00:00-04:00,0.01,6,16,6,0,489,2805,3294
2017-06-04 17:00:00-04:00,0,6,17,6,0,355,3075,3430
2017-06-04 18:00:00-04:00,0,6,18,6,0,390,4559,4949
2017-06-04 19:00:00-04:00,0,6,19,6,0,524,7126,7650
2017-06-04 20:00:00-04:00,0,6,20,6,0,894,10069,10963
2017-06-04 21:00:00-04:00,0,6,21,6,0,1153,13261,14414
2017-06-04 22:00:00-04:00,0,6,22,6,0,1410,14907,16317
2017-06-04 23:00:00-04:00,0,6,23,6,0,1609,16100,17709
2017-06-05 00:00:00-04:00,0.02,6,0,0,0,1740,17712,19452
2017-06-05 01:00:00-04:00,0.02,6,1,0,0,1984,16695,18679
2017-06-05 02:00:00-04:00,0,6,2,0,0,2222,16717,18939
2017-06-05 03:00:00-04:00,0.01,6,3,0,0,2153,15428,17581
2017-06-05 04:00:00-04:00,0,6,4,0,0,2094,15696,17790
2017-06-05 05:00:00-04:00,0,6,5,0,0,2168,16711,18879
2017-06-05 06:00:00-04:00,0,6,6,0,0,1662,14392,16054
2017-06-05 07:00:00-04:00,0,6,7,0,0,1081,12662,13743
2017-06-05 08:00:00-04:00,0,6,8,0,0,1281,13025,14306
2017-06-05 09:00:00-04:00,0,6,9,0,0,1300,11361,12661
2017-06-05 10:00:00-04:00,0,6,10,0,0,1353,9455,10808
2017-06-05 11:00:00-04:00,0,6,11,0,0,1042,6413,7455
2017-06-05 12:00:00-04:00,0,6,12,0,0,622,3062,3684
2017-06-05 13:00:00-04:00,0,6,13,0,0,358,2086,2444
2017-06-05 14:00:00-04:00,0,6,14,0,0,245,1367,1612
2017-06-05 15:00:00-04:00,0,6,15,0,0,269,1848,2117
2017-06-05 16:00:00-04:00,0,6,16,0,0,294,3527,3821
2017-06-05 17:00:00-04:00,0,6,17,0,0,472,8724,9196
2017-06-05 18:00:00-04:00,0,6,18,0,0,1138,15159,16297
2017-06-05 19:00:00-04:00,0,6,19,0,0,1651,17645,19296
2017-06-05 20:00:00-04:00,0,6,20,0,0,1524,16152,17676
2017-06-05 21:00:00-04:00,0,6,21,0,0,1307,14259,15566
2017-06-05 22:00:00-04:00,0,6,22,0,0,1196,14499,15695
2017-06-05 23:00:00-04:00,0,6,23,0,0,1239,14811,16050
2017-06-06 00:00:00-04:00,0,6,0,1,0,1244,14793,16037
2017-06-06 01:00:00-04:00,0,6,1,1,0,1446,16191,17637
2017-06-06 02:00:00-04:00,0,6,2,1,0,1681,16808,18489
2017-06-06 03:00:00-04:00,0,6,3,1,0,1806,15268,17074
2017-06-06 04:00:00-04:00,0,6,4,1,0,2011,17736,19747
2017-06-06 05:00:00-04:00,0,6,5,1,0,2217,21228,23445
2017-06-06 06:00:00-04:00,0,6,6,1,0,1837,20581,22418
2017-06-06 07:00:00-04:00,0,6,7,1,0,1186,17503,18689
2017-06-06 08:00:00-04:00,0.02,6,8,1,0,1133,17623,18756
2017-06-06 09:00:00-04:00,0,6,9,1,0,928,15415,16343
2017-06-06 10:00:00-04:00,0,6,10,1,0,930,11344,12274
2017-06-06 11:00:00-04:00,0,6,11,1,0,769,7626,8395
2017-06-06 12:00:00-04:00,0.01,6,12,1,0,499,4033,4532
2017-06-06 13:00:00-04:00,0,6,13,1,0,252,2291,2543
2017-06-06 14:00:00-04:00,0,6,14,1,0,168,1560,1728
2017-06-06 15:00:00-04:00,0,6,15,1,0,181,1638,1819
2017-06-06 16:00:00-04:00,0,6,16,1,0,210,3352,3562
2017-06-06 17:00:00-04:00,0,6,17,1,0,443,9087,9530
2017-06-06 18:00:00-04:00,0,6,18,1,0,1196,17416,18612
2017-06-06 19:00:00-04:00,0,6,19,1,0,1718,20108,21826
2017-06-06 20:00:00-04:00,0,6,20,1,0,1611,17506,19117
2017-06-06 21:00:00-04:00,0,6,21,1,0,1493,16361,17854
2017-06-06 22:00:00-04:00,0,6,22,1,0,1335,17001,18336
2017-06-06 23:00:00-04:00,0,6,23,1,0,1368,17361,18729
2017-06-07 00:00:00-04:00,0,6,0,2,0,1352,17468,18820
2017-06-07 01:00:00-04:00,0,6,1,2,0,1487,17440,18927
2017-06-07 02:00:00-04:00,0,6,2,2,0,1745,17025,18770
2017-06-07 03:00:00-04:00,0,6,3,2,0,1875,15437,17312
2017-06-07 04:00:00-04:00,0,6,4,2,0,2154,18730,20884
2017-06-07 05:00:00-04:00,0,6,5,2,0,2384,22478,24862
2017-06-07 06:00:00-04:00,0,6,6,2,0,2066,22800,24866
2017-06-07 07:00:00-04:00,0,6,7,2,0,1383,20475,21858
2017-06-07 08:00:00-04:00,0,6,8,2,0,1384,21286,22670
2017-06-07 09:00:00-04:00,0,6,9,2,0,1297,19347,20644
2017-06-07 10:00:00-04:00,0,6,10,2,0,1249,13673,14922
2017-06-07 11:00:00-04:00,0,6,11,2,0,976,8731,9707
2017-06-07 12:00:00-04:00,0,6,12,2,0,577,4798,5375
2017-06-07 13:00:00-04:00,0,6,13,2,0,291,2932,3223
2017-06-07 14:00:00-04:00,0,6,14,2,0,196,1972,2168
2017-06-07 15:00:00-04:00,0,6,15,2,0,185,2064,2249
2017-06-07 16:00:00-04:00,0,6,16,2,0,229,3341,3570
2017-06-07 17:00:00-04:00,0,6,17,2,0,430,8901,9331
2017-06-07 18:00:00-04:00,0,6,18,2,0,1033,16194,17227
2017-06-07 19:00:00-04:00,0,6,19,2,0,1522,19182,20704
2017-06-07 20:00:00-04:00,0,6,20,2,0,1522,17410,18932
2017-06-07 21:00:00-04:00,0,6,21,2,0,1351,16176,17527
2017-06-07 22:00:00-04:00,0,6,22,2,0,1352,16246,17598
2017-06-07 23:00:00-04:00,0,6,23,2,0,1410,16809,18219
2017-06-08 00:00:00-04:00,0,6,0,3,0,1323,16703,18026
2017-06-08 01:00:00-04:00,0,6,1,3,0,1533,17735,19268
2017-06-08 02:00:00-04:00,0,6,2,3,0,1742,16788,18530
2017-06-08 03:00:00-04:00,0,6,3,3,0,1965,15070,17035
2017-06-08 04:00:00-04:00,0,6,4,3,0,2166,17417,19583
2017-06-08 05:00:00-04:00,0,6,5,3,0,2337,20907,23244
2017-06-08 06:00:00-04:00,0,6,6,3,0,2100,21608,23708
2017-06-08 07:00:00-04:00,0,6,7,3,0,1471,20123,21594
2017-06-08 08:00:00-04:00,0,6,8,3,0,1559,21833,23392
2017-06-08 09:00:00-04:00,0,6,9,3,0,1464,20602,22066
2017-06-08 10:00:00-04:00,0,6,10,3,0,1413,16266,17679
2017-06-08 11:00:00-04:00,0,6,11,3,0,1220,11714,12934
2017-06-08 12:00:00-04:00,0,6,12,3,0,765,6084,6849
2017-06-08 13:00:00-04:00,0,6,13,3,0,427,3578,4005
2017-06-08 14:00:00-04:00,0,6,14,3,0,257,2522,2779
2017-06-08 15:00:00-04:00,0,6,15,3,0,236,2349,2585
2017-06-08 16:00:00-04:00,0,6,16,3,0,279,3530,3809
2017-06-08 17:00:00-04:00,0,6,17,3,0,501,9069,9570
2017-06-08 18:00:00-04:00,0,6,18,3,0,1030,15691,16721
2017-06-08 19:00:00-04:00,0,6,19,3,0,1542,18633,20175
2017-06-08 20:00:00-04:00,0,6,20,3,0,1592,17368,18960
2017-06-08 21:00:00-04:00,0,6,21,3,0,1360,16046,17406
2017-06-08 22:00:00-04:00,0,6,22,3,0,1327,16642,17969
2017-06-08 23:00:00-04:00,0,6,23,3,0,1329,17250,18579
2017-06-09 00:00:00-04:00,0,6,0,4,0,1355,17354,18709
2017-06-09 01:00:00-04:00,0,6,1,4,0,1597,18240,19837
2017-06-09 02:00:00-04:00,0,6,2,4,0,1876,17601,19477
2017-06-09 03:00:00-04:00,0,6,3,4,0,1924,15031,16955
2017-06-09 04:00:00-04:00,0,6,4,4,0,2299,18003,20302
2017-06-09 05:00:00-04:00,0,6,5,4,0,2444,22270,24714
2017-06-09 06:00:00-04:00,0,6,6,4,0,2170,22508,24678
2017-06-09 07:00:00-04:00,0,6,7,4,0,1524,20618,22142
2017-06-09 08:00:00-04:00,0,6,8,4,0,1670,22358,24028
2017-06-09 09:00:00-04:00,0,6,9,4,0,1673,21247,22920
2017-06-09 10:00:00-04:00,0,6,10,4,0,1548,17746,19294
2017-06-09 11:00:00-04:00,0,6,11,4,0,1249,12561,13810
2017-06-09 12:00:00-04:00,0,6,12,4,0,812,8046,8858
2017-06-09 13:00:00-04:00,0,6,13,4,0,438,4858,5296
2017-06-09 14:00:00-04:00,0,6,14,4,0,268,3272,3540
2017-06-09 15:00:00-04:00,0,6,15,4,0,293,2912,3205
2017-06-09 16:00:00-04:00,0,6,16,4,0,285,3963,4248
2017-06-09 17:00:00-04:00,0,6,17,4,0,499,8612,9111
2017-06-09 18:00:00-04:00,0,6,18,4,0,1127,14999,16126
2017-06-09 19:00:00-04:00,0,6,19,4,0,1667,17708,19375
2017-06-09 20:00:00-04:00,0,6,20,4,0,1661,16611,18272
2017-06-09 21:00:00-04:00,0,6,21,4,0,1476,15360,16836
2017-06-09 22:00:00-04:00,0,6,22,4,0,1518,16381,17899
2017-06-09 23:00:00-04:00,0,6,23,4,0,1397,16699,18096
2017-06-10 00:00:00-04:00,0,6,0,5,0,1261,16238,17499
2017-06-10 01:00:00-04:00,0,6,1,5,0,1764,17874,19638
2017-06-10 02:00:00-04:00,0,6,2,5,0,2065,16455,18520
2017-06-10 03:00:00-04:00,0,6,3,5,0,2282,14753,17035
2017-06-10 04:00:00-04:00,0,6,4,5,0,2519,17535,20054
2017-06-10 05:00:00-04:00,0,6,5,5,0,2768,20421,23189
2017-06-10 06:00:00-04:00,0,6,6,5,0,2461,21071,23532
2017-06-10 07:00:00-04:00,0,6,7,5,0,1784,18466,20250
2017-06-10 08:00:00-04:00,0,6,8,5,0,1953,18983,20936
2017-06-10 09:00:00-04:00,0,6,9,5,0,2100,19992,22092
2017-06-10 10:00:00-04:00,0,6,10,5,0,2358,18470,20828
2017-06-10 11:00:00-04:00,0,6,11,5,0,2445,18346,20791
2017-06-10 12:00:00-04:00,0,6,12,5,0,1959,14934,16893
2017-06-10 13:00:00-04:00,0,6,13,5,0,1466,11675,13141
2017-06-10 14:00:00-04:00,0,6,14,5,0,1040,8627,9667
2017-06-10 15:00:00-04:00,0,6,15,5,0,886,5667,6553
2017-06-10 16:00:00-04:00,0,6,16,5,0,500,2845,3345
2017-06-10 17:00:00-04:00,0,6,17,5,0,447,3925,4372
2017-06-10 18:00:00-04:00,0,6,18,5,0,574,6278,6852
2017-06-10 19:00:00-04:00,0,6,19,5,0,841,8788,9629
2017-06-10 20:00:00-04:00,0,6,20,5,0,1188,12757,13945
2017-06-10 21:00:00-04:00,0,6,21,5,0,1420,14089,15509
2017-06-10 22:00:00-04:00,0,6,22,5,0,1660,16195,17855
2017-06-10 23:00:00-04:00,0,6,23,5,0,1739,17201,18940
2017-06-11 00:00:00-04:00,0,6,0,6,0,1790,18010,19800
2017-06-11 01:00:00-04:00,0,6,1,6,0,2082,16981,19063
2017-06-11 02:00:00-04:00,0,6,2,6,0,2261,17279,19540
2017-06-11 03:00:00-04:00,0,6,3,6,0,2427,16370,18797
2017-06-11 04:00:00-04:00,0,6,4,6,0,2455,18066,20521
2017-06-11 05:00:00-04:00,0,6,5,6,0,2646,19008,21654
2017-06-11 06:00:00-04:00,0,6,6,6,0,2660,19876,22536
2017-06-11 07:00:00-04:00,0,6,7,6,0,1821,16511,18332
2017-06-11 08:00:00-04:00,0,6,8,6,0,2198,17094,19292
2017-06-11 09:00:00-04:00,0,6,9,6,0,2397,18706,21103
2017-06-11 10:00:00-04:00,0,6,10,6,0,2515,18731,21246
2017-06-11 11:00:00-04:00,0,6,11,6,0,2527,16935,19462
2017-06-11 12:00:00-04:00,0,6,12,6,0,2276,14272,16548
2017-06-11 13:00:00-04:00,0,6,13,6,0,1699,11825,13524
2017-06-11 14:00:00-04:00,0,6,14,6,0,1111,9012,10123
2017-06-11 15:00:00-04:00,0,6,15,6,0,932,5893,6825
2017-06-11 16:00:00-04:00,0,6,16,6,0,523,2734,3257
2017-06-11 17:00:00-04:00,0,6,17,6,0,365,3160,3525
2017-06-11 18:00:00-04:00,0,6,18,6,0,422,4327,4749
2017-06-11 19:00:00-04:00,0,6,19,6,0,615,6625,7240
2017-06-11 20:00:00-04:00,0,6,20,6,0,912,10078,10990
2017-06-11 21:00:00-04:00,0,6,21,6,0,1215,12870,14085
2017-06-11 22:00:00-04:00,0,6,22,6,0,1453,14471,15924
2017-06-11 23:00:00-04:00,0,6,23,6,0,1627,14778,16405
2017-06-12 00:00:00-04:00,0,6,0,0,0,1708,15394,17102
2017-06-12 01:00:00-04:00,0,6,1,0,0,1887,15288,17175
2017-06-12 02:00:00-04:00,0,6,2,0,0,2042,14915,16957
2017-06-12 03:00:00-04:00,0,6,3,0,0,2087,14608,16695
2017-06-12 04:00:00-04:00,0,6,4,0,0,2043,15609,17652
2017-06-12 05:00:00-04:00,0,6,5,0,0,2219,15960,18179
2017-06-12 06:00:00-04:00,0,6,6,0,0,1893,14935,16828
2017-06-12 07:00:00-04:00,0,6,7,0,0,1253,12846,14099
2017-06-12 08:00:00-04:00,0,6,8,0,0,1366,13879,15245
2017-06-12 09:00:00-04:00,0,6,9,0,0,1408,12186,13594
2017-06-12 10:00:00-04:00,0,6,10,0,0,1404,10488,11892
2017-06-12 11:00:00-04:00,0,6,11,0,0,1025,6235,7260
2017-06-12 12:00:00-04:00,0,6,12,0,0,670,4010,4680
2017-06-12 13:00:00-04:00,0,6,13,0,0,361,2540,2901
2017-06-12 14:00:00-04:00,0,6,14,0,0,230,1817,2047
2017-06-12 15:00:00-04:00,0,6,15,0,0,267,2211,2478
2017-06-12 16:00:00-04:00,0,6,16,0,0,311,3737,4048
2017-06-12 17:00:00-04:00,0,6,17,0,0,567,9062,9629
2017-06-12 18:00:00-04:00,0,6,18,0,0,1066,14380,15446
2017-06-12 19:00:00-04:00,0,6,19,0,0,1570,17048,18618
2017-06-12 20:00:00-04:00,0,6,20,0,0,1462,16288,17750
2017-06-12 21:00:00-04:00,0,6,21,0,0,1305,14669,15974
2017-06-12 22:00:00-04:00,0,6,22,0,0,1294,14992,16286
2017-06-12 23:00:00-04:00,0,6,23,0,0,1319,15769,17088
2017-06-13 00:00:00-04:00,0,6,0,1,0,1266,16252,17518
2017-06-13 01:00:00-04:00,0,6,1,1,0,1459,17337,18796
2017-06-13 02:00:00-04:00,0,6,2,1,0,1734,17518,19252
2017-06-13 03:00:00-04:00,0,6,3,1,0,1838,16004,17842
2017-06-13 04:00:00-04:00,0,6,4,1,0,2039,18459,20498
2017-06-13 05:00:00-04:00,0,6,5,1,0,2126,21248,23374
2017-06-13 06:00:00-04:00,0,6,6,1,0,1773,19367,21140
2017-06-13 07:00:00-04:00,0,6,7,1,0,1303,17578,18881
2017-06-13 08:00:00-04:00,0,6,8,1,0,1233,18390,19623
2017-06-13 09:00:00-04:00,0,6,9,1,0,1090,15861,16951
2017-06-13 10:00:00-04:00,0,6,10,1,0,1032,10723,11755
2017-06-13 11:00:00-04:00,0,6,11,1,0,836,7342,8178
2017-06-13 12:00:00-04:00,0,6,12,1,0,516,3877,4393
2017-06-13 13:00:00-04:00,0,6,13,1,0,290,2299,2589
2017-06-13 14:00:00-04:00,0,6,14,1,0,170,1519,1689
2017-06-13 15:00:00-04:00,0,6,15,1,0,211,1650,1861
2017-06-13 16:00:00-04:00,0,6,16,1,0,242,3342,3584
2017-06-13 17:00:00-04:00,0,6,17,1,0,474,8909,9383
2017-06-13 18:00:00-04:00,0,6,18,1,0,1094,15054,16148
2017-06-13 19:00:00-04:00,0,6,19,1,0,1626,18976,20602
2017-06-13 20:00:00-04:00,0,6,20,1,0,1541,17910,19451
2017-06-13 21:00:00-04:00,0,6,21,1,0,1461,16272,17733
2017-06-13 22:00:00-04:00,0,6,22,1,0,1382,16768,18150
2017-06-13 23:00:00-04:00,0,6,23,1,0,1397,17564,18961
2017-06-14 00:00:00-04:00,0,6,0,2,0,1399,17394,18793
2017-06-14 01:00:00-04:00,0,6,1,2,0,1601,18674,20275
2017-06-14 02:00:00-04:00,0,6,2,2,0,1773,17899,19672
2017-06-14 03:00:00-04:00,0.2,6,3,2,0,1913,15679,17592
2017-06-14 04:00:00-04:00,0.01,6,4,2,0,2099,18044,20143
2017-06-14 05:00:00-04:00,0.1,6,5,2,0,2222,21313,23535
2017-06-14 06:00:00-04:00,0.04,6,6,2,0,1952,21042,22994
2017-06-14 07:00:00-04:00,0.13,6,7,2,0,1339,19446,20785
2017-06-14 08:00:00-04:00,0.02,6,8,2,0,1368,20516,21884
2017-06-14 09:00:00-04:00,0,6,9,2,0,1289,18720,20009
2017-06-14 10:00:00-04:00,0,6,10,2,0,1101,13722,14823
2017-06-14 11:00:00-04:00,0,6,11,2,0,907,8248,9155
2017-06-14 12:00:00-04:00,0,6,12,2,0,539,5037,5576
2017-06-14 13:00:00-04:00,0,6,13,2,0,310,2774,3084
2017-06-14 14:00:00-04:00,0,6,14,2,0,191,1897,2088
2017-06-14 15:00:00-04:00,0,6,15,2,0,191,1900,2091
2017-06-14 16:00:00-04:00,0,6,16,2,0,260,3798,4058
2017-06-14 17:00:00-04:00,0,6,17,2,0,496,9133,9629
2017-06-14 18:00:00-04:00,0,6,18,2,0,1187,18278,19465
2017-06-14 19:00:00-04:00,0,6,19,2,0,1684,19828,21512
2017-06-14 20:00:00-04:00,0,6,20,2,0,1614,17655,19269
2017-06-14 21:00:00-04:00,0,6,21,2,0,1596,17303,18899
2017-06-14 22:00:00-04:00,0,6,22,2,0,1525,18328,19853
2017-06-14 23:00:00-04:00,0,6,23,2,0,1596,18473,20069
2017-06-15 00:00:00-04:00,0,6,0,3,0,1457,18944,20401
2017-06-15 01:00:00-04:00,0,6,1,3,0,1563,18259,19822
2017-06-15 02:00:00-04:00,0,6,2,3,0,1711,16985,18696
2017-06-15 03:00:00-04:00,0,6,3,3,0,1839,14789,16628
2017-06-15 04:00:00-04:00,0,6,4,3,0,2110,17846,19956
2017-06-15 05:00:00-04:00,0,6,5,3,0,2316,20903,23219
2017-06-15 06:00:00-04:00,0,6,6,3,0,2070,21246,23316
2017-06-15 07:00:00-04:00,0,6,7,3,0,1452,19276,20728
2017-06-15 08:00:00-04:00,0,6,8,3,0,1521,21489,23010
2017-06-15 09:00:00-04:00,0,6,9,3,0,1468,20902,22370
2017-06-15 10:00:00-04:00,0,6,10,3,0,1352,16014,17366
2017-06-15 11:00:00-04:00,0,6,11,3,0,1024,10691,11715
2017-06-15 12:00:00-04:00,0,6,12,3,0,692,6488,7180
2017-06-15 13:00:00-04:00,0,6,13,3,0,385,3663,4048
2017-06-15 14:00:00-04:00,0,6,14,3,0,230,2334,2564
2017-06-15 15:00:00-04:00,0,6,15,3,0,193,2292,2485
2017-06-15 16:00:00-04:00,0,6,16,3,0,229,3668,3897
2017-06-15 17:00:00-04:00,0,6,17,3,0,478,8964,9442
2017-06-15 18:00:00-04:00,0,6,18,3,0,1141,14850,15991
2017-06-15 19:00:00-04:00,0,6,19,3,0,1638,18839,20477
2017-06-15 20:00:00-04:00,0,6,20,3,0,1632,17772,19404
2017-06-15 21:00:00-04:00,0,6,21,3,0,1479,16258,17737
2017-06-15 22:00:00-04:00,0,6,22,3,0,1357,16723,18080
2017-06-15 23:00:00-04:00,0,6,23,3,0,1465,17071,18536
2017-06-16 00:00:00-04:00,0,6,0,4,0,1387,17023,18410
2017-06-16 01:00:00-04:00,0,6,1,4,0,1663,17942,19605
2017-06-16 02:00:00-04:00,0,6,2,4,0,1749,16476,18225
2017-06-16 03:00:00-04:00,0,6,3,4,0,2002,14810,16812
2017-06-16 04:00:00-04:00,0,6,4,4,0,2171,17285,19456
2017-06-16 05:00:00-04:00,0,6,5,4,0,2458,21329,23787
2017-06-16 06:00:00-04:00,0,6,6,4,0,2173,21636,23809
2017-06-16 07:00:00-04:00,0,6,7,4,0,1537,20062,21599
2017-06-16 08:00:00-04:00,0,6,8,4,0,1669,22133,23802
2017-06-16 09:00:00-04:00,0,6,9,4,0,1681,21344,23025
2017-06-16 10:00:00-04:00,0,6,10,4,0,1529,18185,19714
2017-06-16 11:00:00-04:00,0,6,11,4,0,1297,14086,15383
2017-06-16 12:00:00-04:00,0,6,12,4,0,907,9500,10407
2017-06-16 13:00:00-04:00,0,6,13,4,0,492,5860,6352
2017-06-16 14:00:00-04:00,0,6,14,4,0,299,3756,4055
2017-06-16 15:00:00-04:00,0,6,15,4,0,259,3249,3508
2017-06-16 16:00:00-04:00,0,6,16,4,0,278,3877,4155
2017-06-16 17:00:00-04:00,0,6,17,4,0,504,8772,9276
2017-06-16 18:00:00-04:00,0,6,18,4,0,1093,13894,14987
2017-06-16 19:00:00-04:00,0,6,19,4,0,1646,17891,19537
2017-06-16 20:00:00-04:00,0,6,20,4,0,1707,16869,18576
2017-06-16 21:00:00-04:00,0,6,21,4,0,1475,15267,16742
2017-06-16 22:00:00-04:00,0,6,22,4,0,1394,15823,17217
2017-06-16 23:00:00-04:00,0,6,23,4,0,1451,16692,18143
2017-06-17 00:00:00-04:00,0,6,0,5,0,1285,16355,17640
2017-06-17 01:00:00-04:00,0,6,1,5,0,1707,17577,19284
2017-06-17 02:00:00-04:00,0,6,2,5,0,1999,16196,18195
2017-06-17 03:00:00-04:00,0,6,3,5,0,2277,14802,17079
2017-06-17 04:00:00-04:00,0,6,4,5,0,2584,17898,20482
2017-06-17 05:00:00-04:00,0,6,5,5,0,2685,20906,23591
2017-06-17 06:00:00-04:00,0,6,6,5,0,2421,20308,22729
2017-06-17 07:00:00-04:00,0,6,7,5,0,1713,17325,19038
2017-06-17 08:00:00-04:00,0,6,8,5,0,1899,17585,19484
2017-06-17 09:00:00-04:00,0,6,9,5,0,2077,19158,21235
2017-06-17 10:00:00-04:00,0,6,10,5,0,2251,18177,20428
2017-06-17 11:00:00-04:00,0,6,11,5,0,2149,17341,19490
2017-06-17 12:00:00-04:00,0.19,6,12,5,0,1887,14793,16680
2017-06-17 13:00:00-04:00,0.58,6,13,5,0,1351,11623,12974
2017-06-17 14:00:00-04:00,0.49,6,14,5,0,914,8769,9683
2017-06-17 15:00:00-04:00,0,6,15,5,0,771,5446,6217
2017-06-17 16:00:00-04:00,0,6,16,5,0,476,2776,3252
2017-06-17 17:00:00-04:00,0,6,17,5,0,443,3824,4267
2017-06-17 18:00:00-04:00,0,6,18,5,0,593,5579,6172
2017-06-17 19:00:00-04:00,0,6,19,5,0,816,8038,8854
2017-06-17 20:00:00-04:00,0,6,20,5,0,1149,11295,12444
2017-06-17 21:00:00-04:00,0,6,21,5,0,1316,13286,14602
2017-06-17 22:00:00-04:00,0,6,22,5,0,1589,16643,18232
2017-06-17 23:00:00-04:00,0,6,23,5,0,2405,22994,25399
2017-06-18 00:00:00-04:00,0,6,0,6,0,2261,19935,22196
2017-06-18 01:00:00-04:00,0,6,1,6,0,2032,15285,17317
2017-06-18 02:00:00-04:00,0,6,2,6,0,1907,13413,15320
2017-06-18 03:00:00-04:00,0,6,3,6,0,2243,14195,16438
2017-06-18 04:00:00-04:00,0,6,4,6,0,2384,15850,18234
2017-06-18 05:00:00-04:00,0,6,5,6,0,2358,17063,19421
2017-06-18 06:00:00-04:00,0,6,6,6,0,2469,18554,21023
2017-06-18 07:00:00-04:00,0,6,7,6,0,1675,14401,16076
2017-06-18 08:00:00-04:00,0,6,8,6,0,1847,14489,16336
2017-06-18 09:00:00-04:00,0,6,9,6,0,2117,16374,18491
2017-06-18 10:00:00-04:00,0,6,10,6,0,2234,16512,18746
2017-06-18 11:00:00-04:00,0,6,11,6,0,2167,15433,17600
2017-06-18 12:00:00-04:00,0,6,12,6,0,1920,13672,15592
2017-06-18 13:00:00-04:00,0,6,13,6,0,1435,11316,12751
2017-06-18 14:00:00-04:00,0,6,14,6,0,1079,8613,9692
2017-06-18 15:00:00-04:00,0,6,15,6,0,922,5530,6452
2017-06-18 16:00:00-04:00,0,6,16,6,0,452,2685,3137
2017-06-18 17:00:00-04:00,0,6,17,6,0,313,2847,3160
2017-06-18 18:00:00-04:00,0,6,18,6,0,384,4006,4390
2017-06-18 19:00:00-04:00,0,6,19,6,0,500,5795,6295
2017-06-18 20:00:00-04:00,0,6,20,6,0,768,8806,9574
2017-06-18 21:00:00-04:00,0,6,21,6,0,1079,12427,13506
2017-06-18 22:00:00-04:00,0,6,22,6,0,1314,13869,15183
2017-06-18 23:00:00-04:00,0,6,23,6,0,1513,15054,16567
2017-06-19 00:00:00-04:00,0,6,0,0,0,1499,15583,17082
2017-06-19 01:00:00-04:00,0,6,1,0,0,1830,16478,18308
2017-06-19 02:00:00-04:00,0,6,2,0,0,1991,15320,17311
2017-06-19 03:00:00-04:00,0,6,3,0,0,2070,14932,17002
2017-06-19 04:00:00-04:00,0,6,4,0,0,2061,15393,17454
2017-06-19 05:00:00-04:00,0,6,5,0,0,2207,16069,18276
2017-06-19 06:00:00-04:00,0,6,6,0,0,1919,14851,16770
2017-06-19 07:00:00-04:00,0,6,7,0,0,1285,13425,14710
2017-06-19 08:00:00-04:00,0,6,8,0,0,1490,14265,15755
2017-06-19 09:00:00-04:00,0,6,9,0,0,1437,11913,13350
2017-06-19 10:00:00-04:00,0,6,10,0,0,1297,9461,10758
2017-06-19 11:00:00-04:00,0,6,11,0,0,948,6303,7251
2017-06-19 12:00:00-04:00,0,6,12,0,0,593,4404,4997
2017-06-19 13:00:00-04:00,0,6,13,0,0,334,2498,2832
2017-06-19 14:00:00-04:00,0,6,14,0,0,243,1596,1839
2017-06-19 15:00:00-04:00,0,6,15,0,0,305,2074,2379
2017-06-19 16:00:00-04:00,0,6,16,0,0,338,3536,3874
2017-06-19 17:00:00-04:00,0.81,6,17,0,0,508,8683,9191
2017-06-19 18:00:00-04:00,0.22,6,18,0,0,1015,13797,14812
2017-06-19 19:00:00-04:00,0.07,6,19,0,0,1611,17333,18944
2017-06-19 20:00:00-04:00,0.08,6,20,0,0,1537,16598,18135
2017-06-19 21:00:00-04:00,0.02,6,21,0,0,1361,14546,15907
2017-06-19 22:00:00-04:00,0,6,22,0,0,1160,14429,15589
2017-06-19 23:00:00-04:00,0,6,23,0,0,1186,15494,16680
2017-06-20 00:00:00-04:00,0.02,6,0,1,0,1202,15730,16932
2017-06-20 01:00:00-04:00,0,6,1,1,0,1460,16605,18065
2017-06-20 02:00:00-04:00,0.01,6,2,1,0,1671,16933,18604
2017-06-20 03:00:00-04:00,0,6,3,1,0,2181,17703,19884
2017-06-20 04:00:00-04:00,0,6,4,1,0,2660,19625,22285
2017-06-20 05:00:00-04:00,0,6,5,1,0,2718,20999,23717
2017-06-20 06:00:00-04:00,0,6,6,1,0,2357,19729,22086
2017-06-20 07:00:00-04:00,0,6,7,1,0,1420,16549,17969
2017-06-20 08:00:00-04:00,0,6,8,1,0,1239,17358,18597
2017-06-20 09:00:00-04:00,0,6,9,1,0,964,13825,14789
2017-06-20 10:00:00-04:00,0,6,10,1,0,915,9721,10636
2017-06-20 11:00:00-04:00,0,6,11,1,0,711,6667,7378
2017-06-20 12:00:00-04:00,0,6,12,1,0,452,3740,4192
2017-06-20 13:00:00-04:00,0,6,13,1,0,238,2321,2559
2017-06-20 14:00:00-04:00,0,6,14,1,0,176,1589,1765
2017-06-20 15:00:00-04:00,0,6,15,1,0,189,1620,1809
2017-06-20 16:00:00-04:00,0,6,16,1,0,254,3331,3585
2017-06-20 17:00:00-04:00,0,6,17,1,0,486,9274,9760
2017-06-20 18:00:00-04:00,0,6,18,1,0,1042,14473,15515
2017-06-20 19:00:00-04:00,0,6,19,1,0,1700,18253,19953
2017-06-20 20:00:00-04:00,0,6,20,1,0,1607,16975,18582
2017-06-20 21:00:00-04:00,0,6,21,1,0,1372,15230,16602
2017-06-20 22:00:00-04:00,0,6,22,1,0,1344,15410,16754
2017-06-20 23:00:00-04:00,0,6,23,1,0,1341,16220,17561
2017-06-21 00:00:00-04:00,0,6,0,2,0,1268,15929,17197
2017-06-21 01:00:00-04:00,0,6,1,2,0,1430,16942,18372
2017-06-21 02:00:00-04:00,0,6,2,2,0,1621,16243,17864
2017-06-21 03:00:00-04:00,0,6,3,2,0,1799,14792,16591
2017-06-21 04:00:00-04:00,0,6,4,2,0,2054,17298,19352
2017-06-21 05:00:00-04:00,0,6,5,2,0,2252,20765,23017
2017-06-21 06:00:00-04:00,0,6,6,2,0,1926,19812,21738
2017-06-21 07:00:00-04:00,0,6,7,2,0,1423,18791,20214
2017-06-21 08:00:00-04:00,0,6,8,2,0,1404,20078,21482
2017-06-21 09:00:00-04:00,0,6,9,2,0,1447,18954,20401
2017-06-21 10:00:00-04:00,0,6,10,2,0,1306,14020,15326
2017-06-21 11:00:00-04:00,0,6,11,2,0,895,9084,9979
2017-06-21 12:00:00-04:00,0,6,12,2,0,639,4979,5618
2017-06-21 13:00:00-04:00,0,6,13,2,0,349,3200,3549
2017-06-21 14:00:00-04:00,0,6,14,2,0,186,1920,2106
2017-06-21 15:00:00-04:00,0,6,15,2,0,199,2009,2208
2017-06-21 16:00:00-04:00,0,6,16,2,0,273,3500,3773
2017-06-21 17:00:00-04:00,0,6,17,2,0,464,8695,9159
2017-06-21 18:00:00-04:00,0,6,18,2,0,1032,13906,14938
2017-06-21 19:00:00-04:00,0,6,19,2,0,1608,18104,19712
2017-06-21 20:00:00-04:00,0,6,20,2,0,1538,17049,18587
2017-06-21 21:00:00-04:00,0,6,21,2,0,1360,15308,16668
2017-06-21 22:00:00-04:00,0,6,22,2,0,1333,16281,17614
2017-06-21 23:00:00-04:00,0,6,23,2,0,1395,16662,18057
2017-06-22 00:00:00-04:00,0,6,0,3,0,1311,16543,17854
2017-06-22 01:00:00-04:00,0,6,1,3,0,1519,16874,18393
2017-06-22 02:00:00-04:00,0,6,2,3,0,1656,16249,17905
2017-06-22 03:00:00-04:00,0,6,3,3,0,1836,14696,16532
2017-06-22 04:00:00-04:00,0,6,4,3,0,2097,17430,19527
2017-06-22 05:00:00-04:00,0,6,5,3,0,2165,20517,22682
2017-06-22 06:00:00-04:00,0,6,6,3,0,2106,21209,23315
2017-06-22 07:00:00-04:00,0,6,7,3,0,1317,19112,20429
2017-06-22 08:00:00-04:00,0,6,8,3,0,1379,21454,22833
2017-06-22 09:00:00-04:00,0,6,9,3,0,1396,20066,21462
2017-06-22 10:00:00-04:00,0,6,10,3,0,1256,16153,17409
2017-06-22 11:00:00-04:00,0,6,11,3,0,885,10492,11377
2017-06-22 12:00:00-04:00,0,6,12,3,0,576,5862,6438
2017-06-22 13:00:00-04:00,0,6,13,3,0,320,3654,3974
2017-06-22 14:00:00-04:00,0,6,14,3,0,243,2254,2497
2017-06-22 15:00:00-04:00,0,6,15,3,0,241,2326,2567
2017-06-22 16:00:00-04:00,0,6,16,3,0,275,3567,3842
2017-06-22 17:00:00-04:00,0,6,17,3,0,497,8932,9429
2017-06-22 18:00:00-04:00,0,6,18,3,0,975,14788,15763
2017-06-22 19:00:00-04:00,0,6,19,3,0,1443,17470,18913
2017-06-22 20:00:00-04:00,0,6,20,3,0,1541,16970,18511
2017-06-22 21:00:00-04:00,0,6,21,3,0,1304,15627,16931
2017-06-22 22:00:00-04:00,0,6,22,3,0,1432,15724,17156
2017-06-22 23:00:00-04:00,0,6,23,3,0,1373,16162,17535
2017-06-23 00:00:00-04:00,0,6,0,4,0,1389,16603,17992
2017-06-23 01:00:00-04:00,0,6,1,4,0,1586,17426,19012
2017-06-23 02:00:00-04:00,0,6,2,4,0,1798,16473,18271
2017-06-23 03:00:00-04:00,0,6,3,4,0,1941,14605,16546
2017-06-23 04:00:00-04:00,0,6,4,4,0,2110,17445,19555
2017-06-23 05:00:00-04:00,0,6,5,4,0,2280,20697,22977
2017-06-23 06:00:00-04:00,0,6,6,4,0,2157,21103,23260
2017-06-23 07:00:00-04:00,0,6,7,4,0,1501,19697,21198
2017-06-23 08:00:00-04:00,0,6,8,4,0,1558,21620,23178
2017-06-23 09:00:00-04:00,0,6,9,4,0,1653,20990,22643
2017-06-23 10:00:00-04:00,0,6,10,4,0,1596,18403,19999
2017-06-23 11:00:00-04:00,0,6,11,4,0,1263,13653,14916
2017-06-23 12:00:00-04:00,0,6,12,4,0,876,9086,9962
2017-06-23 13:00:00-04:00,0,6,13,4,0,532,5691,6223
2017-06-23 14:00:00-04:00,0,6,14,4,0,334,3679,4013
2017-06-23 15:00:00-04:00,0,6,15,4,0,319,3072,3391
2017-06-23 16:00:00-04:00,0,6,16,4,0,279,3826,4105
2017-06-23 17:00:00-04:00,0,6,17,4,0,503,8770,9273
2017-06-23 18:00:00-04:00,0,6,18,4,0,1023,13366,14389
2017-06-23 19:00:00-04:00,0,6,19,4,0,1652,17743,19395
2017-06-23 20:00:00-04:00,0.01,6,20,4,0,1576,17015,18591
2017-06-23 21:00:00-04:00,0.01,6,21,4,0,1555,15484,17039
2017-06-23 22:00:00-04:00,0,6,22,4,0,1517,15917,17434
2017-06-23 23:00:00-04:00,0,6,23,4,0,1357,16137,17494
2017-06-24 00:00:00-04:00,0,6,0,5,0,1302,16517,17819
2017-06-24 01:00:00-04:00,0.02,6,1,5,0,1581,16864,18445
2017-06-24 02:00:00-04:00,0.04,6,2,5,0,1908,15465,17373
2017-06-24 03:00:00-04:00,0,6,3,5,0,2190,14072,16262
2017-06-24 04:00:00-04:00,0,6,4,5,0,2440,16815,19255
2017-06-24 05:00:00-04:00,0,6,5,5,0,2689,20569,23258
2017-06-24 06:00:00-04:00,0.3,6,6,5,0,2508,21219,23727
2017-06-24 07:00:00-04:00,0.58,6,7,5,0,1956,21003,22959
2017-06-24 08:00:00-04:00,0.18,6,8,5,0,1840,17541,19381
2017-06-24 09:00:00-04:00,0,6,9,5,0,1941,19287,21228
2017-06-24 10:00:00-04:00,0,6,10,5,0,2037,18369,20406
2017-06-24 11:00:00-04:00,0,6,11,5,0,2076,17063,19139
2017-06-24 12:00:00-04:00,0,6,12,5,0,1780,15823,17603
2017-06-24 13:00:00-04:00,0,6,13,5,0,1241,11749,12990
2017-06-24 14:00:00-04:00,0,6,14,5,0,933,8578,9511
2017-06-24 15:00:00-04:00,0,6,15,5,0,837,5558,6395
2017-06-24 16:00:00-04:00,0,6,16,5,0,549,3081,3630
2017-06-24 17:00:00-04:00,0,6,17,5,0,531,4464,4995
2017-06-24 18:00:00-04:00,0,6,18,5,0,603,6110,6713
2017-06-24 19:00:00-04:00,0,6,19,5,0,731,8203,8934
2017-06-24 20:00:00-04:00,0,6,20,5,0,1012,10530,11542
2017-06-24 21:00:00-04:00,0,6,21,5,0,1288,13270,14558
2017-06-24 22:00:00-04:00,0,6,22,5,0,1413,14660,16073
2017-06-24 23:00:00-04:00,0,6,23,5,0,1572,15769,17341
2017-06-25 00:00:00-04:00,0,6,0,6,0,1619,16394,18013
2017-06-25 01:00:00-04:00,0,6,1,6,0,1927,15746,17673
2017-06-25 02:00:00-04:00,0,6,2,6,0,2115,15727,17842
2017-06-25 03:00:00-04:00,0,6,3,6,0,2262,15529,17791
2017-06-25 04:00:00-04:00,0,6,4,6,0,2344,16268,18612
2017-06-25 05:00:00-04:00,0,6,5,6,0,2442,17652,20094
2017-06-25 06:00:00-04:00,0,6,6,6,0,2208,17920,20128
2017-06-25 07:00:00-04:00,0,6,7,6,0,1729,15228,16957
2017-06-25 08:00:00-04:00,0,6,8,6,0,1901,16195,18096
2017-06-25 09:00:00-04:00,0,6,9,6,0,2115,17629,19744
2017-06-25 10:00:00-04:00,0,6,10,6,0,2269,18471,20740
2017-06-25 11:00:00-04:00,0,6,11,6,0,2224,17383,19607
2017-06-25 12:00:00-04:00,0,6,12,6,0,2005,15487,17492
2017-06-25 13:00:00-04:00,0,6,13,6,0,1620,12889,14509
2017-06-25 14:00:00-04:00,0,6,14,6,0,1325,9977,11302
2017-06-25 15:00:00-04:00,0,6,15,6,0,922,6508,7430
2017-06-25 16:00:00-04:00,0,6,16,6,0,484,3390,3874
2017-06-25 17:00:00-04:00,0,6,17,6,0,335,3475,3810
2017-06-25 18:00:00-04:00,0,6,18,6,0,426,4783,5209
2017-06-25 19:00:00-04:00,0,6,19,6,0,574,6816,7390
2017-06-25 20:00:00-04:00,0,6,20,6,0,739,8776,9515
2017-06-25 21:00:00-04:00,0,6,21,6,0,998,10844,11842
2017-06-25 22:00:00-04:00,0,6,22,6,0,1115,11829,12944
2017-06-25 23:00:00-04:00,0,6,23,6,0,1157,12019,13176
2017-06-26 00:00:00-04:00,0,6,0,0,0,1168,11953,13121
2017-06-26 01:00:00-04:00,0,6,1,0,0,1274,12220,13494
2017-06-26 02:00:00-04:00,0,6,2,0,0,1293,11905,13198
2017-06-26 03:00:00-04:00,0,6,3,0,0,1309,11169,12478
2017-06-26 04:00:00-04:00,0,6,4,0,0,1329,11671,13000
2017-06-26 05:00:00-04:00,0,6,5,0,0,1405,12428,13833
2017-06-26 06:00:00-04:00,0,6,6,0,0,1397,11762,13159
2017-06-26 07:00:00-04:00,0,6,7,0,0,1213,11023,12236
2017-06-26 08:00:00-04:00,0,6,8,0,0,1270,10969,12239
2017-06-26 09:00:00-04:00,0,6,9,0,0,1228,10281,11509
2017-06-26 10:00:00-04:00,0,6,10,0,0,1102,9372,10474
2017-06-26 11:00:00-04:00,0,6,11,0,0,849,7530,8379
2017-06-26 12:00:00-04:00,0,6,12,0,0,591,4798,5389
2017-06-26 13:00:00-04:00,0,6,13,0,0,353,3329,3682
2017-06-26 14:00:00-04:00,0,6,14,0,0,282,2354,2636
2017-06-26 15:00:00-04:00,0,6,15,0,0,275,2561,2836
2017-06-26 16:00:00-04:00,0,6,16,0,0,271,4001,4272
2017-06-26 17:00:00-04:00,0,6,17,0,0,458,8813,9271
2017-06-26 18:00:00-04:00,0,6,18,0,0,819,12369,13188
2017-06-26 19:00:00-04:00,0,6,19,0,0,1387,15075,16462
2017-06-26 20:00:00-04:00,0,6,20,0,0,1380,15248,16628
2017-06-26 21:00:00-04:00,0,6,21,0,0,1247,13659,14906
2017-06-26 22:00:00-04:00,0,6,22,0,0,1140,13762,14902
2017-06-26 23:00:00-04:00,0,6,23,0,0,1148,14540,15688
2017-06-27 00:00:00-04:00,0,6,0,1,0,1104,14760,15864
2017-06-27 01:00:00-04:00,0,6,1,1,0,1243,15433,16676
2017-06-27 02:00:00-04:00,0,6,2,1,0,1466,15156,16622
2017-06-27 03:00:00-04:00,0,6,3,1,0,1499,14295,15794
2017-06-27 04:00:00-04:00,0,6,4,1,0,1675,16435,18110
2017-06-27 05:00:00-04:00,0.06,6,5,1,0,1866,18920,20786
2017-06-27 06:00:00-04:00,0.1,6,6,1,0,1704,17889,19593
2017-06-27 07:00:00-04:00,0,6,7,1,0,1407,16549,17956
2017-06-27 08:00:00-04:00,0,6,8,1,0,1278,17079,18357
2017-06-27 09:00:00-04:00,0,6,9,1,0,1128,15182,16310
2017-06-27 10:00:00-04:00,0,6,10,1,0,922,11003,11925
2017-06-27 11:00:00-04:00,0,6,11,1,0,695,6817,7512
2017-06-27 12:00:00-04:00,0,6,12,1,0,427,3890,4317
2017-06-27 13:00:00-04:00,0,6,13,1,0,276,2542,2818
2017-06-27 14:00:00-04:00,0,6,14,1,0,165,1686,1851
2017-06-27 15:00:00-04:00,0,6,15,1,0,208,1939,2147
2017-06-27 16:00:00-04:00,0,6,16,1,0,266,4200,4466
2017-06-27 17:00:00-04:00,0,6,17,1,0,453,9348,9801
2017-06-27 18:00:00-04:00,0,6,18,1,0,968,13964,14932
2017-06-27 19:00:00-04:00,0,6,19,1,0,1622,17373,18995
2017-06-27 20:00:00-04:00,0,6,20,1,0,1597,16997,18594
2017-06-27 21:00:00-04:00,0,6,21,1,0,1661,17292,18953
2017-06-27 22:00:00-04:00,0,6,22,1,0,1402,16125,17527
2017-06-27 23:00:00-04:00,0,6,23,1,0,1457,16270,17727
2017-06-28 00:00:00-04:00,0,6,0,2,0,1338,16031,17369
2017-06-28 01:00:00-04:00,0,6,1,2,0,1453,17362,18815
2017-06-28 02:00:00-04:00,0,6,2,2,0,1784,16288,18072
2017-06-28 03:00:00-04:00,0,6,3,2,0,1793,14713,16506
2017-06-28 04:00:00-04:00,0,6,4,2,0,2045,16560,18605
2017-06-28 05:00:00-04:00,0,6,5,2,0,2307,20081,22388
2017-06-28 06:00:00-04:00,0,6,6,2,0,2205,20517,22722
2017-06-28 07:00:00-04:00,0,6,7,2,0,1690,18751,20441
2017-06-28 08:00:00-04:00,0,6,8,2,0,1564,20260,21824
2017-06-28 09:00:00-04:00,0,6,9,2,0,1456,18232,19688
2017-06-28 10:00:00-04:00,0,6,10,2,0,1209,13845,15054
2017-06-28 11:00:00-04:00,0,6,11,2,0,824,8856,9680
2017-06-28 12:00:00-04:00,0,6,12,2,0,569,4926,5495
2017-06-28 13:00:00-04:00,0,6,13,2,0,350,2971,3321
2017-06-28 14:00:00-04:00,0,6,14,2,0,206,1935,2141
2017-06-28 15:00:00-04:00,0,6,15,2,0,210,1920,2130
2017-06-28 16:00:00-04:00,0,6,16,2,0,224,3411,3635
2017-06-28 17:00:00-04:00,0,6,17,2,0,447,8653,9100
2017-06-28 18:00:00-04:00,0,6,18,2,0,938,14006,14944
2017-06-28 19:00:00-04:00,0,6,19,2,0,1528,17713,19241
2017-06-28 20:00:00-04:00,0,6,20,2,0,1504,17040,18544
2017-06-28 21:00:00-04:00,0,6,21,2,0,1368,15182,16550
2017-06-28 22:00:00-04:00,0,6,22,2,0,1379,15831,17210
2017-06-28 23:00:00-04:00,0,6,23,2,0,1288,15987,17275
2017-06-29 00:00:00-04:00,0,6,0,3,0,1245,16259,17504
2017-06-29 01:00:00-04:00,0,6,1,3,0,1395,16309,17704
2017-06-29 02:00:00-04:00,0,6,2,3,0,1606,15499,17105
2017-06-29 03:00:00-04:00,0,6,3,3,0,1724,13871,15595
2017-06-29 04:00:00-04:00,0,6,4,3,0,1913,15309,17222
2017-06-29 05:00:00-04:00,0,6,5,3,0,2065,18164,20229
2017-06-29 06:00:00-04:00,0,6,6,3,0,2090,18903,20993
2017-06-29 07:00:00-04:00,0,6,7,3,0,1719,18564,20283
2017-06-29 08:00:00-04:00,0,6,8,3,0,1654,20145,21799
2017-06-29 09:00:00-04:00,0,6,9,3,0,1563,18786,20349
2017-06-29 10:00:00-04:00,0,6,10,3,0,1310,15760,17070
2017-06-29 11:00:00-04:00,0,6,11,3,0,1014,11169,12183
2017-06-29 12:00:00-04:00,0,6,12,3,0,706,7112,7818
2017-06-29 13:00:00-04:00,0,6,13,3,0,408,3669,4077
2017-06-29 14:00:00-04:00,0,6,14,3,0,233,2450,2683
2017-06-29 15:00:00-04:00,0,6,15,3,0,244,2128,2372
2017-06-29 16:00:00-04:00,0,6,16,3,0,266,3479,3745
2017-06-29 17:00:00-04:00,0,6,17,3,0,489,8599,9088
2017-06-29 18:00:00-04:00,0,6,18,3,0,934,13316,14250
2017-06-29 19:00:00-04:00,0,6,19,3,0,1455,16684,18139
2017-06-29 20:00:00-04:00,0,6,20,3,0,1482,16315,17797
2017-06-29 21:00:00-04:00,0,6,21,3,0,1354,14833,16187
2017-06-29 22:00:00-04:00,0,6,22,3,0,1344,15049,16393
2017-06-29 23:00:00-04:00,0,6,23,3,0,1306,15591,16897
2017-06-30 00:00:00-04:00,0,6,0,4,0,1233,15655,16888
2017-06-30 01:00:00-04:00,0,6,1,4,0,1423,16727,18150
2017-06-30 02:00:00-04:00,0,6,2,4,0,1666,15344,17010
2017-06-30 03:00:00-04:00,0,6,3,4,0,1846,13117,14963
2017-06-30 04:00:00-04:00,0,6,4,4,0,2057,14667,16724
2017-06-30 05:00:00-04:00,0,6,5,4,0,2338,17819,20157
2017-06-30 06:00:00-04:00,0,6,6,4,0,2347,18041,20388
2017-06-30 07:00:00-04:00,0,6,7,4,0,1868,17888,19756
2017-06-30 08:00:00-04:00,0,6,8,4,0,1790,18911,20701
2017-06-30 09:00:00-04:00,0,6,9,4,0,1708,18456,20164
2017-06-30 10:00:00-04:00,0,6,10,4,0,1570,16258,17828
2017-06-30 11:00:00-04:00,0,6,11,4,0,1230,13003,14233
2017-06-30 12:00:00-04:00,0,6,12,4,0,905,8874,9779
2017-06-30 13:00:00-04:00,0,6,13,4,0,570,5358,5928
2017-06-30 14:00:00-04:00,0,6,14,4,0,406,3488,3894
2017-06-30 15:00:00-04:00,0,6,15,4,0,316,3104,3420
2017-06-30 16:00:00-04:00,0,6,16,4,0,286,3709,3995
2017-06-30 17:00:00-04:00,0,6,17,4,0,489,8007,8496
2017-06-30 18:00:00-04:00,0,6,18,4,0,885,11505,12390
2017-06-30 19:00:00-04:00,0,6,19,4,0,1416,15208,16624
2017-06-30 20:00:00-04:00,0,6,20,4,0,1589,14856,16445
2017-06-30 21:00:00-04:00,0,6,21,4,0,1459,13360,14819
2017-06-30 22:00:00-04:00,0,6,22,4,0,1441,13811,15252
2017-06-30 23:00:00-04:00,0,6,23,4,0,1364,15207,16571
2017-07-01 00:00:00-04:00,0,7,0,5,0,1276,15494,16770
2017-07-01 01:00:00-04:00,0,7,1,5,0,1645,16456,18101
2017-07-01 02:00:00-04:00,0,7,2,5,0,1929,15665,17594
2017-07-01 03:00:00-04:00,0,7,3,5,0,2258,14480,16738
2017-07-01 04:00:00-04:00,0,7,4,5,0,2393,16109,18502
2017-07-01 05:00:00-04:00,0,7,5,5,0,2624,17726,20350
2017-07-01 06:00:00-04:00,0,7,6,5,0,2525,17518,20043
2017-07-01 07:00:00-04:00,0,7,7,5,0,2133,14586,16719
2017-07-01 08:00:00-04:00,0,7,8,5,0,2162,14636,16798
2017-07-01 09:00:00-04:00,0,7,9,5,0,2046,15261,17307
2017-07-01 10:00:00-04:00,0,7,10,5,0,2158,15426,17584
2017-07-01 11:00:00-04:00,0,7,11,5,0,2028,12767,14795
2017-07-01 12:00:00-04:00,0,7,12,5,0,1707,11314,13021
2017-07-01 13:00:00-04:00,0,7,13,5,0,1291,9024,10315
2017-07-01 14:00:00-04:00,0,7,14,5,0,1067,6577,7644
2017-07-01 15:00:00-04:00,0.01,7,15,5,0,798,4766,5564
2017-07-01 16:00:00-04:00,0,7,16,5,0,440,2829,3269
2017-07-01 17:00:00-04:00,0,7,17,5,0,397,3932,4329
2017-07-01 18:00:00-04:00,0,7,18,5,0,476,4999,5475
2017-07-01 19:00:00-04:00,0.05,7,19,5,0,712,6617,7329
2017-07-01 20:00:00-04:00,0.01,7,20,5,0,1004,8823,9827
2017-07-01 21:00:00-04:00,0,7,21,5,0,1092,10342,11434
2017-07-01 22:00:00-04:00,0,7,22,5,0,1278,11654,12932
2017-07-01 23:00:00-04:00,0,7,23,5,0,1493,12559,14052
2017-07-02 00:00:00-04:00,0,7,0,6,0,1392,13063,14455
2017-07-02 01:00:00-04:00,0,7,1,6,0,1726,13608,15334
2017-07-02 02:00:00-04:00,0,7,2,6,0,1941,13460,15401
2017-07-02 03:00:00-04:00,0,7,3,6,0,1780,11575,13355
2017-07-02 04:00:00-04:00,0,7,4,6,0,1850,12648,14498
2017-07-02 05:00:00-04:00,0,7,5,6,0,2117,13830,15947
2017-07-02 06:00:00-04:00,0,7,6,6,0,2684,17638,20322
2017-07-02 07:00:00-04:00,0,7,7,6,0,1770,9841,11611
2017-07-02 08:00:00-04:00,0,7,8,6,0,1859,10621,12480
2017-07-02 09:00:00-04:00,0,7,9,6,0,1722,11409,13131
2017-07-02 10:00:00-04:00,0,7,10,6,0,1913,11634,13547
2017-07-02 11:00:00-04:00,0,7,11,6,0,1684,9949,11633
2017-07-02 12:00:00-04:00,0,7,12,6,0,1615,8592,10207
2017-07-02 13:00:00-04:00,0,7,13,6,0,1352,7159,8511
2017-07-02 14:00:00-04:00,0,7,14,6,0,1094,5483,6577
2017-07-02 15:00:00-04:00,0,7,15,6,0,831,3987,4818
2017-07-02 16:00:00-04:00,0,7,16,6,0,487,2066,2553
2017-07-02 17:00:00-04:00,0,7,17,6,0,337,2496,2833
2017-07-02 18:00:00-04:00,0,7,18,6,0,384,3483,3867
2017-07-02 19:00:00-04:00,0,7,19,6,0,522,4623,5145
2017-07-02 20:00:00-04:00,0,7,20,6,0,739,6740,7479
2017-07-02 21:00:00-04:00,0,7,21,6,0,973,9014,9987
2017-07-02 22:00:00-04:00,0,7,22,6,0,1079,10199,11278
2017-07-02 23:00:00-04:00,0,7,23,6,0,1176,11000,12176
2017-07-03 00:00:00-04:00,0,7,0,0,0,1184,11505,12689
2017-07-03 01:00:00-04:00,0,7,1,0,0,1330,12038,13368
2017-07-03 02:00:00-04:00,0,7,2,0,0,1477,11490,12967
2017-07-03 03:00:00-04:00,0,7,3,0,0,1606,11331,12937
2017-07-03 04:00:00-04:00,0,7,4,0,0,1528,11671,13199
2017-07-03 05:00:00-04:00,0,7,5,0,0,1577,12151,13728
2017-07-03 06:00:00-04:00,0,7,6,0,0,1636,11029,12665
2017-07-03 07:00:00-04:00,0,7,7,0,0,1376,9773,11149
2017-07-03 08:00:00-04:00,0,7,8,0,0,1433,10402,11835
2017-07-03 09:00:00-04:00,0,7,9,0,0,1318,9644,10962
2017-07-03 10:00:00-04:00,0,7,10,0,0,1302,8261,9563
2017-07-03 11:00:00-04:00,0,7,11,0,0,1095,5845,6940
2017-07-03 12:00:00-04:00,0,7,12,0,0,729,3957,4686
2017-07-03 13:00:00-04:00,0,7,13,0,0,544,2641,3185
2017-07-03 14:00:00-04:00,0,7,14,0,0,365,1901,2266
2017-07-03 15:00:00-04:00,0,7,15,0,0,368,1661,2029
2017-07-03 16:00:00-04:00,0.04,7,16,0,0,264,1983,2247
2017-07-03 17:00:00-04:00,0.08,7,17,0,0,389,3746,4135
2017-07-03 18:00:00-04:00,0,7,18,0,0,615,5125,5740
2017-07-03 19:00:00-04:00,0,7,19,0,0,908,6636,7544
2017-07-03 20:00:00-04:00,0,7,20,0,0,1047,7534,8581
2017-07-03 21:00:00-04:00,0,7,21,0,0,1064,8541,9605
2017-07-03 22:00:00-04:00,0,7,22,0,0,1069,9349,10418
2017-07-03 23:00:00-04:00,0,7,23,0,0,1138,10583,11721
2017-07-04 00:00:00-04:00,0,7,0,1,1,1192,11495,12687
2017-07-04 01:00:00-04:00,0,7,1,1,1,1325,12383,13708
2017-07-04 02:00:00-04:00,0,7,2,1,1,1537,12311,13848
2017-07-04 03:00:00-04:00,0,7,3,1,1,1893,14144,16037
2017-07-04 04:00:00-04:00,0,7,4,1,1,1670,12015,13685
2017-07-04 05:00:00-04:00,0,7,5,1,1,1659,11874,13533
2017-07-04 06:00:00-04:00,0,7,6,1,1,1648,10492,12140
2017-07-04 07:00:00-04:00,0,7,7,1,1,1331,9637,10968
2017-07-04 08:00:00-04:00,0,7,8,1,1,1290,10201,11491
2017-07-04 09:00:00-04:00,0,7,9,1,1,1310,9990,11300
2017-07-04 10:00:00-04:00,0,7,10,1,1,1294,9173,10467
2017-07-04 11:00:00-04:00,0,7,11,1,1,1045,7399,8444
2017-07-04 12:00:00-04:00,0,7,12,1,1,904,5798,6702
2017-07-04 13:00:00-04:00,0,7,13,1,1,620,4435,5055
2017-07-04 14:00:00-04:00,0,7,14,1,1,437,2915,3352
2017-07-04 15:00:00-04:00,0,7,15,1,1,399,2178,2577
2017-07-04 16:00:00-04:00,0,7,16,1,1,246,1490,1736
2017-07-04 17:00:00-04:00,0,7,17,1,1,218,2020,2238
2017-07-04 18:00:00-04:00,0,7,18,1,1,277,2535,2812
2017-07-04 19:00:00-04:00,0,7,19,1,1,343,3414,3757
2017-07-04 20:00:00-04:00,0,7,20,1,1,460,4670,5130
2017-07-04 21:00:00-04:00,0,7,21,1,1,583,6304,6887
2017-07-04 22:00:00-04:00,0,7,22,1,1,730,7843,8573
2017-07-04 23:00:00-04:00,0,7,23,1,1,816,8916,9732
2017-07-05 00:00:00-04:00,0,7,0,2,0,920,9722,10642
2017-07-05 01:00:00-04:00,0,7,1,2,0,1122,10462,11584
2017-07-05 02:00:00-04:00,0,7,2,2,0,1305,10937,12242
2017-07-05 03:00:00-04:00,0,7,3,2,0,1472,11378,12850
2017-07-05 04:00:00-04:00,0,7,4,2,0,1630,11944,13574
2017-07-05 05:00:00-04:00,0,7,5,2,0,1675,11962,13637
2017-07-05 06:00:00-04:00,0,7,6,2,0,1751,11771,13522
2017-07-05 07:00:00-04:00,0,7,7,2,0,1542,11424,12966
2017-07-05 08:00:00-04:00,0,7,8,2,0,1691,11017,12708
2017-07-05 09:00:00-04:00,0,7,9,2,0,1761,12958,14719
2017-07-05 10:00:00-04:00,0,7,10,2,0,1839,11475,13314
2017-07-05 11:00:00-04:00,0,7,11,2,0,1533,7041,8574
2017-07-05 12:00:00-04:00,0,7,12,2,0,1011,3971,4982
2017-07-05 13:00:00-04:00,0,7,13,2,0,644,2425,3069
2017-07-05 14:00:00-04:00,0,7,14,2,0,412,1569,1981
2017-07-05 15:00:00-04:00,0,7,15,2,0,355,1669,2024
2017-07-05 16:00:00-04:00,0,7,16,2,0,266,2992,3258
2017-07-05 17:00:00-04:00,0,7,17,2,0,434,7062,7496
2017-07-05 18:00:00-04:00,0,7,18,2,0,832,10614,11446
2017-07-05 19:00:00-04:00,0,7,19,2,0,1261,13942,15203
2017-07-05 20:00:00-04:00,0,7,20,2,0,1212,13415,14627
2017-07-05 21:00:00-04:00,0,7,21,2,0,1157,12212,13369
2017-07-05 22:00:00-04:00,0,7,22,2,0,1110,12161,13271
2017-07-05 23:00:00-04:00,0,7,23,2,0,1139,12836,13975
2017-07-06 00:00:00-04:00,0,7,0,3,0,1119,13620,14739
2017-07-06 01:00:00-04:00,0,7,1,3,0,1185,13399,14584
2017-07-06 02:00:00-04:00,0,7,2,3,0,1342,13186,14528
2017-07-06 03:00:00-04:00,0,7,3,3,0,1487,12673,14160
2017-07-06 04:00:00-04:00,0,7,4,3,0,1714,14702,16416
2017-07-06 05:00:00-04:00,0,7,5,3,0,1810,16510,18320
2017-07-06 06:00:00-04:00,0,7,6,3,0,1720,15515,17235
2017-07-06 07:00:00-04:00,0,7,7,3,0,1387,13782,15169
2017-07-06 08:00:00-04:00,0,7,8,3,0,1317,13732,15049
2017-07-06 09:00:00-04:00,0,7,9,3,0,1071,12237,13308
2017-07-06 10:00:00-04:00,0,7,10,3,0,878,9358,10236
2017-07-06 11:00:00-04:00,0,7,11,3,0,712,6170,6882
2017-07-06 12:00:00-04:00,0,7,12,3,0,435,3737,4172
2017-07-06 13:00:00-04:00,0,7,13,3,0,270,2384,2654
2017-07-06 14:00:00-04:00,0,7,14,3,0,173,1604,1777
2017-07-06 15:00:00-04:00,0,7,15,3,0,196,1616,1812
2017-07-06 16:00:00-04:00,0,7,16,3,0,204,2893,3097
2017-07-06 17:00:00-04:00,0,7,17,3,0,453,7437,7890
2017-07-06 18:00:00-04:00,0,7,18,3,0,840,11210,12050
2017-07-06 19:00:00-04:00,0,7,19,3,0,1455,15205,16660
2017-07-06 20:00:00-04:00,0,7,20,3,0,1481,15621,17102
2017-07-06 21:00:00-04:00,0,7,21,3,0,1334,13943,15277
2017-07-06 22:00:00-04:00,0,7,22,3,0,1189,13427,14616
2017-07-06 23:00:00-04:00,0,7,23,3,0,1218,13850,15068
2017-07-07 00:00:00-04:00,0,7,0,4,0,1148,13795,14943
2017-07-07 01:00:00-04:00,0,7,1,4,0,1270,14400,15670
2017-07-07 02:00:00-04:00,0,7,2,4,0,1442,14078,15520
2017-07-07 03:00:00-04:00,0,7,3,4,0,1605,12686,14291
2017-07-07 04:00:00-04:00,0.01,7,4,4,0,1864,14881,16745
2017-07-07 05:00:00-04:00,0,7,5,4,0,2038,17298,19336
2017-07-07 06:00:00-04:00,0,7,6,4,0,1894,17574,19468
2017-07-07 07:00:00-04:00,0,7,7,4,0,1642,17585,19227
2017-07-07 08:00:00-04:00,0,7,8,4,0,1548,16569,18117
2017-07-07 09:00:00-04:00,0,7,9,4,0,1469,16043,17512
2017-07-07 10:00:00-04:00,0.51,7,10,4,0,1234,12491,13725
2017-07-07 11:00:00-04:00,1.29,7,11,4,0,964,9216,10180
2017-07-07 12:00:00-04:00,0.11,7,12,4,0,653,5968,6621
2017-07-07 13:00:00-04:00,0,7,13,4,0,480,3986,4466
2017-07-07 14:00:00-04:00,0,7,14,4,0,326,2674,3000
2017-07-07 15:00:00-04:00,0,7,15,4,0,260,2138,2398
2017-07-07 16:00:00-04:00,0,7,16,4,0,237,3015,3252
2017-07-07 17:00:00-04:00,0,7,17,4,0,424,7523,7947
2017-07-07 18:00:00-04:00,0,7,18,4,0,825,11834,12659
2017-07-07 19:00:00-04:00,0,7,19,4,0,1575,15846,17421
2017-07-07 20:00:00-04:00,0,7,20,4,0,1417,14688,16105
2017-07-07 21:00:00-04:00,0.22,7,21,4,0,1650,17676,19326
2017-07-07 22:00:00-04:00,0,7,22,4,0,1494,15593,17087
2017-07-07 23:00:00-04:00,0,7,23,4,0,1158,12760,13918
2017-07-08 00:00:00-04:00,0,7,0,5,0,978,12683,13661
2017-07-08 01:00:00-04:00,0,7,1,5,0,1215,13631,14846
2017-07-08 02:00:00-04:00,0,7,2,5,0,1486,13511,14997
2017-07-08 03:00:00-04:00,0,7,3,5,0,1792,12867,14659
2017-07-08 04:00:00-04:00,0,7,4,5,0,1998,14607,16605
2017-07-08 05:00:00-04:00,0,7,5,5,0,2223,16984,19207
2017-07-08 06:00:00-04:00,0,7,6,5,0,2208,16884,19092
2017-07-08 07:00:00-04:00,0,7,7,5,0,2098,18411,20509
2017-07-08 08:00:00-04:00,0,7,8,5,0,2576,17633,20209
2017-07-08 09:00:00-04:00,0,7,9,5,0,1819,15536,17355
2017-07-08 10:00:00-04:00,0,7,10,5,0,1949,14740,16689
2017-07-08 11:00:00-04:00,0,7,11,5,0,1879,14068,15947
2017-07-08 12:00:00-04:00,0,7,12,5,0,1551,12822,14373
2017-07-08 13:00:00-04:00,0,7,13,5,0,1225,10637,11862
2017-07-08 14:00:00-04:00,0,7,14,5,0,923,7436,8359
2017-07-08 15:00:00-04:00,0,7,15,5,0,702,4700,5402
2017-07-08 16:00:00-04:00,0,7,16,5,0,384,2427,2811
2017-07-08 17:00:00-04:00,0,7,17,5,0,391,3399,3790
2017-07-08 18:00:00-04:00,0,7,18,5,0,495,4547,5042
2017-07-08 19:00:00-04:00,0,7,19,5,0,676,6260,6936
2017-07-08 20:00:00-04:00,0,7,20,5,0,968,8980,9948
2017-07-08 21:00:00-04:00,0,7,21,5,0,1181,10528,11709
2017-07-08 22:00:00-04:00,0,7,22,5,0,1257,12258,13515
2017-07-08 23:00:00-04:00,0,7,23,5,0,1375,12811,14186
2017-07-09 00:00:00-04:00,0,7,0,6,0,1408,13635,15043
2017-07-09 01:00:00-04:00,0,7,1,6,0,1683,13129,14812
2017-07-09 02:00:00-04:00,0,7,2,6,0,1783,13448,15231
2017-07-09 03:00:00-04:00,0,7,3,6,0,1862,13320,15182
2017-07-09 04:00:00-04:00,0,7,4,6,0,1908,14140,16048
2017-07-09 05:00:00-04:00,0,7,5,6,0,2293,15083,17376
2017-07-09 06:00:00-04:00,0,7,6,6,0,2259,15407,17666
2017-07-09 07:00:00-04:00,0,7,7,6,0,1878,12889,14767
2017-07-09 08:00:00-04:00,0,7,8,6,0,2087,13381,15468
2017-07-09 09:00:00-04:00,0,7,9,6,0,2021,14588,16609
2017-07-09 10:00:00-04:00,0,7,10,6,0,2272,14472,16744
2017-07-09 11:00:00-04:00,0,7,11,6,0,2222,14146,16368
2017-07-09 12:00:00-04:00,0,7,12,6,0,1900,12699,14599
2017-07-09 13:00:00-04:00,0,7,13,6,0,1534,10688,12222
2017-07-09 14:00:00-04:00,0,7,14,6,0,1220,7907,9127
2017-07-09 15:00:00-04:00,0,7,15,6,0,935,5035,5970
2017-07-09 16:00:00-04:00,0,7,16,6,0,431,2474,2905
2017-07-09 17:00:00-04:00,0,7,17,6,0,338,2645,2983
2017-07-09 18:00:00-04:00,0,7,18,6,0,370,3611,3981
2017-07-09 19:00:00-04:00,0,7,19,6,0,500,5149,5649
2017-07-09 20:00:00-04:00,0,7,20,6,0,838,7644,8482
2017-07-09 21:00:00-04:00,0,7,21,6,0,945,10208,11153
2017-07-09 22:00:00-04:00,0,7,22,6,0,1103,11676,12779
2017-07-09 23:00:00-04:00,0,7,23,6,0,1236,12576,13812
2017-07-10 00:00:00-04:00,0,7,0,0,0,1225,12801,14026
2017-07-10 01:00:00-04:00,0,7,1,0,0,1361,13484,14845
2017-07-10 02:00:00-04:00,0,7,2,0,0,1599,12955,14554
2017-07-10 03:00:00-04:00,0,7,3,0,0,1575,13378,14953
2017-07-10 04:00:00-04:00,0,7,4,0,0,1562,13947,15509
2017-07-10 05:00:00-04:00,0,7,5,0,0,1674,14165,15839
2017-07-10 06:00:00-04:00,0,7,6,0,0,1686,13227,14913
2017-07-10 07:00:00-04:00,0,7,7,0,0,1479,11791,13270
2017-07-10 08:00:00-04:00,0,7,8,0,0,1497,12496,13993
2017-07-10 09:00:00-04:00,0,7,9,0,0,1464,10893,12357
2017-07-10 10:00:00-04:00,0,7,10,0,0,1240,8088,9328
2017-07-10 11:00:00-04:00,0,7,11,0,0,873,5158,6031
2017-07-10 12:00:00-04:00,0,7,12,0,0,563,2894,3457
2017-07-10 13:00:00-04:00,0,7,13,0,0,323,1919,2242
2017-07-10 14:00:00-04:00,0,7,14,0,0,257,1323,1580
2017-07-10 15:00:00-04:00,0,7,15,0,0,266,1566,1832
2017-07-10 17:00:00-04:00,0,7,17,0,0,265,3189,3454
2017-07-10 18:00:00-04:00,0,7,18,0,0,485,8079,8564
2017-07-10 19:00:00-04:00,0,7,19,0,0,837,12017,12854
2017-07-10 20:00:00-04:00,0,7,20,0,0,1512,15431,16943
2017-07-10 21:00:00-04:00,0,7,21,0,0,1443,14230,15673
2017-07-10 22:00:00-04:00,0,7,22,0,0,1217,12628,13845
2017-07-10 23:00:00-04:00,0,7,23,0,0,1098,12374,13472
2017-07-11 00:00:00-04:00,0,7,0,1,0,1112,13429,14541
2017-07-11 01:00:00-04:00,0,7,1,1,0,1064,13826,14890
2017-07-11 02:00:00-04:00,0,7,2,1,0,1225,14218,15443
2017-07-11 03:00:00-04:00,0,7,3,1,0,1378,14345,15723
2017-07-11 04:00:00-04:00,0,7,4,1,0,1524,13482,15006
2017-07-11 05:00:00-04:00,0,7,5,1,0,1637,15854,17491
2017-07-11 06:00:00-04:00,0,7,6,1,0,1878,18789,20667
2017-07-11 07:00:00-04:00,0,7,7,1,0,1689,18099,19788
2017-07-11 08:00:00-04:00,0,7,8,1,0,1394,17434,18828
2017-07-11 09:00:00-04:00,0,7,9,1,0,1464,16719,18183
2017-07-11 10:00:00-04:00,0,7,10,1,0,1124,13954,15078
2017-07-11 11:00:00-04:00,0,7,11,1,0,955,9842,10797
2017-07-11 12:00:00-04:00,0,7,12,1,0,720,6644,7364
2017-07-11 13:00:00-04:00,0,7,13,1,0,435,4055,4490
2017-07-11 14:00:00-04:00,0,7,14,1,0,291,2511,2802
2017-07-11 15:00:00-04:00,0,7,15,1,0,201,1583,1784
2017-07-11 16:00:00-04:00,0,7,16,1,0,174,1552,1726
2017-07-11 17:00:00-04:00,0,7,17,1,0,232,3075,3307
2017-07-11 18:00:00-04:00,0,7,18,1,0,432,8136,8568
2017-07-11 19:00:00-04:00,0,7,19,1,0,821,13041,13862
2017-07-11 20:00:00-04:00,0,7,20,1,0,1547,16845,18392
2017-07-11 21:00:00-04:00,0,7,21,1,0,1482,16717,18199
2017-07-11 22:00:00-04:00,0,7,22,1,0,1327,14037,15364
2017-07-11 23:00:00-04:00,0,7,23,1,0,1182,14118,15300
2017-07-12 00:00:00-04:00,0,7,0,2,0,1229,15065,16294
2017-07-12 01:00:00-04:00,0,7,1,2,0,1129,14924,16053
2017-07-12 02:00:00-04:00,0,7,2,2,0,1292,16120,17412
2017-07-12 03:00:00-04:00,0,7,3,2,0,1388,15476,16864
2017-07-12 04:00:00-04:00,0,7,4,2,0,1619,14654,16273
2017-07-12 05:00:00-04:00,0,7,5,2,0,1842,16623,18465
2017-07-12 06:00:00-04:00,0,7,6,2,0,2091,20983,23074
2017-07-12 07:00:00-04:00,0,7,7,2,0,1851,18975,20826
2017-07-12 08:00:00-04:00,0,7,8,2,0,1479,18243,19722
2017-07-12 09:00:00-04:00,0,7,9,2,0,1438,19203,20641
2017-07-12 10:00:00-04:00,0,7,10,2,0,1341,16984,18325
2017-07-12 11:00:00-04:00,0,7,11,2,0,1113,12693,13806
2017-07-12 12:00:00-04:00,0,7,12,2,0,774,8646,9420
2017-07-12 13:00:00-04:00,0,7,13,2,0,534,4863,5397
2017-07-12 14:00:00-04:00,0,7,14,2,0,331,2820,3151
2017-07-12 15:00:00-04:00,0,7,15,2,0,240,1818,2058
2017-07-12 16:00:00-04:00,0,7,16,2,0,208,1820,2028
2017-07-12 17:00:00-04:00,0,7,17,2,0,198,3173,3371
2017-07-12 18:00:00-04:00,0,7,18,2,0,452,8462,8914
2017-07-12 19:00:00-04:00,0,7,19,2,0,871,14000,14871
2017-07-12 20:00:00-04:00,0,7,20,2,0,1490,17486,18976
2017-07-12 21:00:00-04:00,0,7,21,2,0,1485,16850,18335
2017-07-12 22:00:00-04:00,0,7,22,2,0,1338,15207,16545
2017-07-12 23:00:00-04:00,0,7,23,2,0,1218,15538,16756
2017-07-13 00:00:00-04:00,0,7,0,3,0,1269,16175,17444
2017-07-13 01:00:00-04:00,0,7,1,3,0,1170,16192,17362
2017-07-13 02:00:00-04:00,0,7,2,3,0,1288,16736,18024
2017-07-13 03:00:00-04:00,0,7,3,3,0,1498,15914,17412
2017-07-13 04:00:00-04:00,0,7,4,3,0,1577,14292,15869
2017-07-13 05:00:00-04:00,0,7,5,3,0,1819,16696,18515
2017-07-13 06:00:00-04:00,0,7,6,3,0,2184,20478,22662
2017-07-13 07:00:00-04:00,0,7,7,3,0,2049,20645,22694
2017-07-13 08:00:00-04:00,0,7,8,3,0,1831,20368,22199
2017-07-13 09:00:00-04:00,0,7,9,3,0,1611,19665,21276
2017-07-13 10:00:00-04:00,0,7,10,3,0,1411,18407,19818
2017-07-13 11:00:00-04:00,0,7,11,3,0,1237,14486,15723
2017-07-13 12:00:00-04:00,0,7,12,3,0,974,9563,10537
2017-07-13 13:00:00-04:00,0,7,13,3,0,643,5580,6223
2017-07-13 14:00:00-04:00,0,7,14,3,0,368,3378,3746
2017-07-13 15:00:00-04:00,0,7,15,3,0,247,2272,2519
2017-07-13 16:00:00-04:00,0,7,16,3,0,221,1997,2218
2017-07-13 17:00:00-04:00,0,7,17,3,0,223,3365,3588
2017-07-13 18:00:00-04:00,0,7,18,3,0,494,8782,9276
2017-07-13 19:00:00-04:00,0,7,19,3,0,879,14552,15431
2017-07-13 20:00:00-04:00,0,7,20,3,0,1591,17838,19429
2017-07-13 21:00:00-04:00,0,7,21,3,0,1608,16924,18532
2017-07-13 22:00:00-04:00,0,7,22,3,0,1424,15495,16919
2017-07-13 23:00:00-04:00,0,7,23,3,0,1368,16308,17676
2017-07-14 00:00:00-04:00,0,7,0,4,0,1408,16439,17847
2017-07-14 01:00:00-04:00,0,7,1,4,0,1302,16613,17915
2017-07-14 02:00:00-04:00,0,7,2,4,0,1484,17231,18715
2017-07-14 03:00:00-04:00,0,7,3,4,0,1634,15992,17626
2017-07-14 04:00:00-04:00,0,7,4,4,0,1762,13961,15723
2017-07-14 05:00:00-04:00,0,7,5,4,0,2277,16769,19046
2017-07-14 06:00:00-04:00,0,7,6,4,0,2336,18761,21097
2017-07-14 07:00:00-04:00,0.01,7,7,4,0,2144,18404,20548
2017-07-14 08:00:00-04:00,0.02,7,8,4,0,1706,18305,20011
2017-07-14 09:00:00-04:00,0.3,7,9,4,0,1753,19124,20877
2017-07-14 10:00:00-04:00,0.05,7,10,4,0,1598,18551,20149
2017-07-14 11:00:00-04:00,0.01,7,11,4,0,1432,16433,17865
2017-07-14 12:00:00-04:00,0,7,12,4,0,1201,12384,13585
2017-07-14 13:00:00-04:00,0,7,13,4,0,862,8972,9834
2017-07-14 14:00:00-04:00,0.01,7,14,4,0,540,5625,6165
2017-07-14 15:00:00-04:00,0.04,7,15,4,0,362,3565,3927
2017-07-14 16:00:00-04:00,0.03,7,16,4,0,330,2812,3142
2017-07-14 17:00:00-04:00,0,7,17,4,0,286,3703,3989
2017-07-14 18:00:00-04:00,0,7,18,4,0,495,8849,9344
2017-07-14 19:00:00-04:00,0,7,19,4,0,946,14173,15119
2017-07-14 20:00:00-04:00,0,7,20,4,0,1538,17280,18818
2017-07-14 21:00:00-04:00,0,7,21,4,0,1707,17025,18732
2017-07-14 22:00:00-04:00,0,7,22,4,0,1491,14771,16262
2017-07-14 23:00:00-04:00,0,7,23,4,0,1188,13358,14546
2017-07-15 00:00:00-04:00,0,7,0,5,0,1190,14484,15674
2017-07-15 01:00:00-04:00,0.01,7,1,5,0,1167,14641,15808
2017-07-15 02:00:00-04:00,0,7,2,5,0,1542,16241,17783
2017-07-15 03:00:00-04:00,0,7,3,5,0,1735,14177,15912
2017-07-15 04:00:00-04:00,0,7,4,5,0,2171,12995,15166
2017-07-15 05:00:00-04:00,0,7,5,5,0,2095,14160,16255
2017-07-15 06:00:00-04:00,0,7,6,5,0,2345,17022,19367
2017-07-15 07:00:00-04:00,0,7,7,5,0,2391,17059,19450
2017-07-15 08:00:00-04:00,0,7,8,5,0,1891,15490,17381
2017-07-15 09:00:00-04:00,0,7,9,5,0,2010,16340,18350
2017-07-15 10:00:00-04:00,0,7,10,5,0,1911,16472,18383
2017-07-15 11:00:00-04:00,0,7,11,5,0,1941,16236,18177
2017-07-15 12:00:00-04:00,0,7,12,5,0,1979,14655,16634
2017-07-15 13:00:00-04:00,0,7,13,5,0,1722,13377,15099
2017-07-15 14:00:00-04:00,0,7,14,5,0,1352,10896,12248
2017-07-15 15:00:00-04:00,0,7,15,5,0,1145,8257,9402
2017-07-15 16:00:00-04:00,0,7,16,5,0,814,5140,5954
2017-07-15 17:00:00-04:00,0,7,17,5,0,464,2701,3165
2017-07-15 18:00:00-04:00,0,7,18,5,0,377,3674,4051
2017-07-15 19:00:00-04:00,0,7,19,5,0,466,5102,5568
2017-07-15 20:00:00-04:00,0,7,20,5,0,681,6914,7595
2017-07-15 21:00:00-04:00,0,7,21,5,0,976,9765,10741
2017-07-15 22:00:00-04:00,0,7,22,5,0,1172,11261,12433
2017-07-15 23:00:00-04:00,0,7,23,5,0,1338,12843,14181
2017-07-16 00:00:00-04:00,0,7,0,6,0,1440,13650,15090
2017-07-16 01:00:00-04:00,0,7,1,6,0,1514,14116,15630
2017-07-16 02:00:00-04:00,0,7,2,6,0,1673,13557,15230
2017-07-16 03:00:00-04:00,0,7,3,6,0,1784,13840,15624
2017-07-16 04:00:00-04:00,0,7,4,6,0,1968,13445,15413
2017-07-16 05:00:00-04:00,0,7,5,6,0,1945,14876,16821
2017-07-16 06:00:00-04:00,0,7,6,6,0,2246,15564,17810
2017-07-16 07:00:00-04:00,0,7,7,6,0,2343,15789,18132
2017-07-16 08:00:00-04:00,0,7,8,6,0,2125,13584,15709
2017-07-16 09:00:00-04:00,0,7,9,6,0,2314,14118,16432
2017-07-16 10:00:00-04:00,0,7,10,6,0,2293,14874,17167
2017-07-16 11:00:00-04:00,0,7,11,6,0,2349,15481,17830
2017-07-16 12:00:00-04:00,0,7,12,6,0,2115,14247,16362
2017-07-16 13:00:00-04:00,0,7,13,6,0,1913,13021,14934
2017-07-16 14:00:00-04:00,0,7,14,6,0,1718,11298,13016
2017-07-16 15:00:00-04:00,0,7,15,6,0,1412,8955,10367
2017-07-16 16:00:00-04:00,0,7,16,6,0,1017,6089,7106
2017-07-16 17:00:00-04:00,0,7,17,6,0,583,2849,3432
2017-07-16 18:00:00-04:00,0,7,18,6,0,356,3141,3497
2017-07-16 19:00:00-04:00,0,7,19,6,0,402,4080,4482
2017-07-16 20:00:00-04:00,0,7,20,6,0,563,5714,6277
2017-07-16 21:00:00-04:00,0,7,21,6,0,790,8359,9149
2017-07-16 22:00:00-04:00,0,7,22,6,0,970,10777,11747
2017-07-16 23:00:00-04:00,0,7,23,6,0,1191,12369,13560
2017-07-17 00:00:00-04:00,0,7,0,0,0,1231,13644,14875
2017-07-17 01:00:00-04:00,0,7,1,0,0,1263,13987,15250
2017-07-17 02:00:00-04:00,0,7,2,0,0,1503,14255,15758
2017-07-17 03:00:00-04:00,0,7,3,0,0,1575,13952,15527
2017-07-17 04:00:00-04:00,0,7,4,0,0,1729,13964,15693
2017-07-17 05:00:00-04:00,0,7,5,0,0,1654,14341,15995
2017-07-17 06:00:00-04:00,0,7,6,0,0,1795,14910,16705
2017-07-17 07:00:00-04:00,0,7,7,0,0,1795,13905,15700
2017-07-17 08:00:00-04:00,0,7,8,0,0,1597,13070,14667
2017-07-17 09:00:00-04:00,0,7,9,0,0,1554,12758,14312
2017-07-17 10:00:00-04:00,0,7,10,0,0,1431,11972,13403
2017-07-17 11:00:00-04:00,0,7,11,0,0,1221,8848,10069
2017-07-17 12:00:00-04:00,0,7,12,0,0,858,5370,6228
2017-07-17 13:00:00-04:00,0,7,13,0,0,563,3196,3759
2017-07-17 14:00:00-04:00,0,7,14,0,0,356,1921,2277
2017-07-17 15:00:00-04:00,0,7,15,0,0,279,1411,1690
2017-07-17 16:00:00-04:00,0,7,16,0,0,281,1707,1988
2017-07-17 17:00:00-04:00,0,7,17,0,0,265,3225,3490
2017-07-17 18:00:00-04:00,0,7,18,0,0,434,8257,8691
2017-07-17 19:00:00-04:00,0,7,19,0,0,868,12221,13089
2017-07-17 20:00:00-04:00,0,7,20,0,0,1637,16384,18021
2017-07-17 21:00:00-04:00,0,7,21,0,0,1605,16083,17688
2017-07-17 22:00:00-04:00,0,7,22,0,0,1310,13719,15029
2017-07-17 23:00:00-04:00,0,7,23,0,0,1167,13804,14971
2017-07-18 00:00:00-04:00,0,7,0,1,0,1154,14012,15166
2017-07-18 01:00:00-04:00,0,7,1,1,0,1067,14289,15356
2017-07-18 02:00:00-04:00,0,7,2,1,0,1221,15477,16698
2017-07-18 03:00:00-04:00,0,7,3,1,0,1294,14757,16051
2017-07-18 04:00:00-04:00,0,7,4,1,0,1505,14382,15887
2017-07-18 05:00:00-04:00,0,7,5,1,0,1782,16903,18685
2017-07-18 06:00:00-04:00,0,7,6,1,0,2056,18995,21051
2017-07-18 07:00:00-04:00,0,7,7,1,0,1855,18021,19876
2017-07-18 08:00:00-04:00,0,7,8,1,0,1426,16327,17753
2017-07-18 09:00:00-04:00,0,7,9,1,0,1221,16408,17629
2017-07-18 10:00:00-04:00,0,7,10,1,0,1108,14193,15301
2017-07-18 11:00:00-04:00,0,7,11,1,0,890,10152,11042
2017-07-18 12:00:00-04:00,0,7,12,1,0,666,6547,7213
2017-07-18 13:00:00-04:00,0,7,13,1,0,467,3938,4405
2017-07-18 14:00:00-04:00,0,7,14,1,0,266,2352,2618
2017-07-18 15:00:00-04:00,0,7,15,1,0,199,1560,1759
2017-07-18 16:00:00-04:00,0,7,16,1,0,202,1510,1712
2017-07-18 17:00:00-04:00,0,7,17,1,0,206,3187,3393
2017-07-18 18:00:00-04:00,0,7,18,1,0,434,8407,8841
2017-07-18 19:00:00-04:00,0,7,19,1,0,881,13256,14137
2017-07-18 20:00:00-04:00,0,7,20,1,0,1461,17055,18516
2017-07-18 21:00:00-04:00,0,7,21,1,0,1410,16387,17797
2017-07-18 22:00:00-04:00,0,7,22,1,0,1282,14918,16200
2017-07-18 23:00:00-04:00,0,7,23,1,0,1203,14888,16091
2017-07-19 00:00:00-04:00,0,7,0,2,0,1240,15739,16979
2017-07-19 01:00:00-04:00,0,7,1,2,0,1130,15741,16871
2017-07-19 02:00:00-04:00,0,7,2,2,0,1236,16486,17722
2017-07-19 03:00:00-04:00,0,7,3,2,0,1434,16257,17691
2017-07-19 04:00:00-04:00,0,7,4,2,0,1550,14743,16293
2017-07-19 05:00:00-04:00,0,7,5,2,0,1713,16833,18546
2017-07-19 06:00:00-04:00,0,7,6,2,0,2009,19738,21747
2017-07-19 07:00:00-04:00,0,7,7,2,0,1842,19471,21313
2017-07-19 08:00:00-04:00,0,7,8,2,0,1546,18675,20221
2017-07-19 09:00:00-04:00,0,7,9,2,0,1591,19959,21550
2017-07-19 10:00:00-04:00,0,7,10,2,0,1383,17449,18832
2017-07-19 11:00:00-04:00,0,7,11,2,0,1121,12727,13848
2017-07-19 12:00:00-04:00,0,7,12,2,0,799,8150,8949
2017-07-19 13:00:00-04:00,0,7,13,2,0,480,4712,5192
2017-07-19 14:00:00-04:00,0,7,14,2,0,267,2784,3051
2017-07-19 15:00:00-04:00,0,7,15,2,0,225,1762,1987
2017-07-19 16:00:00-04:00,0,7,16,2,0,213,1818,2031
2017-07-19 17:00:00-04:00,0,7,17,2,0,213,3238,3451
2017-07-19 18:00:00-04:00,0,7,18,2,0,473,8728,9201
2017-07-19 19:00:00-04:00,0,7,19,2,0,874,13841,14715
2017-07-19 20:00:00-04:00,0,7,20,2,0,1469,17684,19153
2017-07-19 21:00:00-04:00,0,7,21,2,0,1525,16922,18447
2017-07-19 22:00:00-04:00,0,7,22,2,0,1349,15224,16573
2017-07-19 23:00:00-04:00,0,7,23,2,0,1282,15656,16938
2017-07-20 00:00:00-04:00,0,7,0,3,0,1318,16644,17962
2017-07-20 01:00:00-04:00,0,7,1,3,0,1278,16506,17784
2017-07-20 02:00:00-04:00,0,7,2,3,0,1400,17243,18643
2017-07-20 03:00:00-04:00,0,7,3,3,0,1487,16150,17637
2017-07-20 04:00:00-04:00,0,7,4,3,0,1772,14625,16397
2017-07-20 05:00:00-04:00,0,7,5,3,0,1977,16743,18720
2017-07-20 06:00:00-04:00,0,7,6,3,0,2180,20235,22415
2017-07-20 07:00:00-04:00,0,7,7,3,0,2123,20781,22904
2017-07-20 08:00:00-04:00,0,7,8,3,0,1658,20088,21746
2017-07-20 09:00:00-04:00,0,7,9,3,0,1774,20647,22421
2017-07-20 10:00:00-04:00,0,7,10,3,0,1609,19365,20974
2017-07-20 11:00:00-04:00,0,7,11,3,0,1351,14709,16060
2017-07-20 12:00:00-04:00,0,7,12,3,0,960,9437,10397
2017-07-20 13:00:00-04:00,0,7,13,3,0,591,5405,5996
2017-07-20 14:00:00-04:00,0,7,14,3,0,373,3427,3800
2017-07-20 15:00:00-04:00,0,7,15,3,0,256,2168,2424
2017-07-20 16:00:00-04:00,0,7,16,3,0,235,1999,2234
2017-07-20 17:00:00-04:00,0,7,17,3,0,218,3527,3745
2017-07-20 18:00:00-04:00,0,7,18,3,0,482,8814,9296
2017-07-20 19:00:00-04:00,0,7,19,3,0,900,14053,14953
2017-07-20 20:00:00-04:00,0,7,20,3,0,1596,17497,19093
2017-07-20 21:00:00-04:00,0,7,21,3,0,1504,16751,18255
2017-07-20 22:00:00-04:00,0,7,22,3,0,1368,15429,16797
2017-07-20 23:00:00-04:00,0,7,23,3,0,1319,15803,17122
2017-07-21 00:00:00-04:00,0,7,0,4,0,1311,16422,17733
2017-07-21 01:00:00-04:00,0,7,1,4,0,1307,16485,17792
2017-07-21 02:00:00-04:00,0,7,2,4,0,1386,17385,18771
2017-07-21 03:00:00-04:00,0,7,3,4,0,1609,16331,17940
2017-07-21 04:00:00-04:00,0,7,4,4,0,1811,13897,15708
2017-07-21 05:00:00-04:00,0,7,5,4,0,2063,15909,17972
2017-07-21 06:00:00-04:00,0,7,6,4,0,2322,18925,21247
2017-07-21 07:00:00-04:00,0,7,7,4,0,2231,19593,21824
2017-07-21 08:00:00-04:00,0,7,8,4,0,2169,21768,23937
2017-07-21 09:00:00-04:00,0,7,9,4,0,1773,18725,20498
2017-07-21 10:00:00-04:00,0,7,10,4,0,1677,18309,19986
2017-07-21 11:00:00-04:00,0,7,11,4,0,1420,16200,17620
2017-07-21 12:00:00-04:00,0,7,12,4,0,1314,12564,13878
2017-07-21 13:00:00-04:00,0,7,13,4,0,977,8476,9453
2017-07-21 14:00:00-04:00,0,7,14,4,0,585,5226,5811
2017-07-21 15:00:00-04:00,0,7,15,4,0,432,3302,3734
2017-07-21 16:00:00-04:00,0,7,16,4,0,359,2643,3002
2017-07-21 17:00:00-04:00,0,7,17,4,0,280,3684,3964
2017-07-21 18:00:00-04:00,0,7,18,4,0,477,8225,8702
2017-07-21 19:00:00-04:00,0,7,19,4,0,855,12047,12902
2017-07-21 20:00:00-04:00,0,7,20,4,0,1488,15797,17285
2017-07-21 21:00:00-04:00,0,7,21,4,0,1469,15299,16768
2017-07-21 22:00:00-04:00,0,7,22,4,0,1410,14022,15432
2017-07-21 23:00:00-04:00,0,7,23,4,0,1281,14440,15721
2017-07-22 00:00:00-04:00,0,7,0,5,0,1245,15427,16672
2017-07-22 01:00:00-04:00,0,7,1,5,0,1124,15323,16447
2017-07-22 02:00:00-04:00,0,7,2,5,0,1415,16147,17562
2017-07-22 03:00:00-04:00,0,7,3,5,0,1718,15097,16815
2017-07-22 04:00:00-04:00,0,7,4,5,0,1972,13368,15340
2017-07-22 05:00:00-04:00,0,7,5,5,0,2242,15632,17874
2017-07-22 06:00:00-04:00,0,7,6,5,0,2459,17952,20411
2017-07-22 07:00:00-04:00,0,7,7,5,0,2463,18431,20894
2017-07-22 08:00:00-04:00,0,7,8,5,0,2098,16660,18758
2017-07-22 09:00:00-04:00,0,7,9,5,0,2148,16867,19015
2017-07-22 10:00:00-04:00,0,7,10,5,0,2163,17681,19844
2017-07-22 11:00:00-04:00,0,7,11,5,0,2201,17504,19705
2017-07-22 12:00:00-04:00,0,7,12,5,0,2110,16010,18120
2017-07-22 13:00:00-04:00,0,7,13,5,0,1782,13818,15600
2017-07-22 14:00:00-04:00,0,7,14,5,0,1493,11647,13140
2017-07-22 15:00:00-04:00,0,7,15,5,0,1218,8474,9692
2017-07-22 16:00:00-04:00,0,7,16,5,0,916,5237,6153
2017-07-22 17:00:00-04:00,0,7,17,5,0,466,2817,3283
2017-07-22 18:00:00-04:00,0,7,18,5,0,408,4070,4478
2017-07-22 19:00:00-04:00,0,7,19,5,0,514,4989,5503
2017-07-22 20:00:00-04:00,0,7,20,5,0,712,6942,7654
2017-07-22 21:00:00-04:00,0,7,21,5,0,1008,9664,10672
2017-07-22 22:00:00-04:00,0,7,22,5,0,1135,11676,12811
2017-07-22 23:00:00-04:00,0.07,7,23,5,0,1321,13044,14365
2017-07-23 00:00:00-04:00,0.36,7,0,6,0,1439,14126,15565
2017-07-23 01:00:00-04:00,0.15,7,1,6,0,1437,14513,15950
2017-07-23 02:00:00-04:00,0,7,2,6,0,1524,14307,15831
2017-07-23 03:00:00-04:00,0,7,3,6,0,1710,14166,15876
2017-07-23 04:00:00-04:00,0.02,7,4,6,0,1805,14033,15838
2017-07-23 05:00:00-04:00,0,7,5,6,0,2000,14939,16939
2017-07-23 06:00:00-04:00,0,7,6,6,0,2175,17913,20088
2017-07-23 07:00:00-04:00,0,7,7,6,0,2284,16467,18751
2017-07-23 08:00:00-04:00,0,7,8,6,0,2016,13903,15919
2017-07-23 09:00:00-04:00,0,7,9,6,0,2253,14460,16713
2017-07-23 10:00:00-04:00,0,7,10,6,0,2153,15417,17570
2017-07-23 11:00:00-04:00,0,7,11,6,0,2622,18521,21143
2017-07-23 12:00:00-04:00,0,7,12,6,0,2316,15632,17948
2017-07-23 13:00:00-04:00,0.01,7,13,6,0,1871,11911,13782
2017-07-23 14:00:00-04:00,0,7,14,6,0,1349,9825,11174
2017-07-23 15:00:00-04:00,0,7,15,6,0,1113,7660,8773
2017-07-23 16:00:00-04:00,0,7,16,6,0,820,5053,5873
2017-07-23 17:00:00-04:00,0,7,17,6,0,460,2520,2980
2017-07-23 18:00:00-04:00,0,7,18,6,0,341,2743,3084
2017-07-23 19:00:00-04:00,0,7,19,6,0,428,3820,4248
2017-07-23 20:00:00-04:00,0,7,20,6,0,508,5113,5621
2017-07-23 21:00:00-04:00,0,7,21,6,0,788,7647,8435
2017-07-23 22:00:00-04:00,0,7,22,6,0,922,9941,10863
2017-07-23 23:00:00-04:00,0,7,23,6,0,1137,12983,14120
2017-07-24 00:00:00-04:00,0,7,0,0,0,1367,15153,16520
2017-07-24 01:00:00-04:00,0,7,1,0,0,1251,12867,14118
2017-07-24 02:00:00-04:00,0,7,2,0,0,1347,12898,14245
2017-07-24 03:00:00-04:00,0,7,3,0,0,1436,12692,14128
2017-07-24 04:00:00-04:00,0.01,7,4,0,0,1590,13053,14643
2017-07-24 05:00:00-04:00,0.25,7,5,0,0,1580,13684,15264
2017-07-24 06:00:00-04:00,0.15,7,6,0,0,1743,13787,15530
2017-07-24 07:00:00-04:00,0.04,7,7,0,0,1608,12711,14319
2017-07-24 08:00:00-04:00,0,7,8,0,0,1414,12001,13415
2017-07-24 09:00:00-04:00,0.11,7,9,0,0,1334,11169,12503
2017-07-24 10:00:00-04:00,0.18,7,10,0,0,1295,10451,11746
2017-07-24 11:00:00-04:00,0.16,7,11,0,0,1250,8769,10019
2017-07-24 12:00:00-04:00,0,7,12,0,0,836,5706,6542
2017-07-24 13:00:00-04:00,0,7,13,0,0,524,3998,4522
2017-07-24 14:00:00-04:00,0,7,14,0,0,359,2381,2740
2017-07-24 15:00:00-04:00,0,7,15,0,0,233,1540,1773
2017-07-24 16:00:00-04:00,0,7,16,0,0,282,1863,2145
2017-07-24 17:00:00-04:00,0,7,17,0,0,280,3694,3974
2017-07-24 18:00:00-04:00,0,7,18,0,0,451,8946,9397
2017-07-24 19:00:00-04:00,0,7,19,0,0,868,12334,13202
2017-07-24 20:00:00-04:00,0,7,20,0,0,1500,16379,17879
2017-07-24 21:00:00-04:00,0,7,21,0,0,1567,16041,17608
2017-07-24 22:00:00-04:00,0,7,22,0,0,1621,15846,17467
2017-07-24 23:00:00-04:00,0,7,23,0,0,1215,13470,14685
2017-07-25 00:00:00-04:00,0,7,0,1,0,1127,13284,14411
2017-07-25 01:00:00-04:00,0,7,1,1,0,1039,12878,13917
2017-07-25 02:00:00-04:00,0,7,2,1,0,1081,13501,14582
2017-07-25 03:00:00-04:00,0,7,3,1,0,1313,13345,14658
2017-07-25 04:00:00-04:00,0,7,4,1,0,1314,13265,14579
2017-07-25 05:00:00-04:00,0,7,5,1,0,1551,15063,16614
2017-07-25 06:00:00-04:00,0,7,6,1,0,1742,18073,19815
2017-07-25 07:00:00-04:00,0,7,7,1,0,1711,18215,19926
2017-07-25 08:00:00-04:00,0,7,8,1,0,1587,17374,18961
2017-07-25 09:00:00-04:00,0,7,9,1,0,1219,15171,16390
2017-07-25 10:00:00-04:00,0,7,10,1,0,983,13085,14068
2017-07-25 11:00:00-04:00,0,7,11,1,0,844,9165,10009
2017-07-25 12:00:00-04:00,0,7,12,1,0,601,6189,6790
2017-07-25 13:00:00-04:00,0,7,13,1,0,406,3991,4397
2017-07-25 14:00:00-04:00,0,7,14,1,0,246,2248,2494
2017-07-25 15:00:00-04:00,0,7,15,1,0,175,1474,1649
2017-07-25 16:00:00-04:00,0,7,16,1,0,198,1537,1735
2017-07-25 17:00:00-04:00,0,7,17,1,0,222,3212,3434
2017-07-25 18:00:00-04:00,0,7,18,1,0,402,8619,9021
2017-07-25 19:00:00-04:00,0,7,19,1,0,783,12930,13713
2017-07-25 20:00:00-04:00,0,7,20,1,0,1385,16137,17522
2017-07-25 21:00:00-04:00,0,7,21,1,0,1368,15357,16725
2017-07-25 22:00:00-04:00,0,7,22,1,0,1204,13745,14949
2017-07-25 23:00:00-04:00,0,7,23,1,0,1132,13707,14839
2017-07-26 00:00:00-04:00,0,7,0,2,0,1149,14536,15685
2017-07-26 01:00:00-04:00,0,7,1,2,0,1042,14196,15238
2017-07-26 02:00:00-04:00,0,7,2,2,0,1218,14942,16160
2017-07-26 03:00:00-04:00,0,7,3,2,0,1374,14675,16049
2017-07-26 04:00:00-04:00,0,7,4,2,0,1472,13998,15470
2017-07-26 05:00:00-04:00,0,7,5,2,0,1736,16613,18349
2017-07-26 06:00:00-04:00,0,7,6,2,0,1840,19296,21136
2017-07-26 07:00:00-04:00,0,7,7,2,0,1712,18327,20039
2017-07-26 08:00:00-04:00,0,7,8,2,0,1474,17973,19447
2017-07-26 09:00:00-04:00,0,7,9,2,0,1522,18747,20269
2017-07-26 10:00:00-04:00,0,7,10,2,0,1230,16578,17808
2017-07-26 11:00:00-04:00,0,7,11,2,0,996,12877,13873
2017-07-26 12:00:00-04:00,0,7,12,2,0,837,8027,8864
2017-07-26 13:00:00-04:00,0,7,13,2,0,526,4623,5149
2017-07-26 14:00:00-04:00,0,7,14,2,0,301,3025,3326
2017-07-26 15:00:00-04:00,0,7,15,2,0,175,2000,2175
2017-07-26 16:00:00-04:00,0,7,16,2,0,224,1935,2159
2017-07-26 17:00:00-04:00,0,7,17,2,0,203,3200,3403
2017-07-26 18:00:00-04:00,0,7,18,2,0,433,8332,8765
2017-07-26 19:00:00-04:00,0,7,19,2,0,816,12782,13598
2017-07-26 20:00:00-04:00,0,7,20,2,0,1312,16107,17419
2017-07-26 21:00:00-04:00,0,7,21,2,0,1371,15460,16831
2017-07-26 22:00:00-04:00,0,7,22,2,0,1255,13995,15250
2017-07-26 23:00:00-04:00,0,7,23,2,0,1227,14260,15487
2017-07-27 00:00:00-04:00,0,7,0,3,0,1187,15220,16407
2017-07-27 01:00:00-04:00,0,7,1,3,0,1125,14947,16072
2017-07-27 02:00:00-04:00,0,7,2,3,0,1285,15694,16979
2017-07-27 03:00:00-04:00,0,7,3,3,0,1416,14832,16248
2017-07-27 04:00:00-04:00,0,7,4,3,0,1550,13784,15334
2017-07-27 05:00:00-04:00,0,7,5,3,0,1720,15932,17652
2017-07-27 06:00:00-04:00,0,7,6,3,0,1968,19120,21088
2017-07-27 07:00:00-04:00,0,7,7,3,0,1941,19724,21665
2017-07-27 08:00:00-04:00,0,7,8,3,0,1674,18829,20503
2017-07-27 09:00:00-04:00,0,7,9,3,0,1642,20072,21714
2017-07-27 10:00:00-04:00,0,7,10,3,0,1492,18489,19981
2017-07-27 11:00:00-04:00,0,7,11,3,0,1258,15131,16389
2017-07-27 12:00:00-04:00,0,7,12,3,0,1050,9761,10811
2017-07-27 13:00:00-04:00,0,7,13,3,0,631,5703,6334
2017-07-27 14:00:00-04:00,0,7,14,3,0,454,3562,4016
2017-07-27 15:00:00-04:00,0,7,15,3,0,287,2302,2589
2017-07-27 16:00:00-04:00,0,7,16,3,0,237,2056,2293
2017-07-27 17:00:00-04:00,0,7,17,3,0,224,3335,3559
2017-07-27 18:00:00-04:00,0,7,18,3,0,418,8545,8963
2017-07-27 19:00:00-04:00,0,7,19,3,0,815,13097,13912
2017-07-27 20:00:00-04:00,0,7,20,3,0,1408,16336,17744
2017-07-27 21:00:00-04:00,0,7,21,3,0,1462,15662,17124
2017-07-27 22:00:00-04:00,0,7,22,3,0,1301,14455,15756
2017-07-27 23:00:00-04:00,0,7,23,3,0,1195,14584,15779
2017-07-28 00:00:00-04:00,0,7,0,4,0,1200,15040,16240
2017-07-28 01:00:00-04:00,0,7,1,4,0,1203,15318,16521
2017-07-28 02:00:00-04:00,0,7,2,4,0,1502,17517,19019
2017-07-28 03:00:00-04:00,0,7,3,4,0,1476,14829,16305
2017-07-28 04:00:00-04:00,0,7,4,4,0,1756,13791,15547
2017-07-28 05:00:00-04:00,0,7,5,4,0,1999,16359,18358
2017-07-28 06:00:00-04:00,0,7,6,4,0,2248,20038,22286
2017-07-28 07:00:00-04:00,0,7,7,4,0,2067,19733,21800
2017-07-28 08:00:00-04:00,0,7,8,4,0,1649,19080,20729
2017-07-28 09:00:00-04:00,0,7,9,4,0,1739,19500,21239
2017-07-28 10:00:00-04:00,0,7,10,4,0,1616,18765,20381
2017-07-28 11:00:00-04:00,0,7,11,4,0,1430,16468,17898
2017-07-28 12:00:00-04:00,0,7,12,4,0,1133,11863,12996
2017-07-28 13:00:00-04:00,0,7,13,4,0,858,8154,9012
2017-07-28 14:00:00-04:00,0,7,14,4,0,553,5342,5895
2017-07-28 15:00:00-04:00,0,7,15,4,0,379,3325,3704
2017-07-28 16:00:00-04:00,0,7,16,4,0,328,2749,3077
2017-07-28 17:00:00-04:00,0,7,17,4,0,286,3652,3938
2017-07-28 18:00:00-04:00,0,7,18,4,0,396,8037,8433
2017-07-28 19:00:00-04:00,0,7,19,4,0,889,11625,12514
2017-07-28 20:00:00-04:00,0,7,20,4,0,1480,15107,16587
2017-07-28 21:00:00-04:00,0,7,21,4,0,1454,14704,16158
2017-07-28 22:00:00-04:00,0,7,22,4,0,1400,13445,14845
2017-07-28 23:00:00-04:00,0,7,23,4,0,1253,13814,15067
2017-07-29 00:00:00-04:00,0,7,0,5,0,1127,14811,15938
2017-07-29 01:00:00-04:00,0,7,1,5,0,1144,14782,15926
2017-07-29 02:00:00-04:00,0,7,2,5,0,1429,15925,17354
2017-07-29 03:00:00-04:00,0,7,3,5,0,1579,15265,16844
2017-07-29 04:00:00-04:00,0,7,4,5,0,1797,13823,15620
2017-07-29 05:00:00-04:00,0,7,5,5,0,2096,16106,18202
2017-07-29 06:00:00-04:00,0,7,6,5,0,2303,18773,21076
2017-07-29 07:00:00-04:00,0,7,7,5,0,2306,18473,20779
2017-07-29 08:00:00-04:00,0,7,8,5,0,2015,16155,18170
2017-07-29 09:00:00-04:00,0,7,9,5,0,1963,15958,17921
2017-07-29 10:00:00-04:00,0,7,10,5,0,2087,16763,18850
2017-07-29 11:00:00-04:00,0,7,11,5,0,2170,17067,19237
2017-07-29 12:00:00-04:00,0,7,12,5,0,2142,16787,18929
2017-07-29 13:00:00-04:00,0,7,13,5,0,1916,14602,16518
2017-07-29 14:00:00-04:00,0,7,14,5,0,1562,11876,13438
2017-07-29 15:00:00-04:00,0,7,15,5,0,1262,8706,9968
2017-07-29 16:00:00-04:00,0,7,16,5,0,879,5405,6284
2017-07-29 17:00:00-04:00,0,7,17,5,0,523,2772,3295
2017-07-29 18:00:00-04:00,0,7,18,5,0,391,3575,3966
2017-07-29 19:00:00-04:00,0,7,19,5,0,511,4504,5015
2017-07-29 20:00:00-04:00,0,7,20,5,0,675,6281,6956
2017-07-29 21:00:00-04:00,0,7,21,5,0,872,8718,9590
2017-07-29 22:00:00-04:00,0,7,22,5,0,1089,10614,11703
2017-07-29 23:00:00-04:00,0,7,23,5,0,1166,11941,13107
2017-07-30 00:00:00-04:00,0,7,0,6,0,1277,13137,14414
2017-07-30 01:00:00-04:00,0,7,1,6,0,1327,13682,15009
2017-07-30 02:00:00-04:00,0,7,2,6,0,1487,13299,14786
2017-07-30 03:00:00-04:00,0,7,3,6,0,1669,13232,14901
2017-07-30 04:00:00-04:00,0,7,4,6,0,1764,13363,15127
2017-07-30 05:00:00-04:00,0,7,5,6,0,1827,14282,16109
2017-07-30 06:00:00-04:00,0,7,6,6,0,2033,14830,16863
2017-07-30 07:00:00-04:00,0,7,7,6,0,2056,15071,17127
2017-07-30 08:00:00-04:00,0,7,8,6,0,1887,13045,14932
2017-07-30 09:00:00-04:00,0,7,9,6,0,2089,13926,16015
2017-07-30 10:00:00-04:00,0,7,10,6,0,2093,14553,16646
2017-07-30 11:00:00-04:00,0,7,11,6,0,2428,16330,18758
2017-07-30 12:00:00-04:00,0,7,12,6,0,2101,15035,17136
2017-07-30 13:00:00-04:00,0,7,13,6,0,1919,13898,15817
2017-07-30 14:00:00-04:00,0,7,14,6,0,1556,11808,13364
2017-07-30 15:00:00-04:00,0,7,15,6,0,1285,8962,10247
2017-07-30 16:00:00-04:00,0,7,16,6,0,921,5741,6662
2017-07-30 17:00:00-04:00,0,7,17,6,0,509,2713,3222
2017-07-30 18:00:00-04:00,0,7,18,6,0,337,2820,3157
2017-07-30 19:00:00-04:00,0,7,19,6,0,408,3770,4178
2017-07-30 20:00:00-04:00,0,7,20,6,0,483,5097,5580
2017-07-30 21:00:00-04:00,0,7,21,6,0,689,7457,8146
2017-07-30 22:00:00-04:00,0,7,22,6,0,940,10326,11266
2017-07-30 23:00:00-04:00,0,7,23,6,0,1122,11806,12928
2017-07-31 00:00:00-04:00,0,7,0,0,0,1165,12720,13885
2017-07-31 01:00:00-04:00,0,7,1,0,0,1161,12981,14142
2017-07-31 02:00:00-04:00,0,7,2,0,0,1309,13927,15236
2017-07-31 03:00:00-04:00,0,7,3,0,0,1440,13459,14899
2017-07-31 04:00:00-04:00,0,7,4,0,0,1578,13577,15155
2017-07-31 05:00:00-04:00,0,7,5,0,0,1564,14175,15739
2017-07-31 06:00:00-04:00,0,7,6,0,0,1702,14474,16176
2017-07-31 07:00:00-04:00,0,7,7,0,0,1604,13600,15204
2017-07-31 08:00:00-04:00,0,7,8,0,0,1542,12717,14259
2017-07-31 09:00:00-04:00,0,7,9,0,0,1581,12517,14098
2017-07-31 10:00:00-04:00,0,7,10,0,0,1500,11577,13077
2017-07-31 11:00:00-04:00,0,7,11,0,0,1373,9799,11172
2017-07-31 12:00:00-04:00,0,7,12,0,0,934,6254,7188
2017-07-31 13:00:00-04:00,0,7,13,0,0,579,3452,4031
2017-07-31 14:00:00-04:00,0,7,14,0,0,365,2383,2748
2017-07-31 15:00:00-04:00,0,7,15,0,0,292,1618,1910
2017-07-31 16:00:00-04:00,0,7,16,0,0,308,1952,2260
2017-07-31 17:00:00-04:00,0,7,17,0,0,245,3266,3511
2017-07-31 18:00:00-04:00,0,7,18,0,0,398,7956,8354
2017-07-31 19:00:00-04:00,0,7,19,0,0,795,11808,12603
2017-07-31 20:00:00-04:00,0,7,20,0,0,1335,14617,15952
2017-07-31 21:00:00-04:00,0,7,21,0,0,1338,13661,14999
2017-07-31 22:00:00-04:00,0,7,22,0,0,1086,12292,13378
2017-07-31 23:00:00-04:00,0,7,23,0,0,1065,12410,13475
2017-08-01 00:00:00-04:00,0,8,0,1,0,1043,12956,13999
2017-08-01 01:00:00-04:00,0,8,1,1,0,1025,13723,14748
2017-08-01 02:00:00-04:00,0,8,2,1,0,1168,14363,15531
2017-08-01 03:00:00-04:00,0,8,3,1,0,1267,14524,15791
2017-08-01 04:00:00-04:00,0,8,4,1,0,1430,13674,15104
2017-08-01 05:00:00-04:00,0,8,5,1,0,1612,15498,17110
2017-08-01 06:00:00-04:00,0,8,6,1,0,1831,18022,19853
2017-08-01 07:00:00-04:00,0,8,7,1,0,1727,17399,19126
2017-08-01 08:00:00-04:00,0,8,8,1,0,1325,15767,17092
2017-08-01 09:00:00-04:00,0,8,9,1,0,1295,14972,16267
2017-08-01 10:00:00-04:00,0,8,10,1,0,1087,13243,14330
2017-08-01 11:00:00-04:00,0,8,11,1,0,852,9373,10225
2017-08-01 12:00:00-04:00,0,8,12,1,0,618,6034,6652
2017-08-01 13:00:00-04:00,0,8,13,1,0,406,3565,3971
2017-08-01 14:00:00-04:00,0,8,14,1,0,284,2289,2573
2017-08-01 15:00:00-04:00,0,8,15,1,0,195,1526,1721
2017-08-01 16:00:00-04:00,0,8,16,1,0,186,1618,1804
2017-08-01 17:00:00-04:00,0,8,17,1,0,235,3150,3385
2017-08-01 18:00:00-04:00,0,8,18,1,0,421,8202,8623
2017-08-01 19:00:00-04:00,0,8,19,1,0,798,12115,12913
2017-08-01 20:00:00-04:00,0,8,20,1,0,1426,15634,17060
2017-08-01 21:00:00-04:00,0,8,21,1,0,1401,14975,16376
2017-08-01 22:00:00-04:00,0,8,22,1,0,1283,13498,14781
2017-08-01 23:00:00-04:00,0,8,23,1,0,1169,13718,14887
2017-08-02 00:00:00-04:00,0,8,0,2,0,1177,14701,15878
2017-08-02 01:00:00-04:00,0,8,1,2,0,1143,15083,16226
2017-08-02 02:00:00-04:00,0,8,2,2,0,1263,15582,16845
2017-08-02 03:00:00-04:00,0,8,3,2,0,1409,15475,16884
2017-08-02 04:00:00-04:00,0,8,4,2,0,1572,14180,15752
2017-08-02 05:00:00-04:00,0,8,5,2,0,1758,16433,18191
2017-08-02 06:00:00-04:00,0,8,6,2,0,1998,19173,21171
2017-08-02 07:00:00-04:00,0,8,7,2,0,1846,18625,20471
2017-08-02 08:00:00-04:00,0,8,8,2,0,1542,17253,18795
2017-08-02 09:00:00-04:00,0,8,9,2,0,1494,17617,19111
2017-08-02 10:00:00-04:00,0,8,10,2,0,1352,15689,17041
2017-08-02 11:00:00-04:00,0,8,11,2,0,1116,12810,13926
2017-08-02 12:00:00-04:00,0,8,12,2,0,845,9056,9901
2017-08-02 13:00:00-04:00,0,8,13,2,0,564,5092,5656
2017-08-02 14:00:00-04:00,0,8,14,2,0,327,2881,3208
2017-08-02 15:00:00-04:00,0,8,15,2,0,232,1960,2192
2017-08-02 16:00:00-04:00,0,8,16,2,0,213,1757,1970
2017-08-02 17:00:00-04:00,0.05,8,17,2,0,208,3092,3300
2017-08-02 18:00:00-04:00,0.03,8,18,2,0,427,8362,8789
2017-08-02 19:00:00-04:00,0,8,19,2,0,800,12914,13714
2017-08-02 20:00:00-04:00,0,8,20,2,0,1381,16654,18035
2017-08-02 21:00:00-04:00,0,8,21,2,0,1384,15884,17268
2017-08-02 22:00:00-04:00,0,8,22,2,0,1297,14224,15521
2017-08-02 23:00:00-04:00,0,8,23,2,0,1285,15155,16440
2017-08-03 00:00:00-04:00,0,8,0,3,0,1352,18850,20202
2017-08-03 01:00:00-04:00,0,8,1,3,0,1227,16651,17878
2017-08-03 02:00:00-04:00,0,8,2,3,0,1276,14727,16003
2017-08-03 03:00:00-04:00,0,8,3,3,0,1412,14479,15891
2017-08-03 04:00:00-04:00,0,8,4,3,0,1836,14694,16530
2017-08-03 05:00:00-04:00,0,8,5,3,0,2462,17978,20440
2017-08-03 06:00:00-04:00,0,8,6,3,0,2090,17353,19443
2017-08-03 07:00:00-04:00,0,8,7,3,0,1818,18024,19842
2017-08-03 08:00:00-04:00,0,8,8,3,0,1461,17727,19188
2017-08-03 09:00:00-04:00,0,8,9,3,0,1514,18116,19630
2017-08-03 10:00:00-04:00,0,8,10,3,0,1272,16560,17832
2017-08-03 11:00:00-04:00,0,8,11,3,0,1204,14111,15315
2017-08-03 12:00:00-04:00,0,8,12,3,0,919,10029,10948
2017-08-03 13:00:00-04:00,0,8,13,3,0,598,5607,6205
2017-08-03 14:00:00-04:00,0,8,14,3,0,335,3477,3812
2017-08-03 15:00:00-04:00,0,8,15,3,0,239,2193,2432
2017-08-03 16:00:00-04:00,0,8,16,3,0,222,2125,2347
2017-08-03 17:00:00-04:00,0,8,17,3,0,221,3377,3598
2017-08-03 18:00:00-04:00,0,8,18,3,0,438,8501,8939
2017-08-03 19:00:00-04:00,0,8,19,3,0,818,13151,13969
2017-08-03 20:00:00-04:00,0,8,20,3,0,1472,16522,17994
2017-08-03 21:00:00-04:00,0,8,21,3,0,1459,16193,17652
2017-08-03 22:00:00-04:00,0,8,22,3,0,1288,14301,15589
2017-08-03 23:00:00-04:00,0.01,8,23,3,0,1253,14385,15638
2017-08-04 00:00:00-04:00,0,8,0,4,0,1299,15272,16571
2017-08-04 01:00:00-04:00,0,8,1,4,0,1247,15762,17009
2017-08-04 02:00:00-04:00,0,8,2,4,0,1321,16403,17724
2017-08-04 03:00:00-04:00,0,8,3,4,0,1648,15710,17358
2017-08-04 04:00:00-04:00,0,8,4,4,0,1753,13965,15718
2017-08-04 05:00:00-04:00,0,8,5,4,0,1930,16327,18257
2017-08-04 06:00:00-04:00,0,8,6,4,0,2182,19023,21205
2017-08-04 07:00:00-04:00,0.09,8,7,4,0,2013,19716,21729
2017-08-04 08:00:00-04:00,0.65,8,8,4,0,1808,19625,21433
2017-08-04 09:00:00-04:00,0.01,8,9,4,0,1725,19074,20799
2017-08-04 10:00:00-04:00,0,8,10,4,0,1552,18116,19668
2017-08-04 11:00:00-04:00,0,8,11,4,0,1383,15757,17140
2017-08-04 12:00:00-04:00,0,8,12,4,0,1163,11877,13040
2017-08-04 13:00:00-04:00,0,8,13,4,0,924,8625,9549
2017-08-04 14:00:00-04:00,0,8,14,4,0,609,5255,5864
2017-08-04 15:00:00-04:00,0,8,15,4,0,389,3286,3675
2017-08-04 16:00:00-04:00,0,8,16,4,0,309,2733,3042
2017-08-04 17:00:00-04:00,0,8,17,4,0,282,3449,3731
2017-08-04 18:00:00-04:00,0,8,18,4,0,416,8724,9140
2017-08-04 19:00:00-04:00,0,8,19,4,0,970,15022,15992
2017-08-04 20:00:00-04:00,0,8,20,4,0,1407,14878,16285
2017-08-04 21:00:00-04:00,0,8,21,4,0,1528,14166,15694
2017-08-04 22:00:00-04:00,0,8,22,4,0,1307,13179,14486
2017-08-04 23:00:00-04:00,0,8,23,4,0,1242,13338,14580
2017-08-05 00:00:00-04:00,0,8,0,5,0,1208,14089,15297
2017-08-05 01:00:00-04:00,0,8,1,5,0,1127,14406,15533
2017-08-05 02:00:00-04:00,0,8,2,5,0,1360,14954,16314
2017-08-05 03:00:00-04:00,0,8,3,5,0,1590,14003,15593
2017-08-05 04:00:00-04:00,0,8,4,5,0,1787,12901,14688
2017-08-05 05:00:00-04:00,0.07,8,5,5,0,2084,14999,17083
2017-08-05 06:00:00-04:00,0.09,8,6,5,0,2280,17084,19364
2017-08-05 07:00:00-04:00,0,8,7,5,0,2285,17324,19609
2017-08-05 08:00:00-04:00,0,8,8,5,0,2042,15740,17782
2017-08-05 09:00:00-04:00,0,8,9,5,0,1982,15496,17478
2017-08-05 10:00:00-04:00,0,8,10,5,0,1922,15714,17636
2017-08-05 11:00:00-04:00,0,8,11,5,0,2009,15964,17973
2017-08-05 12:00:00-04:00,0,8,12,5,0,1981,14678,16659
2017-08-05 13:00:00-04:00,0,8,13,5,0,1704,13626,15330
2017-08-05 14:00:00-04:00,0,8,14,5,0,1387,11229,12616
2017-08-05 15:00:00-04:00,0,8,15,5,0,1137,8030,9167
2017-08-05 16:00:00-04:00,0,8,16,5,0,897,5229,6126
2017-08-05 17:00:00-04:00,0,8,17,5,0,505,2785,3290
2017-08-05 18:00:00-04:00,0,8,18,5,0,401,3550,3951
2017-08-05 19:00:00-04:00,0,8,19,5,0,489,4551,5040
2017-08-05 20:00:00-04:00,0,8,20,5,0,613,6087,6700
2017-08-05 21:00:00-04:00,0,8,21,5,0,857,8480,9337
2017-08-05 22:00:00-04:00,0,8,22,5,0,1060,10366,11426
2017-08-05 23:00:00-04:00,0,8,23,5,0,1227,11690,12917
2017-08-06 00:00:00-04:00,0,8,0,6,0,1287,12469,13756
2017-08-06 01:00:00-04:00,0,8,1,6,0,1326,12971,14297
2017-08-06 02:00:00-04:00,0,8,2,6,0,1433,12819,14252
2017-08-06 03:00:00-04:00,0,8,3,6,0,1682,13883,15565
2017-08-06 04:00:00-04:00,0,8,4,6,0,1743,13075,14818
2017-08-06 05:00:00-04:00,0,8,5,6,0,1800,14157,15957
2017-08-06 06:00:00-04:00,0,8,6,6,0,2037,14701,16738
2017-08-06 07:00:00-04:00,0,8,7,6,0,2109,14658,16767
2017-08-06 08:00:00-04:00,0,8,8,6,0,1914,13069,14983
2017-08-06 09:00:00-04:00,0,8,9,6,0,1981,13131,15112
2017-08-06 10:00:00-04:00,0,8,10,6,0,2092,13964,16056
2017-08-06 11:00:00-04:00,0,8,11,6,0,2037,14510,16547
2017-08-06 12:00:00-04:00,0,8,12,6,0,2010,14178,16188
2017-08-06 13:00:00-04:00,0,8,13,6,0,1875,12483,14358
2017-08-06 14:00:00-04:00,0,8,14,6,0,1542,10629,12171
2017-08-06 15:00:00-04:00,0,8,15,6,0,1239,8411,9650
2017-08-06 16:00:00-04:00,0,8,16,6,0,916,5188,6104
2017-08-06 17:00:00-04:00,0,8,17,6,0,480,2608,3088
2017-08-06 18:00:00-04:00,0,8,18,6,0,326,2850,3176
2017-08-06 19:00:00-04:00,0,8,19,6,0,380,3761,4141
2017-08-06 20:00:00-04:00,0,8,20,6,0,496,5633,6129
2017-08-06 21:00:00-04:00,0,8,21,6,0,746,7576,8322
2017-08-06 22:00:00-04:00,0,8,22,6,0,940,9591,10531
2017-08-06 23:00:00-04:00,0,8,23,6,0,1025,11011,12036
2017-08-07 00:00:00-04:00,0,8,0,0,0,1163,11686,12849
2017-08-07 01:00:00-04:00,0,8,1,0,0,1118,12182,13300
2017-08-07 02:00:00-04:00,0,8,2,0,0,1333,12621,13954
2017-08-07 03:00:00-04:00,0,8,3,0,0,1455,12349,13804
2017-08-07 04:00:00-04:00,0,8,4,0,0,1473,12576,14049
2017-08-07 05:00:00-04:00,0,8,5,0,0,1497,13577,15074
2017-08-07 06:00:00-04:00,0,8,6,0,0,1507,14030,15537
2017-08-07 07:00:00-04:00,0,8,7,0,0,1583,13012,14595
2017-08-07 08:00:00-04:00,0,8,8,0,0,1421,12226,13647
2017-08-07 09:00:00-04:00,0.01,8,9,0,0,1405,11640,13045
2017-08-07 10:00:00-04:00,0,8,10,0,0,1270,10359,11629
2017-08-07 11:00:00-04:00,0.02,8,11,0,0,1137,9175,10312
2017-08-07 12:00:00-04:00,0.05,8,12,0,0,762,5913,6675
2017-08-07 13:00:00-04:00,0.02,8,13,0,0,480,3339,3819
2017-08-07 14:00:00-04:00,0.1,8,14,0,0,302,2136,2438
2017-08-07 15:00:00-04:00,0.07,8,15,0,0,225,1560,1785
2017-08-07 16:00:00-04:00,0.09,8,16,0,0,259,1751,2010
2017-08-07 17:00:00-04:00,0.01,8,17,0,0,254,3192,3446
2017-08-07 18:00:00-04:00,0.03,8,18,0,0,459,7861,8320
2017-08-07 19:00:00-04:00,0.01,8,19,0,0,806,12301,13107
2017-08-07 20:00:00-04:00,0.02,8,20,0,0,1435,15735,17170
2017-08-07 21:00:00-04:00,0,8,21,0,0,1491,15255,16746
2017-08-07 22:00:00-04:00,0,8,22,0,0,1228,12866,14094
2017-08-07 23:00:00-04:00,0,8,23,0,0,1185,13855,15040
2017-08-08 00:00:00-04:00,0,8,0,1,0,1200,13837,15037
2017-08-08 01:00:00-04:00,0,8,1,1,0,1122,14050,15172
2017-08-08 02:00:00-04:00,0,8,2,1,0,1339,15608,16947
2017-08-08 03:00:00-04:00,0,8,3,1,0,1520,14688,16208
2017-08-08 04:00:00-04:00,0,8,4,1,0,1669,14204,15873
2017-08-08 05:00:00-04:00,0,8,5,1,0,1731,15738,17469
2017-08-08 06:00:00-04:00,0,8,6,1,0,2007,19629,21636
2017-08-08 07:00:00-04:00,0,8,7,1,0,1821,17337,19158
2017-08-08 08:00:00-04:00,0,8,8,1,0,1351,15747,17098
2017-08-08 09:00:00-04:00,0,8,9,1,0,1094,13446,14540
2017-08-08 10:00:00-04:00,0,8,10,1,0,893,11511,12404
2017-08-08 11:00:00-04:00,0,8,11,1,0,787,8283,9070
2017-08-08 12:00:00-04:00,0,8,12,1,0,544,5289,5833
2017-08-08 13:00:00-04:00,0,8,13,1,0,297,2935,3232
2017-08-08 14:00:00-04:00,0,8,14,1,0,223,1952,2175
2017-08-08 15:00:00-04:00,0,8,15,1,0,145,1355,1500
2017-08-08 16:00:00-04:00,0,8,16,1,0,148,1404,1552
2017-08-08 17:00:00-04:00,0,8,17,1,0,185,2991,3176
2017-08-08 18:00:00-04:00,0,8,18,1,0,396,7819,8215
2017-08-08 19:00:00-04:00,0,8,19,1,0,792,12023,12815
2017-08-08 20:00:00-04:00,0,8,20,1,0,1374,15831,17205
2017-08-08 21:00:00-04:00,0,8,21,1,0,1312,15209,16521
2017-08-08 22:00:00-04:00,0,8,22,1,0,1165,13511,14676
2017-08-08 23:00:00-04:00,0,8,23,1,0,1104,13490,14594
2017-08-09 00:00:00-04:00,0,8,0,2,0,1106,14050,15156
2017-08-09 01:00:00-04:00,0,8,1,2,0,1139,14263,15402
2017-08-09 02:00:00-04:00,0,8,2,2,0,1231,15152,16383
2017-08-09 03:00:00-04:00,0,8,3,2,0,1319,14385,15704
2017-08-09 04:00:00-04:00,0,8,4,2,0,1464,13528,14992
2017-08-09 05:00:00-04:00,0,8,5,2,0,1658,15980,17638
2017-08-09 06:00:00-04:00,0,8,6,2,0,1879,18858,20737
2017-08-09 07:00:00-04:00,0,8,7,2,0,1693,17630,19323
2017-08-09 08:00:00-04:00,0,8,8,2,0,1462,17400,18862
2017-08-09 09:00:00-04:00,0,8,9,2,0,1475,17854,19329
2017-08-09 10:00:00-04:00,0,8,10,2,0,1339,15602,16941
2017-08-09 11:00:00-04:00,0,8,11,2,0,1005,11224,12229
2017-08-09 12:00:00-04:00,0,8,12,2,0,791,7296,8087
2017-08-09 13:00:00-04:00,0,8,13,2,0,536,4219,4755
2017-08-09 14:00:00-04:00,0,8,14,2,0,293,2684,2977
2017-08-09 15:00:00-04:00,0,8,15,2,0,221,1804,2025
2017-08-09 16:00:00-04:00,0,8,16,2,0,219,1805,2024
2017-08-09 17:00:00-04:00,0,8,17,2,0,196,2948,3144
2017-08-09 18:00:00-04:00,0,8,18,2,0,408,7886,8294
2017-08-09 19:00:00-04:00,0,8,19,2,0,823,11894,12717
2017-08-09 20:00:00-04:00,0,8,20,2,0,1326,15369,16695
2017-08-09 21:00:00-04:00,0,8,21,2,0,1422,15001,16423
2017-08-09 22:00:00-04:00,0,8,22,2,0,1211,13762,14973
2017-08-09 23:00:00-04:00,0,8,23,2,0,1165,13838,15003
2017-08-10 00:00:00-04:00,0,8,0,3,0,1163,14604,15767
2017-08-10 01:00:00-04:00,0,8,1,3,0,1138,15136,16274
2017-08-10 02:00:00-04:00,0,8,2,3,0,1304,15405,16709
2017-08-10 03:00:00-04:00,0,8,3,3,0,1430,14706,16136
2017-08-10 04:00:00-04:00,0,8,4,3,0,1528,13855,15383
2017-08-10 05:00:00-04:00,0,8,5,3,0,1699,15872,17571
2017-08-10 06:00:00-04:00,0,8,6,3,0,1961,18882,20843
2017-08-10 07:00:00-04:00,0,8,7,3,0,1795,19177,20972
2017-08-10 08:00:00-04:00,0,8,8,3,0,1628,18354,19982
2017-08-10 09:00:00-04:00,0,8,9,3,0,1500,18418,19918
2017-08-10 10:00:00-04:00,0,8,10,3,0,1374,17098,18472
2017-08-10 11:00:00-04:00,0,8,11,3,0,1082,13045,14127
2017-08-10 12:00:00-04:00,0,8,12,3,0,891,8742,9633
2017-08-10 13:00:00-04:00,0,8,13,3,0,602,5147,5749
2017-08-10 14:00:00-04:00,0,8,14,3,0,419,3150,3569
2017-08-10 15:00:00-04:00,0,8,15,3,0,281,2066,2347
2017-08-10 16:00:00-04:00,0,8,16,3,0,206,1870,2076
2017-08-10 17:00:00-04:00,0,8,17,3,0,188,3034,3222
2017-08-10 18:00:00-04:00,0,8,18,3,0,439,7923,8362
2017-08-10 19:00:00-04:00,0,8,19,3,0,840,12387,13227
2017-08-10 20:00:00-04:00,0,8,20,3,0,1559,17287,18846
2017-08-10 21:00:00-04:00,0,8,21,3,0,1455,15605,17060
2017-08-10 22:00:00-04:00,0,8,22,3,0,1326,14082,15408
2017-08-10 23:00:00-04:00,0,8,23,3,0,1193,14249,15442
2017-08-11 00:00:00-04:00,0,8,0,4,0,1216,15004,16220
2017-08-11 01:00:00-04:00,0,8,1,4,0,1168,15377,16545
2017-08-11 02:00:00-04:00,0,8,2,4,0,1330,15902,17232
2017-08-11 03:00:00-04:00,0,8,3,4,0,1539,15034,16573
2017-08-11 04:00:00-04:00,0,8,4,4,0,1695,13652,15347
2017-08-11 05:00:00-04:00,0,8,5,4,0,1840,16129,17969
2017-08-11 06:00:00-04:00,0,8,6,4,0,2056,19125,21181
2017-08-11 07:00:00-04:00,0,8,7,4,0,1891,19218,21109
2017-08-11 08:00:00-04:00,0,8,8,4,0,1740,18649,20389
2017-08-11 09:00:00-04:00,0,8,9,4,0,1564,18887,20451
2017-08-11 10:00:00-04:00,0,8,10,4,0,1511,17909,19420
2017-08-11 11:00:00-04:00,0,8,11,4,0,1341,15710,17051
2017-08-11 12:00:00-04:00,0,8,12,4,0,1071,11603,12674
2017-08-11 13:00:00-04:00,0,8,13,4,0,729,7831,8560
2017-08-11 14:00:00-04:00,0,8,14,4,0,475,4901,5376
2017-08-11 15:00:00-04:00,0,8,15,4,0,394,3267,3661
2017-08-11 16:00:00-04:00,0,8,16,4,0,278,2665,2943
2017-08-11 17:00:00-04:00,0,8,17,4,0,232,3234,3466
2017-08-11 18:00:00-04:00,0,8,18,4,0,433,7607,8040
2017-08-11 19:00:00-04:00,0,8,19,4,0,818,10718,11536
2017-08-11 20:00:00-04:00,0.0001,8,20,4,0,1358,13957,15315
2017-08-11 21:00:00-04:00,0.0001,8,21,4,0,1386,13580,14966
2017-08-11 22:00:00-04:00,0.01,8,22,4,0,1261,12709,13970
2017-08-11 23:00:00-04:00,0,8,23,4,0,1241,13031,14272
2017-08-12 00:00:00-04:00,0,8,0,5,0,1217,14253,15470
2017-08-12 01:00:00-04:00,0.0001,8,1,5,0,1173,14153,15326
2017-08-12 02:00:00-04:00,0.14,8,2,5,0,1372,15141,16513
2017-08-12 03:00:00-04:00,0.02,8,3,5,0,1541,14247,15788
2017-08-12 04:00:00-04:00,0.0001,8,4,5,0,1747,13250,14997
2017-08-12 05:00:00-04:00,0.0001,8,5,5,0,2028,14959,16987
2017-08-12 06:00:00-04:00,0,8,6,5,0,2230,16742,18972
2017-08-12 07:00:00-04:00,0,8,7,5,0,2111,16721,18832
2017-08-12 08:00:00-04:00,0,8,8,5,0,2309,17815,20124
2017-08-12 09:00:00-04:00,0,8,9,5,0,1993,14959,16952
2017-08-12 10:00:00-04:00,0,8,10,5,0,1916,15107,17023
2017-08-12 11:00:00-04:00,0,8,11,5,0,1957,14652,16609
2017-08-12 12:00:00-04:00,0,8,12,5,0,1942,13912,15854
2017-08-12 13:00:00-04:00,0,8,13,5,0,1823,12744,14567
2017-08-12 14:00:00-04:00,0,8,14,5,0,1477,10655,12132
2017-08-12 15:00:00-04:00,0,8,15,5,0,1079,6845,7924
2017-08-12 16:00:00-04:00,0,8,16,5,0,811,4528,5339
2017-08-12 17:00:00-04:00,0,8,17,5,0,425,2483,2908
2017-08-12 18:00:00-04:00,0,8,18,5,0,344,3531,3875
2017-08-12 19:00:00-04:00,0,8,19,5,0,467,4556,5023
2017-08-12 20:00:00-04:00,0,8,20,5,0,677,6435,7112
2017-08-12 21:00:00-04:00,0,8,21,5,0,936,8486,9422
2017-08-12 22:00:00-04:00,0,8,22,5,0,1060,10386,11446
2017-08-12 23:00:00-04:00,0,8,23,5,0,1214,11189,12403
2017-08-13 00:00:00-04:00,0,8,0,6,0,1332,12070,13402
2017-08-13 01:00:00-04:00,0,8,1,6,0,1382,12959,14341
2017-08-13 02:00:00-04:00,0,8,2,6,0,1523,12469,13992
2017-08-13 03:00:00-04:00,0,8,3,6,0,1649,12982,14631
2017-08-13 04:00:00-04:00,0,8,4,6,0,1725,12990,14715
2017-08-13 05:00:00-04:00,0,8,5,6,0,1894,14003,15897
2017-08-13 06:00:00-04:00,0,8,6,6,0,2063,14269,16332
2017-08-13 07:00:00-04:00,0,8,7,6,0,2123,15046,17169
2017-08-13 08:00:00-04:00,0,8,8,6,0,2109,12458,14567
2017-08-13 09:00:00-04:00,0,8,9,6,0,2070,12636,14706
2017-08-13 10:00:00-04:00,0,8,10,6,0,1956,13210,15166
2017-08-13 11:00:00-04:00,0,8,11,6,0,2005,13791,15796
2017-08-13 12:00:00-04:00,0,8,12,6,0,1974,12537,14511
2017-08-13 13:00:00-04:00,0,8,13,6,0,1719,11364,13083
2017-08-13 14:00:00-04:00,0,8,14,6,0,1499,9638,11137
2017-08-13 15:00:00-04:00,0,8,15,6,0,1191,7154,8345
2017-08-13 16:00:00-04:00,0,8,16,6,0,900,4697,5597
2017-08-13 17:00:00-04:00,0,8,17,6,0,442,2374,2816
2017-08-13 18:00:00-04:00,0,8,18,6,0,372,3052,3424
2017-08-13 19:00:00-04:00,0,8,19,6,0,371,3622,3993
2017-08-13 20:00:00-04:00,0,8,20,6,0,530,4926,5456
2017-08-13 21:00:00-04:00,0,8,21,6,0,805,7144,7949
2017-08-13 22:00:00-04:00,0,8,22,6,0,985,9537,10522
2017-08-13 23:00:00-04:00,0,8,23,6,0,1071,10880,11951
2017-08-14 00:00:00-04:00,0,8,0,0,0,1202,11702,12904
2017-08-14 01:00:00-04:00,0,8,1,0,0,1204,11801,13005
2017-08-14 02:00:00-04:00,0,8,2,0,0,1404,12487,13891
2017-08-14 03:00:00-04:00,0,8,3,0,0,1524,12393,13917
2017-08-14 04:00:00-04:00,0,8,4,0,0,1560,12131,13691
2017-08-14 05:00:00-04:00,0,8,5,0,0,1569,12697,14266
2017-08-14 06:00:00-04:00,0,8,6,0,0,1726,13278,15004
2017-08-14 07:00:00-04:00,0,8,7,0,0,1605,12389,13994
2017-08-14 08:00:00-04:00,0,8,8,0,0,1505,12364,13869
2017-08-14 09:00:00-04:00,0,8,9,0,0,1445,11313,12758
2017-08-14 10:00:00-04:00,0,8,10,0,0,1353,10281,11634
2017-08-14 11:00:00-04:00,0,8,11,0,0,1111,8100,9211
2017-08-14 12:00:00-04:00,0,8,12,0,0,784,4854,5638
2017-08-14 13:00:00-04:00,0,8,13,0,0,524,2847,3371
2017-08-14 14:00:00-04:00,0,8,14,0,0,349,1658,2007
2017-08-14 15:00:00-04:00,0,8,15,0,0,284,1318,1602
2017-08-14 16:00:00-04:00,0,8,16,0,0,238,1558,1796
2017-08-14 17:00:00-04:00,0,8,17,0,0,258,2924,3182
2017-08-14 18:00:00-04:00,0,8,18,0,0,387,7514,7901
2017-08-14 19:00:00-04:00,0,8,19,0,0,769,10826,11595
2017-08-14 20:00:00-04:00,0,8,20,0,0,1306,13773,15079
2017-08-14 21:00:00-04:00,0,8,21,0,0,1349,13259,14608
2017-08-14 22:00:00-04:00,0,8,22,0,0,1111,11960,13071
2017-08-14 23:00:00-04:00,0,8,23,0,0,1025,11798,12823
2017-08-15 00:00:00-04:00,0.0001,8,0,1,0,1078,12389,13467
2017-08-15 01:00:00-04:00,0.0001,8,1,1,0,1001,12652,13653
2017-08-15 02:00:00-04:00,0.02,8,2,1,0,1178,13582,14760
2017-08-15 03:00:00-04:00,0.26,8,3,1,0,1273,13165,14438
2017-08-15 04:00:00-04:00,0.03,8,4,1,0,1390,12750,14140
2017-08-15 05:00:00-04:00,0.01,8,5,1,0,1509,14754,16263
2017-08-15 06:00:00-04:00,0.0001,8,6,1,0,1701,16371,18072
2017-08-15 07:00:00-04:00,0,8,7,1,0,1518,15097,16615
2017-08-15 08:00:00-04:00,0,8,8,1,0,1286,14103,15389
2017-08-15 09:00:00-04:00,0,8,9,1,0,1066,13298,14364
2017-08-15 10:00:00-04:00,0,8,10,1,0,955,11632,12587
2017-08-15 11:00:00-04:00,0.0001,8,11,1,0,785,7818,8603
2017-08-15 12:00:00-04:00,0.0001,8,12,1,0,611,5168,5779
2017-08-15 13:00:00-04:00,0.01,8,13,1,0,428,3040,3468
2017-08-15 14:00:00-04:00,0.07,8,14,1,0,303,2100,2403
2017-08-15 15:00:00-04:00,0.04,8,15,1,0,186,1409,1595
2017-08-15 16:00:00-04:00,0.0001,8,16,1,0,181,1425,1606
2017-08-15 17:00:00-04:00,0,8,17,1,0,174,2920,3094
2017-08-15 18:00:00-04:00,0.0001,8,18,1,0,384,7658,8042
2017-08-15 19:00:00-04:00,0.0001,8,19,1,0,763,11753,12516
2017-08-15 20:00:00-04:00,0,8,20,1,0,1325,14448,15773
2017-08-15 21:00:00-04:00,0,8,21,1,0,1279,14282,15561
2017-08-15 22:00:00-04:00,0,8,22,1,0,1139,13120,14259
2017-08-15 23:00:00-04:00,0,8,23,1,0,1136,13734,14870
2017-08-16 00:00:00-04:00,0,8,0,2,0,1272,15643,16915
2017-08-16 01:00:00-04:00,0,8,1,2,0,1190,15951,17141
2017-08-16 02:00:00-04:00,0,8,2,2,0,1363,17402,18765
2017-08-16 03:00:00-04:00,0,8,3,2,0,1404,13769,15173
2017-08-16 04:00:00-04:00,0,8,4,2,0,1555,12257,13812
2017-08-16 05:00:00-04:00,0,8,5,2,0,1566,14872,16438
2017-08-16 06:00:00-04:00,0,8,6,2,0,1909,18020,19929
2017-08-16 07:00:00-04:00,0,8,7,2,0,1616,16576,18192
2017-08-16 08:00:00-04:00,0,8,8,2,0,1325,16491,17816
2017-08-16 09:00:00-04:00,0,8,9,2,0,1343,16881,18224
2017-08-16 10:00:00-04:00,0,8,10,2,0,1198,14853,16051
2017-08-16 11:00:00-04:00,0,8,11,2,0,929,10735,11664
2017-08-16 12:00:00-04:00,0,8,12,2,0,736,6530,7266
2017-08-16 13:00:00-04:00,0,8,13,2,0,478,3872,4350
2017-08-16 14:00:00-04:00,0,8,14,2,0,283,2466,2749
2017-08-16 15:00:00-04:00,0,8,15,2,0,208,1757,1965
2017-08-16 16:00:00-04:00,0,8,16,2,0,202,1741,1943
2017-08-16 17:00:00-04:00,0,8,17,2,0,186,2882,3068
2017-08-16 18:00:00-04:00,0,8,18,2,0,362,7787,8149
2017-08-16 19:00:00-04:00,0,8,19,2,0,728,11943,12671
2017-08-16 20:00:00-04:00,0,8,20,2,0,1366,15939,17305
2017-08-16 21:00:00-04:00,0,8,21,2,0,1476,15500,16976
2017-08-16 22:00:00-04:00,0,8,22,2,0,1202,13297,14499
2017-08-16 23:00:00-04:00,0,8,23,2,0,1294,13480,14774
2017-08-17 00:00:00-04:00,0,8,0,3,0,1227,14350,15577
2017-08-17 01:00:00-04:00,0,8,1,3,0,1134,14419,15553
2017-08-17 02:00:00-04:00,0,8,2,3,0,1222,14399,15621
2017-08-17 03:00:00-04:00,0,8,3,3,0,1402,14457,15859
2017-08-17 04:00:00-04:00,0,8,4,3,0,1513,13498,15011
2017-08-17 05:00:00-04:00,0,8,5,3,0,1705,15886,17591
2017-08-17 06:00:00-04:00,0,8,6,3,0,1974,18812,20786
2017-08-17 07:00:00-04:00,0,8,7,3,0,1802,18139,19941
2017-08-17 08:00:00-04:00,0,8,8,3,0,1617,17750,19367
2017-08-17 09:00:00-04:00,0,8,9,3,0,1541,17661,19202
2017-08-17 10:00:00-04:00,0,8,10,3,0,1396,16174,17570
2017-08-17 11:00:00-04:00,0,8,11,3,0,1176,12381,13557
2017-08-17 12:00:00-04:00,0,8,12,3,0,859,7987,8846
2017-08-17 13:00:00-04:00,0,8,13,3,0,609,4705,5314
2017-08-17 14:00:00-04:00,0,8,14,3,0,392,2919,3311
2017-08-17 15:00:00-04:00,0,8,15,3,0,251,2015,2266
2017-08-17 16:00:00-04:00,0,8,16,3,0,246,1924,2170
2017-08-17 17:00:00-04:00,0,8,17,3,0,212,3101,3313
2017-08-17 18:00:00-04:00,0,8,18,3,0,384,7620,8004
2017-08-17 19:00:00-04:00,0,8,19,3,0,829,11887,12716
2017-08-17 20:00:00-04:00,0,8,20,3,0,1392,15225,16617
2017-08-17 21:00:00-04:00,0,8,21,3,0,1383,14496,15879
2017-08-17 22:00:00-04:00,0,8,22,3,0,1238,13473,14711
2017-08-17 23:00:00-04:00,0,8,23,3,0,1132,13647,14779
2017-08-18 00:00:00-04:00,0,8,0,4,0,1140,14491,15631
2017-08-18 01:00:00-04:00,0,8,1,4,0,1135,14687,15822
2017-08-18 02:00:00-04:00,0,8,2,4,0,1314,15316,16630
2017-08-18 03:00:00-04:00,0,8,3,4,0,1432,14664,16096
2017-08-18 04:00:00-04:00,0,8,4,4,0,1520,13732,15252
2017-08-18 05:00:00-04:00,0,8,5,4,0,1740,14677,16417
2017-08-18 06:00:00-04:00,0,8,6,4,0,1928,17449,19377
2017-08-18 07:00:00-04:00,0.01,8,7,4,0,1855,18736,20591
2017-08-18 08:00:00-04:00,0.28,8,8,4,0,1733,18324,20057
2017-08-18 09:00:00-04:00,0.56,8,9,4,0,1650,18036,19686
2017-08-18 10:00:00-04:00,0.02,8,10,4,0,1569,17299,18868
2017-08-18 11:00:00-04:00,0,8,11,4,0,1278,14666,15944
2017-08-18 12:00:00-04:00,0,8,12,4,0,1066,11053,12119
2017-08-18 13:00:00-04:00,0.0001,8,13,4,0,742,6965,7707
2017-08-18 14:00:00-04:00,0.0001,8,14,4,0,477,4641,5118
2017-08-18 15:00:00-04:00,0.0001,8,15,4,0,329,2998,3327
2017-08-18 16:00:00-04:00,0,8,16,4,0,300,2593,2893
2017-08-18 17:00:00-04:00,0,8,17,4,0,235,3035,3270
2017-08-18 18:00:00-04:00,0.0001,8,18,4,0,410,7685,8095
2017-08-18 19:00:00-04:00,0.03,8,19,4,0,910,12405,13315
2017-08-18 20:00:00-04:00,0.01,8,20,4,0,1601,17059,18660
2017-08-18 21:00:00-04:00,0.0001,8,21,4,0,1492,14261,15753
2017-08-18 22:00:00-04:00,0.0001,8,22,4,0,1237,12818,14055
2017-08-18 23:00:00-04:00,0.0001,8,23,4,0,1120,12821,13941
2017-08-19 00:00:00-04:00,0.0001,8,0,5,0,1119,13314,14433
2017-08-19 01:00:00-04:00,0.0001,8,1,5,0,1055,14468,15523
2017-08-19 02:00:00-04:00,0.0001,8,2,5,0,1325,14820,16145
2017-08-19 03:00:00-04:00,0,8,3,5,0,1638,14839,16477
2017-08-19 04:00:00-04:00,0,8,4,5,0,1794,14077,15871
2017-08-19 05:00:00-04:00,0,8,5,5,0,2106,15832,17938
2017-08-19 06:00:00-04:00,0,8,6,5,0,2475,18929,21404
2017-08-19 07:00:00-04:00,0,8,7,5,0,2510,20220,22730
2017-08-19 08:00:00-04:00,0,8,8,5,0,1694,13195,14889
2017-08-19 09:00:00-04:00,0,8,9,5,0,1671,12896,14567
2017-08-19 10:00:00-04:00,0,8,10,5,0,1644,13336,14980
2017-08-19 11:00:00-04:00,0,8,11,5,0,1679,13486,15165
2017-08-19 12:00:00-04:00,0,8,12,5,0,1612,12307,13919
2017-08-19 13:00:00-04:00,0,8,13,5,0,1492,10941,12433
2017-08-19 14:00:00-04:00,0,8,14,5,0,1247,9095,10342
2017-08-19 15:00:00-04:00,0,8,15,5,0,969,6392,7361
2017-08-19 16:00:00-04:00,0,8,16,5,0,797,4208,5005
2017-08-19 17:00:00-04:00,0,8,17,5,0,414,2371,2785
2017-08-19 18:00:00-04:00,0,8,18,5,0,398,3649,4047
2017-08-19 19:00:00-04:00,0,8,19,5,0,515,5022,5537
2017-08-19 20:00:00-04:00,0,8,20,5,0,723,6988,7711
2017-08-19 21:00:00-04:00,0,8,21,5,0,994,9297,10291
2017-08-19 22:00:00-04:00,0,8,22,5,0,1190,11280,12470
2017-08-19 23:00:00-04:00,0,8,23,5,0,1356,11982,13338
2017-08-20 00:00:00-04:00,0,8,0,6,0,1490,12967,14457
2017-08-20 01:00:00-04:00,0,8,1,6,0,1495,13854,15349
2017-08-20 02:00:00-04:00,0,8,2,6,0,1662,13325,14987
2017-08-20 03:00:00-04:00,0,8,3,6,0,1802,13963,15765
2017-08-20 04:00:00-04:00,0,8,4,6,0,1831,13840,15671
2017-08-20 05:00:00-04:00,0,8,5,6,0,1884,14781,16665
2017-08-20 06:00:00-04:00,0,8,6,6,0,2172,15648,17820
2017-08-20 07:00:00-04:00,0,8,7,6,0,2122,15676,17798
2017-08-20 08:00:00-04:00,0,8,8,6,0,2094,13840,15934
2017-08-20 09:00:00-04:00,0,8,9,6,0,2103,13378,15481
2017-08-20 10:00:00-04:00,0,8,10,6,0,2211,14196,16407
2017-08-20 11:00:00-04:00,0,8,11,6,0,2105,14458,16563
2017-08-20 12:00:00-04:00,0,8,12,6,0,1983,13234,15217
2017-08-20 13:00:00-04:00,0,8,13,6,0,1718,11596,13314
2017-08-20 14:00:00-04:00,0,8,14,6,0,1461,9732,11193
2017-08-20 15:00:00-04:00,0,8,15,6,0,1234,7670,8904
2017-08-20 16:00:00-04:00,0,8,16,6,0,899,5012,5911
2017-08-20 17:00:00-04:00,0,8,17,6,0,463,2445,2908
2017-08-20 18:00:00-04:00,0,8,18,6,0,353,2774,3127
2017-08-20 19:00:00-04:00,0,8,19,6,0,408,4219,4627
2017-08-20 20:00:00-04:00,0,8,20,6,0,537,5957,6494
2017-08-20 21:00:00-04:00,0,8,21,6,0,753,7850,8603
2017-08-20 22:00:00-04:00,0,8,22,6,0,1022,10488,11510
2017-08-20 23:00:00-04:00,0,8,23,6,0,1117,11419,12536
2017-08-21 00:00:00-04:00,0,8,0,0,0,1249,12146,13395
2017-08-21 01:00:00-04:00,0,8,1,0,0,1177,12313,13490
2017-08-21 02:00:00-04:00,0,8,2,0,0,1401,13049,14450
2017-08-21 03:00:00-04:00,0,8,3,0,0,1484,12896,14380
2017-08-21 04:00:00-04:00,0,8,4,0,0,1637,12930,14567
2017-08-21 05:00:00-04:00,0,8,5,0,0,1600,13562,15162
2017-08-21 06:00:00-04:00,0,8,6,0,0,1703,14108,15811
2017-08-21 07:00:00-04:00,0,8,7,0,0,1622,13077,14699
2017-08-21 08:00:00-04:00,0,8,8,0,0,1580,12743,14323
2017-08-21 09:00:00-04:00,0,8,9,0,0,1422,12067,13489
2017-08-21 10:00:00-04:00,0,8,10,0,0,1289,10449,11738
2017-08-21 11:00:00-04:00,0,8,11,0,0,1157,8390,9547
2017-08-21 12:00:00-04:00,0,8,12,0,0,793,4929,5722
2017-08-21 13:00:00-04:00,0,8,13,0,0,507,2780,3287
2017-08-21 14:00:00-04:00,0,8,14,0,0,324,1795,2119
2017-08-21 15:00:00-04:00,0,8,15,0,0,241,1305,1546
2017-08-21 16:00:00-04:00,0,8,16,0,0,251,1621,1872
2017-08-21 17:00:00-04:00,0,8,17,0,0,197,2845,3042
2017-08-21 18:00:00-04:00,0,8,18,0,0,388,7206,7594
2017-08-21 19:00:00-04:00,0,8,19,0,0,753,10584,11337
2017-08-21 20:00:00-04:00,0,8,20,0,0,1314,14148,15462
2017-08-21 21:00:00-04:00,0,8,21,0,0,1267,13850,15117
2017-08-21 22:00:00-04:00,0,8,22,0,0,1107,12360,13467
2017-08-21 23:00:00-04:00,0,8,23,0,0,1090,12404,13494
2017-08-22 00:00:00-04:00,0,8,0,1,0,1128,13332,14460
2017-08-22 01:00:00-04:00,0,8,1,1,0,1071,13896,14967
2017-08-22 02:00:00-04:00,0,8,2,1,0,1131,13877,15008
2017-08-22 03:00:00-04:00,0,8,3,1,0,1194,13584,14778
2017-08-22 04:00:00-04:00,0,8,4,1,0,1331,13020,14351
2017-08-22 05:00:00-04:00,0,8,5,1,0,1435,14834,16269
2017-08-22 06:00:00-04:00,0,8,6,1,0,1604,16839,18443
2017-08-22 07:00:00-04:00,0,8,7,1,0,1423,15744,17167
2017-08-22 08:00:00-04:00,0,8,8,1,0,1251,14665,15916
2017-08-22 09:00:00-04:00,0,8,9,1,0,1086,13528,14614
2017-08-22 10:00:00-04:00,0,8,10,1,0,937,11981,12918
2017-08-22 11:00:00-04:00,0,8,11,1,0,860,8779,9639
2017-08-22 12:00:00-04:00,0,8,12,1,0,586,5567,6153
2017-08-22 13:00:00-04:00,0,8,13,1,0,375,3196,3571
2017-08-22 14:00:00-04:00,0,8,14,1,0,249,1888,2137
2017-08-22 15:00:00-04:00,0,8,15,1,0,163,1282,1445
2017-08-22 16:00:00-04:00,0,8,16,1,0,139,1411,1550
2017-08-22 17:00:00-04:00,0,8,17,1,0,166,2653,2819
2017-08-22 18:00:00-04:00,0,8,18,1,0,393,7178,7571
2017-08-22 19:00:00-04:00,0,8,19,1,0,781,11365,12146
2017-08-22 20:00:00-04:00,0,8,20,1,0,1269,15355,16624
2017-08-22 21:00:00-04:00,0,8,21,1,0,1300,15055,16355
2017-08-22 22:00:00-04:00,0,8,22,1,0,1214,13669,14883
2017-08-22 23:00:00-04:00,0.07,8,23,1,0,1059,13931,14990
2017-08-23 00:00:00-04:00,0.14,8,0,2,0,1085,14990,16075
2017-08-23 01:00:00-04:00,0.04,8,1,2,0,1112,15273,16385
2017-08-23 02:00:00-04:00,0,8,2,2,0,1169,15930,17099
2017-08-23 03:00:00-04:00,0,8,3,2,0,1348,15269,16617
2017-08-23 04:00:00-04:00,0.0001,8,4,2,0,1549,14242,15791
2017-08-23 05:00:00-04:00,0,8,5,2,0,1614,15860,17474
2017-08-23 06:00:00-04:00,0,8,6,2,0,1837,19053,20890
2017-08-23 07:00:00-04:00,0,8,7,2,0,1726,17978,19704
2017-08-23 08:00:00-04:00,0,8,8,2,0,1472,17383,18855
2017-08-23 09:00:00-04:00,0,8,9,2,0,1311,16462,17773
2017-08-23 10:00:00-04:00,0,8,10,2,0,1302,16643,17945
2017-08-23 11:00:00-04:00,0,8,11,2,0,1289,12723,14012
2017-08-23 12:00:00-04:00,0,8,12,2,0,892,7853,8745
2017-08-23 13:00:00-04:00,0,8,13,2,0,387,4021,4408
2017-08-23 14:00:00-04:00,0,8,14,2,0,260,2605,2865
2017-08-23 15:00:00-04:00,0,8,15,2,0,191,1597,1788
2017-08-23 16:00:00-04:00,0,8,16,2,0,196,1574,1770
2017-08-23 17:00:00-04:00,0,8,17,2,0,180,2801,2981
2017-08-23 18:00:00-04:00,0,8,18,2,0,409,7526,7935
2017-08-23 19:00:00-04:00,0,8,19,2,0,796,12059,12855
2017-08-23 20:00:00-04:00,0,8,20,2,0,1411,16261,17672
2017-08-23 21:00:00-04:00,0,8,21,2,0,1636,15702,17338
2017-08-23 22:00:00-04:00,0,8,22,2,0,1218,13807,15025
2017-08-23 23:00:00-04:00,0,8,23,2,0,1235,13778,15013
2017-08-24 00:00:00-04:00,0,8,0,3,0,1170,14663,15833
2017-08-24 01:00:00-04:00,0,8,1,3,0,1021,14837,15858
2017-08-24 02:00:00-04:00,0,8,2,3,0,1200,15143,16343
2017-08-24 03:00:00-04:00,0,8,3,3,0,1285,14589,15874
2017-08-24 04:00:00-04:00,0,8,4,3,0,1436,13599,15035
2017-08-24 05:00:00-04:00,0,8,5,3,0,1719,15420,17139
2017-08-24 06:00:00-04:00,0,8,6,3,0,1895,18309,20204
2017-08-24 07:00:00-04:00,0,8,7,3,0,1940,18013,19953
2017-08-24 08:00:00-04:00,0,8,8,3,0,1574,17308,18882
2017-08-24 09:00:00-04:00,0,8,9,3,0,1514,16927,18441
2017-08-24 10:00:00-04:00,0,8,10,3,0,1339,15455,16794
2017-08-24 11:00:00-04:00,0,8,11,3,0,1053,11649,12702
2017-08-24 12:00:00-04:00,0,8,12,3,0,830,8482,9312
2017-08-24 13:00:00-04:00,0,8,13,3,0,546,4769,5315
2017-08-24 14:00:00-04:00,0,8,14,3,0,324,3013,3337
2017-08-24 15:00:00-04:00,0,8,15,3,0,246,1996,2242
2017-08-24 16:00:00-04:00,0,8,16,3,0,216,1892,2108
2017-08-24 17:00:00-04:00,0,8,17,3,0,194,2895,3089
2017-08-24 18:00:00-04:00,0,8,18,3,0,380,7225,7605
2017-08-24 19:00:00-04:00,0,8,19,3,0,826,11327,12153
2017-08-24 20:00:00-04:00,0,8,20,3,0,1245,14190,15435
2017-08-24 21:00:00-04:00,0,8,21,3,0,1343,14059,15402
2017-08-24 22:00:00-04:00,0,8,22,3,0,1219,13302,14521
2017-08-24 23:00:00-04:00,0,8,23,3,0,1109,13036,14145
2017-08-25 00:00:00-04:00,0,8,0,4,0,1150,14021,15171
2017-08-25 01:00:00-04:00,0,8,1,4,0,1129,14105,15234
2017-08-25 02:00:00-04:00,0,8,2,4,0,1299,14953,16252
2017-08-25 03:00:00-04:00,0,8,3,4,0,1478,14308,15786
2017-08-25 04:00:00-04:00,0,8,4,4,0,1642,13204,14846
2017-08-25 05:00:00-04:00,0,8,5,4,0,1834,15140,16974
2017-08-25 06:00:00-04:00,0,8,6,4,0,2052,17845,19897
2017-08-25 07:00:00-04:00,0,8,7,4,0,1918,17829,19747
2017-08-25 08:00:00-04:00,0,8,8,4,0,1701,17641,19342
2017-08-25 09:00:00-04:00,0,8,9,4,0,1515,17264,18779
2017-08-25 10:00:00-04:00,0,8,10,4,0,1411,16384,17795
2017-08-25 11:00:00-04:00,0,8,11,4,0,1237,14099,15336
2017-08-25 12:00:00-04:00,0,8,12,4,0,1011,10995,12006
2017-08-25 13:00:00-04:00,0,8,13,4,0,784,6921,7705
2017-08-25 14:00:00-04:00,0,8,14,4,0,583,4610,5193
2017-08-25 15:00:00-04:00,0,8,15,4,0,356,3047,3403
2017-08-25 16:00:00-04:00,0,8,16,4,0,280,2542,2822
2017-08-25 17:00:00-04:00,0,8,17,4,0,224,2984,3208
2017-08-25 18:00:00-04:00,0,8,18,4,0,409,7179,7588
2017-08-25 19:00:00-04:00,0,8,19,4,0,820,10189,11009
2017-08-25 20:00:00-04:00,0,8,20,4,0,1313,12943,14256
2017-08-25 21:00:00-04:00,0,8,21,4,0,1361,12892,14253
2017-08-25 22:00:00-04:00,0,8,22,4,0,1168,11858,13026
2017-08-25 23:00:00-04:00,0,8,23,4,0,1235,13013,14248
2017-08-26 00:00:00-04:00,0,8,0,5,0,1113,13413,14526
2017-08-26 01:00:00-04:00,0,8,1,5,0,1099,13556,14655
2017-08-26 02:00:00-04:00,0,8,2,5,0,1286,14138,15424
2017-08-26 03:00:00-04:00,0,8,3,5,0,1513,14008,15521
2017-08-26 04:00:00-04:00,0,8,4,5,0,1761,13233,14994
2017-08-26 05:00:00-04:00,0,8,5,5,0,1939,14828,16767
2017-08-26 06:00:00-04:00,0,8,6,5,0,2130,15788,17918
2017-08-26 07:00:00-04:00,0,8,7,5,0,1949,15953,17902
2017-08-26 08:00:00-04:00,0,8,8,5,0,1871,14644,16515
2017-08-26 09:00:00-04:00,0,8,9,5,0,1903,13943,15846
2017-08-26 10:00:00-04:00,0,8,10,5,0,1833,14680,16513
2017-08-26 11:00:00-04:00,0,8,11,5,0,1892,14092,15984
2017-08-26 12:00:00-04:00,0,8,12,5,0,1788,12381,14169
2017-08-26 13:00:00-04:00,0,8,13,5,0,1613,11061,12674
2017-08-26 14:00:00-04:00,0,8,14,5,0,1304,9241,10545
2017-08-26 15:00:00-04:00,0,8,15,5,0,1041,6821,7862
2017-08-26 16:00:00-04:00,0,8,16,5,0,794,4384,5178
2017-08-26 17:00:00-04:00,0,8,17,5,0,368,2320,2688
2017-08-26 18:00:00-04:00,0,8,18,5,0,349,3375,3724
2017-08-26 19:00:00-04:00,0,8,19,5,0,524,4805,5329
2017-08-26 20:00:00-04:00,0,8,20,5,0,692,6281,6973
2017-08-26 21:00:00-04:00,0,8,21,5,0,964,8539,9503
2017-08-26 22:00:00-04:00,0,8,22,5,0,1080,10174,11254
2017-08-26 23:00:00-04:00,0,8,23,5,0,1187,11068,12255
2017-08-27 00:00:00-04:00,0,8,0,6,0,1300,12148,13448
2017-08-27 01:00:00-04:00,0,8,1,6,0,1352,12222,13574
2017-08-27 02:00:00-04:00,0,8,2,6,0,1629,12211,13840
2017-08-27 03:00:00-04:00,0,8,3,6,0,1685,12593,14278
2017-08-27 04:00:00-04:00,0,8,4,6,0,1803,12662,14465
2017-08-27 05:00:00-04:00,0,8,5,6,0,1901,13678,15579
2017-08-27 06:00:00-04:00,0,8,6,6,0,2113,14526,16639
2017-08-27 07:00:00-04:00,0,8,7,6,0,2188,14927,17115
2017-08-27 08:00:00-04:00,0,8,8,6,0,2261,14047,16308
2017-08-27 09:00:00-04:00,0,8,9,6,0,2173,13444,15617
2017-08-27 10:00:00-04:00,0,8,10,6,0,2287,13804,16091
2017-08-27 11:00:00-04:00,0,8,11,6,0,2132,12779,14911
2017-08-27 12:00:00-04:00,0,8,12,6,0,1645,10279,11924
2017-08-27 13:00:00-04:00,0,8,13,6,0,2360,17540,19900
2017-08-27 14:00:00-04:00,0,8,14,6,0,1712,10889,12601
2017-08-27 15:00:00-04:00,0,8,15,6,0,1420,8290,9710
2017-08-27 16:00:00-04:00,0,8,16,6,0,1052,5293,6345
2017-08-27 17:00:00-04:00,0,8,17,6,0,460,2368,2828
2017-08-27 18:00:00-04:00,0,8,18,6,0,327,2931,3258
2017-08-27 19:00:00-04:00,0,8,19,6,0,336,3732,4068
2017-08-27 20:00:00-04:00,0,8,20,6,0,422,4828,5250
2017-08-27 21:00:00-04:00,0,8,21,6,0,716,7135,7851
2017-08-27 22:00:00-04:00,0,8,22,6,0,868,9475,10343
2017-08-27 23:00:00-04:00,0,8,23,6,0,1056,10695,11751
2017-08-28 00:00:00-04:00,0,8,0,0,0,1166,11461,12627
2017-08-28 01:00:00-04:00,0,8,1,0,0,1142,12010,13152
2017-08-28 02:00:00-04:00,0,8,2,0,0,1414,12815,14229
2017-08-28 03:00:00-04:00,0,8,3,0,0,1471,12437,13908
2017-08-28 04:00:00-04:00,0,8,4,0,0,1557,12933,14490
2017-08-28 05:00:00-04:00,0,8,5,0,0,1568,13338,14906
2017-08-28 06:00:00-04:00,0,8,6,0,0,1651,13815,15466
2017-08-28 07:00:00-04:00,0,8,7,0,0,1550,12760,14310
2017-08-28 08:00:00-04:00,0,8,8,0,0,1566,12586,14152
2017-08-28 09:00:00-04:00,0,8,9,0,0,1324,10681,12005
2017-08-28 10:00:00-04:00,0,8,10,0,0,1275,9694,10969
2017-08-28 11:00:00-04:00,0,8,11,0,0,1046,7518,8564
2017-08-28 12:00:00-04:00,0,8,12,0,0,746,4471,5217
2017-08-28 13:00:00-04:00,0,8,13,0,0,451,2577,3028
2017-08-28 14:00:00-04:00,0,8,14,0,0,301,1687,1988
2017-08-28 15:00:00-04:00,0,8,15,0,0,220,1192,1412
2017-08-28 16:00:00-04:00,0,8,16,0,0,231,1393,1624
2017-08-28 17:00:00-04:00,0,8,17,0,0,181,2537,2718
2017-08-28 18:00:00-04:00,0,8,18,0,0,404,6912,7316
2017-08-28 19:00:00-04:00,0,8,19,0,0,826,10333,11159
2017-08-28 20:00:00-04:00,0,8,20,0,0,1278,12979,14257
2017-08-28 21:00:00-04:00,0,8,21,0,0,1283,12791,14074
2017-08-28 22:00:00-04:00,0,8,22,0,0,1128,11541,12669
2017-08-28 23:00:00-04:00,0,8,23,0,0,869,10253,11122
2017-08-29 00:00:00-04:00,0,8,0,1,0,991,11559,12550
2017-08-29 01:00:00-04:00,0,8,1,1,0,1067,12375,13442
2017-08-29 02:00:00-04:00,0,8,2,1,0,1148,12725,13873
2017-08-29 03:00:00-04:00,0,8,3,1,0,1270,12884,14154
2017-08-29 04:00:00-04:00,0,8,4,1,0,1387,12281,13668
2017-08-29 05:00:00-04:00,0,8,5,1,0,1526,14187,15713
2017-08-29 06:00:00-04:00,0,8,6,1,0,1742,15651,17393
2017-08-29 07:00:00-04:00,0,8,7,1,0,1619,15299,16918
2017-08-29 08:00:00-04:00,0,8,8,1,0,1397,14164,15561
2017-08-29 09:00:00-04:00,0,8,9,1,0,1091,12884,13975
2017-08-29 10:00:00-04:00,0.0001,8,10,1,0,1070,10847,11917
2017-08-29 11:00:00-04:00,0,8,11,1,0,887,7619,8506
2017-08-29 12:00:00-04:00,0.0001,8,12,1,0,672,5776,6448
2017-08-29 13:00:00-04:00,0.01,8,13,1,0,471,3498,3969
2017-08-29 14:00:00-04:00,0.02,8,14,1,0,244,1946,2190
2017-08-29 15:00:00-04:00,0.03,8,15,1,0,148,1340,1488
2017-08-29 16:00:00-04:00,0.05,8,16,1,0,167,1318,1485
2017-08-29 17:00:00-04:00,0.01,8,17,1,0,170,2510,2680
2017-08-29 18:00:00-04:00,0.0001,8,18,1,0,384,6761,7145
2017-08-29 19:00:00-04:00,0.0001,8,19,1,0,820,10879,11699
2017-08-29 20:00:00-04:00,0.03,8,20,1,0,1332,14272,15604
2017-08-29 21:00:00-04:00,0.04,8,21,1,0,1350,13850,15200
2017-08-29 22:00:00-04:00,0.03,8,22,1,0,1172,12812,13984
2017-08-29 23:00:00-04:00,0.02,8,23,1,0,1088,13032,14120
2017-08-30 00:00:00-04:00,0.06,8,0,2,0,1170,14727,15897
2017-08-30 01:00:00-04:00,0.02,8,1,2,0,1171,16080,17251
2017-08-30 02:00:00-04:00,0,8,2,2,0,1360,16687,18047
2017-08-30 03:00:00-04:00,0,8,3,2,0,1588,16132,17720
2017-08-30 04:00:00-04:00,0,8,4,2,0,1732,15144,16876
2017-08-30 05:00:00-04:00,0,8,5,2,0,1898,16370,18268
2017-08-30 06:00:00-04:00,0,8,6,2,0,2134,18980,21114
2017-08-30 07:00:00-04:00,0,8,7,2,0,1921,17942,19863
2017-08-30 08:00:00-04:00,0,8,8,2,0,1744,17918,19662
2017-08-30 09:00:00-04:00,0,8,9,2,0,1447,16867,18314
2017-08-30 10:00:00-04:00,0,8,10,2,0,1215,13639,14854
2017-08-30 11:00:00-04:00,0,8,11,2,0,996,9787,10783
2017-08-30 12:00:00-04:00,0,8,12,2,0,762,7017,7779
2017-08-30 13:00:00-04:00,0,8,13,2,0,465,3736,4201
2017-08-30 14:00:00-04:00,0,8,14,2,0,200,2120,2320
2017-08-30 15:00:00-04:00,0,8,15,2,0,156,1463,1619
2017-08-30 16:00:00-04:00,0,8,16,2,0,150,1432,1582
2017-08-30 17:00:00-04:00,0,8,17,2,0,174,2605,2779
2017-08-30 18:00:00-04:00,0,8,18,2,0,397,7022,7419
2017-08-30 19:00:00-04:00,0,8,19,2,0,806,11065,11871
2017-08-30 20:00:00-04:00,0,8,20,2,0,1285,14034,15319
2017-08-30 21:00:00-04:00,0,8,21,2,0,1410,14302,15712
2017-08-30 22:00:00-04:00,0,8,22,2,0,1234,12888,14122
2017-08-30 23:00:00-04:00,0,8,23,2,0,1130,12959,14089
2017-08-31 00:00:00-04:00,0,8,0,3,0,1145,13601,14746
2017-08-31 01:00:00-04:00,0,8,1,3,0,1143,13522,14665
2017-08-31 02:00:00-04:00,0,8,2,3,0,1196,14442,15638
2017-08-31 03:00:00-04:00,0,8,3,3,0,1289,13912,15201
2017-08-31 04:00:00-04:00,0,8,4,3,0,1515,13174,14689
2017-08-31 05:00:00-04:00,0,8,5,3,0,1711,15103,16814
2017-08-31 06:00:00-04:00,0,8,6,3,0,1884,16974,18858
2017-08-31 07:00:00-04:00,0,8,7,3,0,1738,17103,18841
2017-08-31 08:00:00-04:00,0,8,8,3,0,1611,16613,18224
2017-08-31 09:00:00-04:00,0,8,9,3,0,1417,16245,17662
2017-08-31 10:00:00-04:00,0,8,10,3,0,1329,15087,16416
2017-08-31 11:00:00-04:00,0,8,11,3,0,1152,11481,12633
2017-08-31 12:00:00-04:00,0,8,12,3,0,870,7959,8829
2017-08-31 13:00:00-04:00,0,8,13,3,0,523,4762,5285
2017-08-31 14:00:00-04:00,0,8,14,3,0,351,2900,3251
2017-08-31 15:00:00-04:00,0,8,15,3,0,221,1920,2141
2017-08-31 16:00:00-04:00,0,8,16,3,0,192,1760,1952
2017-08-31 17:00:00-04:00,0,8,17,3,0,195,2694,2889
2017-08-31 18:00:00-04:00,0,8,18,3,0,391,7066,7457
2017-08-31 19:00:00-04:00,0,8,19,3,0,827,10794,11621
2017-08-31 20:00:00-04:00,0,8,20,3,0,1264,13782,15046
2017-08-31 21:00:00-04:00,0,8,21,3,0,1341,13554,14895
2017-08-31 22:00:00-04:00,0,8,22,3,0,1223,12614,13837
2017-08-31 23:00:00-04:00,0,8,23,3,0,1162,12739,13901
2017-09-01 00:00:00-04:00,0,9,0,4,0,1193,13687,14880
2017-09-01 01:00:00-04:00,0,9,1,4,0,1169,14232,15401
2017-09-01 02:00:00-04:00,0,9,2,4,0,1299,14703,16002
2017-09-01 03:00:00-04:00,0,9,3,4,0,1592,14867,16459
2017-09-01 04:00:00-04:00,0,9,4,4,0,1572,13251,14823
2017-09-01 05:00:00-04:00,0,9,5,4,0,1821,15130,16951
2017-09-01 06:00:00-04:00,0,9,6,4,0,2050,18025,20075
2017-09-01 07:00:00-04:00,0,9,7,4,0,1923,17129,19052
2017-09-01 08:00:00-04:00,0,9,8,4,0,1624,16283,17907
2017-09-01 09:00:00-04:00,0,9,9,4,0,1495,15719,17214
2017-09-01 10:00:00-04:00,0,9,10,4,0,1531,14656,16187
2017-09-01 11:00:00-04:00,0,9,11,4,0,1349,12925,14274
2017-09-01 12:00:00-04:00,0,9,12,4,0,1060,76,1136
2017-09-01 13:00:00-04:00,0,9,13,4,0,728,126,854
2017-09-01 14:00:00-04:00,0,9,14,4,0,471,10347,10818
2017-09-01 15:00:00-04:00,0,9,15,4,0,324,7251,7575
2017-09-01 16:00:00-04:00,0,9,16,4,0,249,4589,4838
2017-09-01 17:00:00-04:00,0,9,17,4,0,189,3111,3300
2017-09-01 18:00:00-04:00,0,9,18,4,0,396,2679,3075
2017-09-01 19:00:00-04:00,0,9,19,4,0,686,3183,3869
2017-09-01 20:00:00-04:00,0,9,20,4,0,1180,6644,7824
2017-09-01 21:00:00-04:00,0,9,21,4,0,1168,9186,10354
2017-09-01 22:00:00-04:00,0,9,22,4,0,1118,11594,12712
2017-09-01 23:00:00-04:00,0,9,23,4,0,1111,11957,13068
2017-09-02 00:00:00-04:00,0,9,0,5,0,1113,11435,12548
2017-09-02 01:00:00-04:00,0,9,1,5,0,1120,12015,13135
2017-09-02 02:00:00-04:00,0,9,2,5,0,1234,12904,14138
2017-09-02 03:00:00-04:00,0,9,3,5,0,1366,13687,15053
2017-09-02 04:00:00-04:00,0,9,4,5,0,1566,14186,15752
2017-09-02 05:00:00-04:00,0,9,5,5,0,1628,14246,15874
2017-09-02 06:00:00-04:00,0,9,6,5,0,1783,13376,15159
2017-09-02 07:00:00-04:00,0,9,7,5,0,1665,14642,16307
2017-09-02 08:00:00-04:00,0,9,8,5,0,1578,15411,16989
2017-09-02 09:00:00-04:00,0,9,9,5,0,1481,15270,16751
2017-09-02 10:00:00-04:00,0,9,10,5,0,1563,13321,14884
2017-09-02 11:00:00-04:00,0,9,11,5,0,1569,12646,14215
2017-09-02 12:00:00-04:00,0,9,12,5,0,1445,13346,14791
2017-09-02 13:00:00-04:00,0,9,13,5,0,1178,13017,14195
2017-09-02 14:00:00-04:00,0,9,14,5,0,1020,11748,12768
2017-09-02 15:00:00-04:00,0,9,15,5,0,826,9760,10586
2017-09-02 16:00:00-04:00,0,9,16,5,0,650,7941,8591
2017-09-02 17:00:00-04:00,0.0001,9,17,5,0,339,5769,6108
2017-09-02 18:00:00-04:00,0.0001,9,18,5,0,309,4006,4315
2017-09-02 19:00:00-04:00,0.0001,9,19,5,0,445,2173,2618
2017-09-02 20:00:00-04:00,0.06,9,20,5,0,636,3120,3756
2017-09-02 21:00:00-04:00,0.14,9,21,5,0,845,4107,4952
2017-09-02 22:00:00-04:00,0.32,9,22,5,0,959,5678,6637
2017-09-02 23:00:00-04:00,0.06,9,23,5,0,1040,7980,9020
2017-09-03 00:00:00-04:00,0.01,9,0,6,0,1214,9652,10866
2017-09-03 01:00:00-04:00,0.02,9,1,6,0,1225,10634,11859
2017-09-03 02:00:00-04:00,0.01,9,2,6,0,1439,11452,12891
2017-09-03 03:00:00-04:00,0.04,9,3,6,0,1536,12077,13613
2017-09-03 04:00:00-04:00,0.12,9,4,6,0,1593,12217,13810
2017-09-03 05:00:00-04:00,0.01,9,5,6,0,1902,12451,14353
2017-09-03 06:00:00-04:00,0,9,6,6,0,2016,12815,14831
2017-09-03 07:00:00-04:00,0,9,7,6,0,2126,14886,17012
2017-09-03 08:00:00-04:00,0.0001,9,8,6,0,2173,13595,15768
2017-09-03 09:00:00-04:00,0.24,9,9,6,0,1997,16530,18527
2017-09-03 10:00:00-04:00,0.11,9,10,6,0,1835,14742,16577
2017-09-03 11:00:00-04:00,0.0001,9,11,6,0,1713,14810,16523
2017-09-03 12:00:00-04:00,0.05,9,12,6,0,1458,13469,14927
2017-09-03 13:00:00-04:00,0,9,13,6,0,1211,12103,13314
2017-09-03 14:00:00-04:00,0,9,14,6,0,1041,9949,10990
2017-09-03 15:00:00-04:00,0,9,15,6,0,791,7670,8461
2017-09-03 16:00:00-04:00,0,9,16,6,0,625,6636,7261
2017-09-03 17:00:00-04:00,0,9,17,6,0,321,5378,5699
2017-09-03 18:00:00-04:00,0,9,18,6,0,255,3301,3556
2017-09-03 19:00:00-04:00,0,9,19,6,0,325,1638,1963
2017-09-03 20:00:00-04:00,0,9,20,6,0,436,2124,2560
2017-09-03 21:00:00-04:00,0,9,21,6,0,716,2890,3606
2017-09-03 22:00:00-04:00,0,9,22,6,0,835,4124,4959
2017-09-03 23:00:00-04:00,0,9,23,6,0,1010,7305,8315
2017-09-04 00:00:00-04:00,0,9,0,0,1,1065,8726,9791
2017-09-04 01:00:00-04:00,0,9,1,0,1,1051,11183,12234
2017-09-04 02:00:00-04:00,0,9,2,0,1,1196,10842,12038
2017-09-04 03:00:00-04:00,0,9,3,0,1,1358,11134,12492
2017-09-04 04:00:00-04:00,0,9,4,0,1,1394,11823,13217
2017-09-04 05:00:00-04:00,0,9,5,0,1,1414,11779,13193
2017-09-04 06:00:00-04:00,0,9,6,0,1,1577,11640,13217
2017-09-04 07:00:00-04:00,0,9,7,0,1,1389,12132,13521
2017-09-04 08:00:00-04:00,0,9,8,0,1,1378,12145,13523
2017-09-04 09:00:00-04:00,0,9,9,0,1,1216,11494,12710
2017-09-04 10:00:00-04:00,0,9,10,0,1,1402,10276,11678
2017-09-04 11:00:00-04:00,0,9,11,0,1,1525,10272,11797
2017-09-04 12:00:00-04:00,0,9,12,0,1,1267,9996,11263
2017-09-04 13:00:00-04:00,0,9,13,0,1,889,10080,10969
2017-09-04 14:00:00-04:00,0,9,14,0,1,679,8496,9175
2017-09-04 15:00:00-04:00,0,9,15,0,1,526,6089,6615
2017-09-04 16:00:00-04:00,0,9,16,0,1,464,4610,5074
2017-09-04 17:00:00-04:00,0,9,17,0,1,272,3623,3895
2017-09-04 18:00:00-04:00,0,9,18,0,1,291,2652,2943
2017-09-04 19:00:00-04:00,0,9,19,0,1,326,1838,2164
2017-09-04 20:00:00-04:00,0,9,20,0,1,417,2777,3194
2017-09-04 21:00:00-04:00,0,9,21,0,1,605,3376,3981
2017-09-04 22:00:00-04:00,0,9,22,0,1,713,4428,5141
2017-09-04 23:00:00-04:00,0,9,23,0,1,849,6310,7159
2017-09-05 00:00:00-04:00,0,9,0,1,0,950,8330,9280
2017-09-05 01:00:00-04:00,0,9,1,1,0,985,9735,10720
2017-09-05 02:00:00-04:00,0,9,2,1,0,1153,10820,11973
2017-09-05 03:00:00-04:00,0,9,3,1,0,1358,11301,12659
2017-09-05 04:00:00-04:00,0,9,4,1,0,1526,12608,14134
2017-09-05 05:00:00-04:00,0,9,5,1,0,1551,12512,14063
2017-09-05 06:00:00-04:00,0,9,6,1,0,1656,12592,14248
2017-09-05 07:00:00-04:00,0,9,7,1,0,1441,13242,14683
2017-09-05 08:00:00-04:00,0,9,8,1,0,1518,13608,15126
2017-09-05 09:00:00-04:00,0,9,9,1,0,1410,12918,14328
2017-09-05 10:00:00-04:00,0,9,10,1,0,1288,12307,13595
2017-09-05 11:00:00-04:00,0,9,11,1,0,971,11907,12878
2017-09-05 12:00:00-04:00,0,9,12,1,0,714,10029,10743
2017-09-05 13:00:00-04:00,0,9,13,1,0,375,7256,7631
2017-09-05 14:00:00-04:00,0,9,14,1,0,212,4653,4865
2017-09-05 15:00:00-04:00,0,9,15,1,0,185,2435,2620
2017-09-05 16:00:00-04:00,0,9,16,1,0,166,1551,1717
2017-09-05 17:00:00-04:00,0,9,17,1,0,170,1045,1215
2017-09-05 18:00:00-04:00,0,9,18,1,0,453,1404,1857
2017-09-05 19:00:00-04:00,0,9,19,1,0,918,3011,3929
2017-09-05 20:00:00-04:00,0,9,20,1,0,1357,8359,9716
2017-09-05 21:00:00-04:00,0,9,21,1,0,1424,13228,14652
2017-09-05 22:00:00-04:00,0,9,22,1,0,1268,15423,16691
2017-09-05 23:00:00-04:00,0,9,23,1,0,1240,15150,16390
2017-09-06 00:00:00-04:00,0,9,0,2,0,1161,13584,14745
2017-09-06 01:00:00-04:00,0,9,1,2,0,1152,13449,14601
2017-09-06 02:00:00-04:00,0,9,2,2,0,1320,14054,15374
2017-09-06 03:00:00-04:00,0,9,3,2,0,1433,14723,16156
2017-09-06 04:00:00-04:00,0,9,4,2,0,1553,15556,17109
2017-09-06 05:00:00-04:00,0,9,5,2,0,1730,15433,17163
2017-09-06 06:00:00-04:00,0.0001,9,6,2,0,1884,14711,16595
2017-09-06 07:00:00-04:00,0.0001,9,7,2,0,1723,16668,18391
2017-09-06 08:00:00-04:00,0.01,9,8,2,0,1598,19227,20825
2017-09-06 09:00:00-04:00,0.01,9,9,2,0,1254,18289,19543
2017-09-06 10:00:00-04:00,0.0001,9,10,2,0,1229,17797,19026
2017-09-06 11:00:00-04:00,0.0001,9,11,2,0,1022,15018,16040
2017-09-06 12:00:00-04:00,0,9,12,2,0,807,12634,13441
2017-09-06 13:00:00-04:00,0.0001,9,13,2,0,490,9277,9767
2017-09-06 14:00:00-04:00,0.13,9,14,2,0,329,6500,6829
2017-09-06 15:00:00-04:00,0,9,15,2,0,159,4029,4188
2017-09-06 16:00:00-04:00,0.0001,9,16,2,0,164,2310,2474
2017-09-06 17:00:00-04:00,0.0001,9,17,2,0,197,1419,1616
2017-09-06 18:00:00-04:00,0.0001,9,18,2,0,424,1555,1979
2017-09-06 19:00:00-04:00,0.0001,9,19,2,0,1049,3137,4186
2017-09-06 20:00:00-04:00,0.04,9,20,2,0,1413,8347,9760
2017-09-06 21:00:00-04:00,0.12,9,21,2,0,1447,15061,16508
2017-09-06 22:00:00-04:00,0.07,9,22,2,0,1274,17258,18532
2017-09-06 23:00:00-04:00,0.03,9,23,2,0,1257,17217,18474
2017-09-07 00:00:00-04:00,0.04,9,0,3,0,1228,15515,16743
2017-09-07 01:00:00-04:00,0.0001,9,1,3,0,1257,15905,17162
2017-09-07 02:00:00-04:00,0.0001,9,2,3,0,1443,15964,17407
2017-09-07 03:00:00-04:00,0.0001,9,3,3,0,1531,17134,18665
2017-09-07 04:00:00-04:00,0.0001,9,4,3,0,1741,17757,19498
2017-09-07 05:00:00-04:00,0.0001,9,5,3,0,2051,16533,18584
2017-09-07 06:00:00-04:00,0,9,6,3,0,2173,14645,16818
2017-09-07 07:00:00-04:00,0,9,7,3,0,1905,18135,20040
2017-09-07 08:00:00-04:00,0,9,8,3,0,2014,20352,22366
2017-09-07 09:00:00-04:00,0,9,9,3,0,1790,21216,23006
2017-09-07 10:00:00-04:00,0,9,10,3,0,1494,21072,22566
2017-09-07 11:00:00-04:00,0,9,11,3,0,1186,19502,20688
2017-09-07 12:00:00-04:00,0,9,12,3,0,864,16635,17499
2017-09-07 13:00:00-04:00,0,9,13,3,0,505,11459,11964
2017-09-07 14:00:00-04:00,0,9,14,3,0,260,7821,8081
2017-09-07 15:00:00-04:00,0,9,15,3,0,154,4808,4962
2017-09-07 16:00:00-04:00,0,9,16,3,0,184,2643,2827
2017-09-07 17:00:00-04:00,0,9,17,3,0,193,1683,1876
2017-09-07 18:00:00-04:00,0,9,18,3,0,470,1682,2152
2017-09-07 19:00:00-04:00,0,9,19,3,0,1134,3211,4345
2017-09-07 20:00:00-04:00,0,9,20,3,0,1569,8551,10120
2017-09-07 21:00:00-04:00,0,9,21,3,0,1505,16008,17513
2017-09-07 22:00:00-04:00,0,9,22,3,0,1347,17863,19210
2017-09-07 23:00:00-04:00,0,9,23,3,0,1348,16492,17840
2017-09-08 00:00:00-04:00,0,9,0,4,0,1215,15554,16769
2017-09-08 01:00:00-04:00,0,9,1,4,0,1230,15512,16742
2017-09-08 02:00:00-04:00,0,9,2,4,0,1481,16089,17570
2017-09-08 03:00:00-04:00,0,9,3,4,0,1652,15902,17554
2017-09-08 04:00:00-04:00,0,9,4,4,0,1696,17563,19259
2017-09-08 05:00:00-04:00,0,9,5,4,0,1956,17019,18975
2017-09-08 06:00:00-04:00,0,9,6,4,0,2136,15188,17324
2017-09-08 07:00:00-04:00,0,9,7,4,0,1979,17882,19861
2017-09-08 08:00:00-04:00,0,9,8,4,0,1794,20907,22701
2017-09-08 09:00:00-04:00,0,9,9,4,0,1715,20916,22631
2017-09-08 10:00:00-04:00,0,9,10,4,0,1580,20536,22116
2017-09-08 11:00:00-04:00,0,9,11,4,0,1408,19594,21002
2017-09-08 12:00:00-04:00,0,9,12,4,0,1113,18619,19732
2017-09-08 13:00:00-04:00,0,9,13,4,0,771,15944,16715
2017-09-08 14:00:00-04:00,0,9,14,4,0,500,12657,13157
2017-09-08 15:00:00-04:00,0,9,15,4,0,324,7787,8111
2017-09-08 16:00:00-04:00,0,9,16,4,0,278,5038,5316
2017-09-08 17:00:00-04:00,0,9,17,4,0,231,3323,3554
2017-09-08 18:00:00-04:00,0,9,18,4,0,503,2717,3220
2017-09-08 19:00:00-04:00,0,9,19,4,0,1163,3446,4609
2017-09-08 20:00:00-04:00,0,9,20,4,0,1464,8571,10035
2017-09-08 21:00:00-04:00,0,9,21,4,0,1461,14988,16449
2017-09-08 22:00:00-04:00,0,9,22,4,0,1335,17098,18433
2017-09-08 23:00:00-04:00,0,9,23,4,0,1317,15505,16822
2017-09-09 00:00:00-04:00,0,9,0,5,0,1254,14599,15853
2017-09-09 01:00:00-04:00,0,9,1,5,0,1116,15102,16218
2017-09-09 02:00:00-04:00,0,9,2,5,0,1466,15811,17277
2017-09-09 03:00:00-04:00,0,9,3,5,0,1658,15756,17414
2017-09-09 04:00:00-04:00,0,9,4,5,0,1790,17654,19444
2017-09-09 05:00:00-04:00,0,9,5,5,0,2034,16589,18623
2017-09-09 06:00:00-04:00,0,9,6,5,0,2475,14791,17266
2017-09-09 07:00:00-04:00,0,9,7,5,0,2307,17291,19598
2017-09-09 08:00:00-04:00,0,9,8,5,0,2209,21152,23361
2017-09-09 09:00:00-04:00,0,9,9,5,0,2057,21600,23657
2017-09-09 10:00:00-04:00,0,9,10,5,0,2073,19749,21822
2017-09-09 11:00:00-04:00,0,9,11,5,0,2055,17828,19883
2017-09-09 12:00:00-04:00,0,9,12,5,0,1899,18593,20492
2017-09-09 13:00:00-04:00,0,9,13,5,0,1695,18452,20147
2017-09-09 14:00:00-04:00,0,9,14,5,0,1327,16392,17719
2017-09-09 15:00:00-04:00,0,9,15,5,0,1100,14358,15458
2017-09-09 16:00:00-04:00,0,9,16,5,0,766,12105,12871
2017-09-09 17:00:00-04:00,0,9,17,5,0,387,8752,9139
2017-09-09 18:00:00-04:00,0,9,18,5,0,369,5373,5742
2017-09-09 19:00:00-04:00,0,9,19,5,0,465,2612,3077
2017-09-09 20:00:00-04:00,0,9,20,5,0,732,3689,4421
2017-09-09 21:00:00-04:00,0,9,21,5,0,1037,5629,6666
2017-09-09 22:00:00-04:00,0,9,22,5,0,1256,8636,9892
2017-09-09 23:00:00-04:00,0,9,23,5,0,1333,11947,13280
2017-09-10 00:00:00-04:00,0,9,0,6,0,1450,13839,15289
2017-09-10 01:00:00-04:00,0,9,1,6,0,1516,14446,15962
2017-09-10 02:00:00-04:00,0,9,2,6,0,1713,15250,16963
2017-09-10 03:00:00-04:00,0,9,3,6,0,1753,15540,17293
2017-09-10 04:00:00-04:00,0,9,4,6,0,1947,15629,17576
2017-09-10 05:00:00-04:00,0,9,5,6,0,2186,15890,18076
2017-09-10 06:00:00-04:00,0,9,6,6,0,2337,15318,17655
2017-09-10 07:00:00-04:00,0,9,7,6,0,2334,16900,19234
2017-09-10 08:00:00-04:00,0,9,8,6,0,2219,19158,21377
2017-09-10 09:00:00-04:00,0,9,9,6,0,2182,19732,21914
2017-09-10 10:00:00-04:00,0,9,10,6,0,2300,17560,19860
2017-09-10 11:00:00-04:00,0,9,11,6,0,2222,16618,18840
2017-09-10 12:00:00-04:00,0,9,12,6,0,2073,17499,19572
2017-09-10 13:00:00-04:00,0,9,13,6,0,1858,17804,19662
2017-09-10 14:00:00-04:00,0,9,14,6,0,1527,16711,18238
2017-09-10 15:00:00-04:00,0,9,15,6,0,1298,15080,16378
2017-09-10 16:00:00-04:00,0,9,16,6,0,918,12888,13806
2017-09-10 17:00:00-04:00,0,9,17,6,0,444,9672,10116
2017-09-10 18:00:00-04:00,0,9,18,6,0,341,6202,6543
2017-09-10 19:00:00-04:00,0,9,19,6,0,382,2746,3128
2017-09-10 20:00:00-04:00,0,9,20,6,0,569,3028,3597
2017-09-10 21:00:00-04:00,0,9,21,6,0,802,4349,5151
2017-09-10 22:00:00-04:00,0,9,22,6,0,1080,6843,7923
2017-09-10 23:00:00-04:00,0,9,23,6,0,1230,9443,10673
2017-09-11 00:00:00-04:00,0,9,0,0,0,1412,12610,14022
2017-09-11 01:00:00-04:00,0,9,1,0,0,1302,14645,15947
2017-09-11 02:00:00-04:00,0,9,2,0,0,1433,16406,17839
2017-09-11 03:00:00-04:00,0,9,3,0,0,1594,15885,17479
2017-09-11 04:00:00-04:00,0,9,4,0,0,1646,15898,17544
2017-09-11 05:00:00-04:00,0,9,5,0,0,1662,15800,17462
2017-09-11 06:00:00-04:00,0,9,6,0,0,1791,15650,17441
2017-09-11 07:00:00-04:00,0,9,7,0,0,1702,16143,17845
2017-09-11 08:00:00-04:00,0,9,8,0,0,1577,16274,17851
2017-09-11 09:00:00-04:00,0,9,9,0,0,1398,15632,17030
2017-09-11 10:00:00-04:00,0,9,10,0,0,1262,14307,15569
2017-09-11 11:00:00-04:00,0,9,11,0,0,1092,13184,14276
2017-09-11 12:00:00-04:00,0,9,12,0,0,755,11696,12451
2017-09-11 13:00:00-04:00,0,9,13,0,0,438,8482,8920
2017-09-11 14:00:00-04:00,0,9,14,0,0,340,5394,5734
2017-09-11 15:00:00-04:00,0,9,15,0,0,255,3346,3601
2017-09-11 16:00:00-04:00,0,9,16,0,0,257,2290,2547
2017-09-11 17:00:00-04:00,0,9,17,0,0,216,1721,1937
2017-09-11 18:00:00-04:00,0,9,18,0,0,439,1842,2281
2017-09-11 19:00:00-04:00,0,9,19,0,0,1097,3334,4431
2017-09-11 20:00:00-04:00,0,9,20,0,0,1564,8507,10071
2017-09-11 21:00:00-04:00,0,9,21,0,0,1402,14564,15966
2017-09-11 22:00:00-04:00,0,9,22,0,0,1217,16219,17436
2017-09-11 23:00:00-04:00,0,9,23,0,0,1079,14893,15972
2017-09-12 00:00:00-04:00,0,9,0,1,0,1109,13198,14307
2017-09-12 01:00:00-04:00,0,9,1,1,0,1108,13415,14523
2017-09-12 02:00:00-04:00,0,9,2,1,0,1255,13980,15235
2017-09-12 03:00:00-04:00,0,9,3,1,0,1364,14187,15551
2017-09-12 04:00:00-04:00,0,9,4,1,0,1501,15852,17353
2017-09-12 05:00:00-04:00,0,9,5,1,0,1676,16314,17990
2017-09-12 06:00:00-04:00,0,9,6,1,0,1869,15565,17434
2017-09-12 07:00:00-04:00,0,9,7,1,0,1699,17693,19392
2017-09-12 08:00:00-04:00,0,9,8,1,0,1471,20277,21748
2017-09-12 09:00:00-04:00,0,9,9,1,0,1195,20067,21262
2017-09-12 10:00:00-04:00,0,9,10,1,0,1061,18617,19678
2017-09-12 11:00:00-04:00,0,9,11,1,0,910,16712,17622
2017-09-12 12:00:00-04:00,0,9,12,1,0,708,14087,14795
2017-09-12 13:00:00-04:00,0,9,13,1,0,428,10675,11103
2017-09-12 14:00:00-04:00,0,9,14,1,0,255,6827,7082
2017-09-12 15:00:00-04:00,0,9,15,1,0,165,3984,4149
2017-09-12 16:00:00-04:00,0,9,16,1,0,209,2362,2571
2017-09-12 17:00:00-04:00,0,9,17,1,0,198,1695,1893
2017-09-12 18:00:00-04:00,0,9,18,1,0,420,1890,2310
2017-09-12 19:00:00-04:00,0,9,19,1,0,1075,3254,4329
2017-09-12 20:00:00-04:00,0,9,20,1,0,1495,8710,10205
2017-09-12 21:00:00-04:00,0,9,21,1,0,1372,15734,17106
2017-09-12 22:00:00-04:00,0,9,22,1,0,1254,17335,18589
2017-09-12 23:00:00-04:00,0,9,23,1,0,1129,16060,17189
2017-09-13 00:00:00-04:00,0,9,0,2,0,1135,14633,15768
2017-09-13 01:00:00-04:00,0,9,1,2,0,1207,14999,16206
2017-09-13 02:00:00-04:00,0,9,2,2,0,1359,15816,17175
2017-09-13 03:00:00-04:00,0,9,3,2,0,1412,15627,17039
2017-09-13 04:00:00-04:00,0,9,4,2,0,1520,17333,18853
2017-09-13 05:00:00-04:00,0,9,5,2,0,1921,17470,19391
2017-09-13 06:00:00-04:00,0,9,6,2,0,1952,15736,17688
2017-09-13 07:00:00-04:00,0,9,7,2,0,1818,18332,20150
2017-09-13 08:00:00-04:00,0,9,8,2,0,1538,21306,22844
2017-09-13 09:00:00-04:00,0,9,9,2,0,1470,20924,22394
2017-09-13 10:00:00-04:00,0,9,10,2,0,1181,20466,21647
2017-09-13 11:00:00-04:00,0,9,11,2,0,1072,19905,20977
2017-09-13 12:00:00-04:00,0,9,12,2,0,813,17054,17867
2017-09-13 13:00:00-04:00,0,9,13,2,0,460,13162,13622
2017-09-13 14:00:00-04:00,0,9,14,2,0,264,8072,8336
2017-09-13 15:00:00-04:00,0.0001,9,15,2,0,179,4738,4917
2017-09-13 16:00:00-04:00,0.02,9,16,2,0,197,2912,3109
2017-09-13 17:00:00-04:00,0.0001,9,17,2,0,175,2007,2182
2017-09-13 18:00:00-04:00,0,9,18,2,0,436,1961,2397
2017-09-13 19:00:00-04:00,0,9,19,2,0,1020,3266,4286
2017-09-13 20:00:00-04:00,0,9,20,2,0,1396,8787,10183
2017-09-13 21:00:00-04:00,0,9,21,2,0,1384,15791,17175
2017-09-13 22:00:00-04:00,0,9,22,2,0,1178,17635,18813
2017-09-13 23:00:00-04:00,0,9,23,2,0,1083,16042,17125
2017-09-14 00:00:00-04:00,0,9,0,3,0,1164,15215,16379
2017-09-14 01:00:00-04:00,0,9,1,3,0,1167,15603,16770
2017-09-14 02:00:00-04:00,0,9,2,3,0,1340,16164,17504
2017-09-14 03:00:00-04:00,0,9,3,3,0,1659,16008,17667
2017-09-14 04:00:00-04:00,0,9,4,3,0,1865,17449,19314
2017-09-14 05:00:00-04:00,0,9,5,3,0,1991,18173,20164
2017-09-14 06:00:00-04:00,0,9,6,3,0,2108,15397,17505
2017-09-14 07:00:00-04:00,0,9,7,3,0,1969,16940,18909
2017-09-14 08:00:00-04:00,0,9,8,3,0,1740,20005,21745
2017-09-14 09:00:00-04:00,0,9,9,3,0,1448,20828,22276
2017-09-14 10:00:00-04:00,0,9,10,3,0,1237,20663,21900
2017-09-14 11:00:00-04:00,0,9,11,3,0,1126,20036,21162
2017-09-14 12:00:00-04:00,0,9,12,3,0,788,18415,19203
2017-09-14 13:00:00-04:00,0,9,13,3,0,514,13596,14110
2017-09-14 14:00:00-04:00,0,9,14,3,0,327,8658,8985
2017-09-14 15:00:00-04:00,0,9,15,3,0,226,5210,5436
2017-09-14 16:00:00-04:00,0,9,16,3,0,208,3332,3540
2017-09-14 17:00:00-04:00,0,9,17,3,0,203,2261,2464
2017-09-14 18:00:00-04:00,0,9,18,3,0,440,2032,2472
2017-09-14 19:00:00-04:00,0,9,19,3,0,1201,3348,4549
2017-09-14 20:00:00-04:00,0,9,20,3,0,1645,8865,10510
2017-09-14 21:00:00-04:00,0,9,21,3,0,1653,16556,18209
2017-09-14 22:00:00-04:00,0,9,22,3,0,1400,18882,20282
2017-09-14 23:00:00-04:00,0,9,23,3,0,1254,17314,18568
2017-09-15 00:00:00-04:00,0,9,0,4,0,1273,16129,17402
2017-09-15 01:00:00-04:00,0,9,1,4,0,1234,16219,17453
2017-09-15 02:00:00-04:00,0,9,2,4,0,1442,16888,18330
2017-09-15 03:00:00-04:00,0,9,3,4,0,1593,16582,18175
2017-09-15 04:00:00-04:00,0,9,4,4,0,1791,17971,19762
2017-09-15 05:00:00-04:00,0,9,5,4,0,1949,17234,19183
2017-09-15 06:00:00-04:00,0,9,6,4,0,2270,15324,17594
2017-09-15 07:00:00-04:00,0,9,7,4,0,2117,17496,19613
2017-09-15 08:00:00-04:00,0,9,8,4,0,1961,20789,22750
2017-09-15 09:00:00-04:00,0,9,9,4,0,1762,21357,23119
2017-09-15 10:00:00-04:00,0,9,10,4,0,1560,20308,21868
2017-09-15 11:00:00-04:00,0,9,11,4,0,1390,19647,21037
2017-09-15 12:00:00-04:00,0,9,12,4,0,1135,19432,20567
2017-09-15 13:00:00-04:00,0,9,13,4,0,778,17198,17976
2017-09-15 14:00:00-04:00,0,9,14,4,0,488,11834,12322
2017-09-15 15:00:00-04:00,0,9,15,4,0,343,7805,8148
2017-09-15 16:00:00-04:00,0,9,16,4,0,298,4975,5273
2017-09-15 17:00:00-04:00,0,9,17,4,0,234,3240,3474
2017-09-15 18:00:00-04:00,0,9,18,4,0,492,2698,3190
2017-09-15 19:00:00-04:00,0,9,19,4,0,1100,3482,4582
2017-09-15 20:00:00-04:00,0,9,20,4,0,1560,8468,10028
2017-09-15 21:00:00-04:00,0,9,21,4,0,1532,15026,16558
2017-09-15 22:00:00-04:00,0,9,22,4,0,1329,17291,18620
2017-09-15 23:00:00-04:00,0,9,23,4,0,1227,15851,17078
2017-09-16 00:00:00-04:00,0,9,0,5,0,1236,14793,16029
2017-09-16 01:00:00-04:00,0,9,1,5,0,1113,14931,16044
2017-09-16 02:00:00-04:00,0,9,2,5,0,1410,15960,17370
2017-09-16 03:00:00-04:00,0,9,3,5,0,1745,16022,17767
2017-09-16 04:00:00-04:00,0,9,4,5,0,1938,17660,19598
2017-09-16 05:00:00-04:00,0,9,5,5,0,2247,16241,18488
2017-09-16 06:00:00-04:00,0,9,6,5,0,2580,14611,17191
2017-09-16 07:00:00-04:00,0,9,7,5,0,2365,17650,20015
2017-09-16 08:00:00-04:00,0,9,8,5,0,2131,20000,22131
2017-09-16 09:00:00-04:00,0,9,9,5,0,2068,21234,23302
2017-09-16 10:00:00-04:00,0,9,10,5,0,2017,19191,21208
2017-09-16 11:00:00-04:00,0,9,11,5,0,1999,18130,20129
2017-09-16 12:00:00-04:00,0,9,12,5,0,1826,18908,20734
2017-09-16 13:00:00-04:00,0,9,13,5,0,1659,18135,19794
2017-09-16 14:00:00-04:00,0,9,14,5,0,1390,16158,17548
2017-09-16 15:00:00-04:00,0,9,15,5,0,1138,13963,15101
2017-09-16 16:00:00-04:00,0,9,16,5,0,788,11573,12361
2017-09-16 17:00:00-04:00,0,9,17,5,0,401,8186,8587
2017-09-16 18:00:00-04:00,0,9,18,5,0,382,5174,5556
2017-09-16 19:00:00-04:00,0,9,19,5,0,535,2669,3204
2017-09-16 20:00:00-04:00,0,9,20,5,0,755,3798,4553
2017-09-16 21:00:00-04:00,0,9,21,5,0,1026,5832,6858
2017-09-16 22:00:00-04:00,0,9,22,5,0,1143,9240,10383
2017-09-16 23:00:00-04:00,0,9,23,5,0,1300,12466,13766
2017-09-17 00:00:00-04:00,0,9,0,6,0,1431,14205,15636
2017-09-17 01:00:00-04:00,0,9,1,6,0,1473,16086,17559
2017-09-17 02:00:00-04:00,0,9,2,6,0,1619,16935,18554
2017-09-17 03:00:00-04:00,0,9,3,6,0,1753,17533,19286
2017-09-17 04:00:00-04:00,0,9,4,6,0,1857,17604,19461
2017-09-17 05:00:00-04:00,0,9,5,6,0,1939,17788,19727
2017-09-17 06:00:00-04:00,0,9,6,6,0,2134,16331,18465
2017-09-17 07:00:00-04:00,0,9,7,6,0,2232,17419,19651
2017-09-17 08:00:00-04:00,0,9,8,6,0,2194,19271,21465
2017-09-17 09:00:00-04:00,0,9,9,6,0,2130,19957,22087
2017-09-17 10:00:00-04:00,0,9,10,6,0,2253,17096,19349
2017-09-17 11:00:00-04:00,0,9,11,6,0,2170,16343,18513
2017-09-17 12:00:00-04:00,0,9,12,6,0,2130,18237,20367
2017-09-17 13:00:00-04:00,0,9,13,6,0,1927,17981,19908
2017-09-17 14:00:00-04:00,0,9,14,6,0,1650,17089,18739
2017-09-17 15:00:00-04:00,0,9,15,6,0,1297,15340,16637
2017-09-17 16:00:00-04:00,0,9,16,6,0,1028,12793,13821
2017-09-17 17:00:00-04:00,0,9,17,6,0,478,9394,9872
2017-09-17 18:00:00-04:00,0,9,18,6,0,329,5943,6272
2017-09-17 19:00:00-04:00,0,9,19,6,0,430,2857,3287
2017-09-17 20:00:00-04:00,0,9,20,6,0,567,3941,4508
2017-09-17 21:00:00-04:00,0,9,21,6,0,858,4621,5479
2017-09-17 22:00:00-04:00,0,9,22,6,0,1057,7678,8735
2017-09-17 23:00:00-04:00,0,9,23,6,0,1180,10343,11523
2017-09-18 00:00:00-04:00,0,9,0,0,0,1334,13646,14980
2017-09-18 01:00:00-04:00,0,9,1,0,0,1441,15298,16739
2017-09-18 02:00:00-04:00,0,9,2,0,0,1513,16436,17949
2017-09-18 03:00:00-04:00,0,9,3,0,0,1627,16937,18564
2017-09-18 04:00:00-04:00,0,9,4,0,0,1533,16595,18128
2017-09-18 05:00:00-04:00,0,9,5,0,0,1578,15947,17525
2017-09-18 06:00:00-04:00,0,9,6,0,0,1703,14573,16276
2017-09-18 07:00:00-04:00,0.0001,9,7,0,0,1562,13997,15559
2017-09-18 08:00:00-04:00,0.0001,9,8,0,0,1458,14957,16415
2017-09-18 09:00:00-04:00,0.0001,9,9,0,0,1407,14736,16143
2017-09-18 10:00:00-04:00,0,9,10,0,0,1281,13335,14616
2017-09-18 11:00:00-04:00,0,9,11,0,0,859,12490,13349
2017-09-18 12:00:00-04:00,0,9,12,0,0,653,10881,11534
2017-09-18 13:00:00-04:00,0,9,13,0,0,460,8169,8629
2017-09-18 14:00:00-04:00,0,9,14,0,0,257,5234,5491
2017-09-18 15:00:00-04:00,0,9,15,0,0,219,3095,3314
2017-09-18 16:00:00-04:00,0,9,16,0,0,256,1946,2202
2017-09-18 17:00:00-04:00,0,9,17,0,0,230,1394,1624
2017-09-18 18:00:00-04:00,0,9,18,0,0,464,1755,2219
2017-09-18 19:00:00-04:00,0,9,19,0,0,1147,3626,4773
2017-09-18 20:00:00-04:00,0,9,20,0,0,1601,8627,10228
2017-09-18 21:00:00-04:00,0,9,21,0,0,1544,14018,15562
2017-09-18 22:00:00-04:00,0,9,22,0,0,1335,14958,16293
2017-09-18 23:00:00-04:00,0,9,23,0,0,1185,13374,14559
2017-09-19 00:00:00-04:00,0,9,0,1,0,1133,11764,12897
2017-09-19 01:00:00-04:00,0,9,1,1,0,1125,11796,12921
2017-09-19 02:00:00-04:00,0,9,2,1,0,1260,12336,13596
2017-09-19 03:00:00-04:00,0,9,3,1,0,1463,13018,14481
2017-09-19 04:00:00-04:00,0,9,4,1,0,1602,14077,15679
2017-09-19 05:00:00-04:00,0,9,5,1,0,1823,14263,16086
2017-09-19 06:00:00-04:00,0,9,6,1,0,1999,13240,15239
2017-09-19 07:00:00-04:00,0,9,7,1,0,1828,15231,17059
2017-09-19 08:00:00-04:00,0,9,8,1,0,1451,17029,18480
2017-09-19 09:00:00-04:00,0,9,9,1,0,1248,16800,18048
2017-09-19 10:00:00-04:00,0,9,10,1,0,1052,16899,17951
2017-09-19 11:00:00-04:00,0.0001,9,11,1,0,896,15949,16845
2017-09-19 12:00:00-04:00,0,9,12,1,0,604,13828,14432
2017-09-19 13:00:00-04:00,0,9,13,1,0,417,9732,10149
2017-09-19 14:00:00-04:00,0.0001,9,14,1,0,210,6506,6716
2017-09-19 15:00:00-04:00,0.14,9,15,1,0,171,3910,4081
2017-09-19 16:00:00-04:00,0.04,9,16,1,0,167,2071,2238
2017-09-19 17:00:00-04:00,0.0001,9,17,1,0,176,1434,1610
2017-09-19 18:00:00-04:00,0.0001,9,18,1,0,468,1535,2003
2017-09-19 19:00:00-04:00,0.01,9,19,1,0,1057,3235,4292
2017-09-19 20:00:00-04:00,0.0001,9,20,1,0,1505,8631,10136
2017-09-19 21:00:00-04:00,0,9,21,1,0,1360,14019,15379
2017-09-19 22:00:00-04:00,0,9,22,1,0,1271,15287,16558
2017-09-19 23:00:00-04:00,0,9,23,1,0,1186,13712,14898
2017-09-20 00:00:00-04:00,0,9,0,2,0,1150,12456,13606
2017-09-20 01:00:00-04:00,0,9,1,2,0,1140,12635,13775
2017-09-20 02:00:00-04:00,0,9,2,2,0,1431,12828,14259
2017-09-20 03:00:00-04:00,0,9,3,2,0,2064,13092,15156
2017-09-20 04:00:00-04:00,0,9,4,2,0,1951,15403,17354
2017-09-20 05:00:00-04:00,0,9,5,2,0,1987,16903,18890
2017-09-20 06:00:00-04:00,0,9,6,2,0,2198,13527,15725
2017-09-20 07:00:00-04:00,0,9,7,2,0,2134,14908,17042
2017-09-20 08:00:00-04:00,0,9,8,2,0,1639,17141,18780
2017-09-20 09:00:00-04:00,0,9,9,2,0,1392,18064,19456
2017-09-20 10:00:00-04:00,0,9,10,2,0,1143,16982,18125
2017-09-20 11:00:00-04:00,0,9,11,2,0,1048,17173,18221
2017-09-20 12:00:00-04:00,0,9,12,2,0,696,15940,16636
2017-09-20 13:00:00-04:00,0,9,13,2,0,398,11852,12250
2017-09-20 14:00:00-04:00,0,9,14,2,0,221,7088,7309
2017-09-20 15:00:00-04:00,0,9,15,2,0,153,3955,4108
2017-09-20 16:00:00-04:00,0,9,16,2,0,167,2436,2603
2017-09-20 17:00:00-04:00,0,9,17,2,0,202,1611,1813
2017-09-20 18:00:00-04:00,0,9,18,2,0,456,1776,2232
2017-09-20 19:00:00-04:00,0,9,19,2,0,1098,3333,4431
2017-09-20 20:00:00-04:00,0,9,20,2,0,1436,8699,10135
2017-09-20 21:00:00-04:00,0,9,21,2,0,1405,14600,16005
2017-09-20 22:00:00-04:00,0,9,22,2,0,1245,15522,16767
2017-09-20 23:00:00-04:00,0,9,23,2,0,1282,13928,15210
2017-09-21 00:00:00-04:00,0,9,0,3,0,1238,13193,14431
2017-09-21 01:00:00-04:00,0,9,1,3,0,1269,13626,14895
2017-09-21 02:00:00-04:00,0,9,2,3,0,1335,13973,15308
2017-09-21 03:00:00-04:00,0,9,3,3,0,1581,14188,15769
2017-09-21 04:00:00-04:00,0,9,4,3,0,1619,15214,16833
2017-09-21 05:00:00-04:00,0,9,5,3,0,2037,14695,16732
2017-09-21 06:00:00-04:00,0,9,6,3,0,2180,13201,15381
2017-09-21 07:00:00-04:00,0,9,7,3,0,1873,15768,17641
2017-09-21 08:00:00-04:00,0,9,8,3,0,1630,17901,19531
2017-09-21 09:00:00-04:00,0,9,9,3,0,1507,18135,19642
2017-09-21 10:00:00-04:00,0,9,10,3,0,1318,17104,18422
2017-09-21 11:00:00-04:00,0,9,11,3,0,1127,18073,19200
2017-09-21 12:00:00-04:00,0,9,12,3,0,819,17068,17887
2017-09-21 13:00:00-04:00,0,9,13,3,0,567,12039,12606
2017-09-21 14:00:00-04:00,0,9,14,3,0,306,7625,7931
2017-09-21 15:00:00-04:00,0,9,15,3,0,259,4537,4796
2017-09-21 16:00:00-04:00,0,9,16,3,0,193,2903,3096
2017-09-21 17:00:00-04:00,0,9,17,3,0,220,2051,2271
2017-09-21 18:00:00-04:00,0,9,18,3,0,426,1808,2234
2017-09-21 19:00:00-04:00,0,9,19,3,0,871,3068,3939
2017-09-21 20:00:00-04:00,0,9,20,3,0,1329,7528,8857
2017-09-21 21:00:00-04:00,0,9,21,3,0,1420,11306,12726
2017-09-21 22:00:00-04:00,0,9,22,3,0,1318,13257,14575
2017-09-21 23:00:00-04:00,0,9,23,3,0,1222,14237,15459
2017-09-22 00:00:00-04:00,0,9,0,4,0,1158,13964,15122
2017-09-22 01:00:00-04:00,0,9,1,4,0,1172,13305,14477
2017-09-22 02:00:00-04:00,0,9,2,4,0,1307,14201,15508
2017-09-22 03:00:00-04:00,0,9,3,4,0,1500,14949,16449
2017-09-22 04:00:00-04:00,0,9,4,4,0,1600,14956,16556
2017-09-22 05:00:00-04:00,0,9,5,4,0,1906,13971,15877
2017-09-22 06:00:00-04:00,0,9,6,4,0,2074,12391,14465
2017-09-22 07:00:00-04:00,0,9,7,4,0,1918,15249,17167
2017-09-22 08:00:00-04:00,0,9,8,4,0,1696,18046,19742
2017-09-22 09:00:00-04:00,0,9,9,4,0,1608,18510,20118
2017-09-22 10:00:00-04:00,0,9,10,4,0,1458,17815,19273
2017-09-22 11:00:00-04:00,0,9,11,4,0,1390,18423,19813
2017-09-22 12:00:00-04:00,0,9,12,4,0,1051,17574,18625
2017-09-22 13:00:00-04:00,0,9,13,4,0,732,14108,14840
2017-09-22 14:00:00-04:00,0,9,14,4,0,485,10247,10732
2017-09-22 15:00:00-04:00,0,9,15,4,0,342,6479,6821
2017-09-22 16:00:00-04:00,0,9,16,4,0,271,4384,4655
2017-09-22 17:00:00-04:00,0,9,17,4,0,219,3056,3275
2017-09-22 18:00:00-04:00,0,9,18,4,0,414,2483,2897
2017-09-22 19:00:00-04:00,0,9,19,4,0,853,3163,4016
2017-09-22 20:00:00-04:00,0,9,20,4,0,1277,7473,8750
2017-09-22 21:00:00-04:00,0,9,21,4,0,1509,11949,13458
2017-09-22 22:00:00-04:00,0,9,22,4,0,1131,13345,14476
2017-09-22 23:00:00-04:00,0,9,23,4,0,1307,13576,14883
2017-09-23 00:00:00-04:00,0,9,0,5,0,1242,13364,14606
2017-09-23 01:00:00-04:00,0,9,1,5,0,1100,13743,14843
2017-09-23 02:00:00-04:00,0,9,2,5,0,1348,14263,15611
2017-09-23 03:00:00-04:00,0,9,3,5,0,1585,14365,15950
2017-09-23 04:00:00-04:00,0,9,4,5,0,1784,15710,17494
2017-09-23 05:00:00-04:00,0,9,5,5,0,2087,15427,17514
2017-09-23 06:00:00-04:00,0,9,6,5,0,2510,14444,16954
2017-09-23 07:00:00-04:00,0,9,7,5,0,2371,17547,19918
2017-09-23 08:00:00-04:00,0,9,8,5,0,2006,19816,21822
2017-09-23 09:00:00-04:00,0,9,9,5,0,2063,20978,23041
2017-09-23 10:00:00-04:00,0,9,10,5,0,2101,18399,20500
2017-09-23 11:00:00-04:00,0,9,11,5,0,2063,17315,19378
2017-09-23 12:00:00-04:00,0,9,12,5,0,1847,18194,20041
2017-09-23 13:00:00-04:00,0,9,13,5,0,1579,17963,19542
2017-09-23 14:00:00-04:00,0,9,14,5,0,1321,16017,17338
2017-09-23 15:00:00-04:00,0,9,15,5,0,1052,13804,14856
2017-09-23 16:00:00-04:00,0,9,16,5,0,834,11409,12243
2017-09-23 17:00:00-04:00,0,9,17,5,0,430,8405,8835
2017-09-23 18:00:00-04:00,0,9,18,5,0,376,5205,5581
2017-09-23 19:00:00-04:00,0,9,19,5,0,507,2672,3179
2017-09-23 20:00:00-04:00,0,9,20,5,0,794,3781,4575
2017-09-23 21:00:00-04:00,0,9,21,5,0,1044,5336,6380
2017-09-23 22:00:00-04:00,0,9,22,5,0,1226,8619,9845
2017-09-23 23:00:00-04:00,0,9,23,5,0,1320,11788,13108
2017-09-24 00:00:00-04:00,0,9,0,6,0,1471,13883,15354
2017-09-24 01:00:00-04:00,0,9,1,6,0,1446,15148,16594
2017-09-24 02:00:00-04:00,0,9,2,6,0,1571,16368,17939
2017-09-24 03:00:00-04:00,0,9,3,6,0,1694,17013,18707
2017-09-24 04:00:00-04:00,0,9,4,6,0,1719,16529,18248
2017-09-24 05:00:00-04:00,0,9,5,6,0,1930,17034,18964
2017-09-24 06:00:00-04:00,0,9,6,6,0,2128,16142,18270
2017-09-24 07:00:00-04:00,0,9,7,6,0,2082,17569,19651
2017-09-24 08:00:00-04:00,0,9,8,6,0,2034,19487,21521
2017-09-24 09:00:00-04:00,0,9,9,6,0,2103,20139,22242
2017-09-24 10:00:00-04:00,0,9,10,6,0,2192,16959,19151
2017-09-24 11:00:00-04:00,0,9,11,6,0,2267,16461,18728
2017-09-24 12:00:00-04:00,0,9,12,6,0,1925,17917,19842
2017-09-24 13:00:00-04:00,0,9,13,6,0,1811,17346,19157
2017-09-24 14:00:00-04:00,0,9,14,6,0,1529,15188,16717
2017-09-24 15:00:00-04:00,0,9,15,6,0,1211,14214,15425
2017-09-24 16:00:00-04:00,0,9,16,6,0,917,11984,12901
2017-09-24 17:00:00-04:00,0,9,17,6,0,489,8685,9174
2017-09-24 18:00:00-04:00,0,9,18,6,0,368,5477,5845
2017-09-24 19:00:00-04:00,0,9,19,6,0,432,2680,3112
2017-09-24 20:00:00-04:00,0,9,20,6,0,551,3425,3976
2017-09-24 21:00:00-04:00,0,9,21,6,0,818,4888,5706
2017-09-24 22:00:00-04:00,0,9,22,6,0,1055,6899,7954
2017-09-24 23:00:00-04:00,0,9,23,6,0,1183,9723,10906
2017-09-25 00:00:00-04:00,0,9,0,0,0,1360,12927,14287
2017-09-25 01:00:00-04:00,0,9,1,0,0,1284,14593,15877
2017-09-25 02:00:00-04:00,0,9,2,0,0,1407,16401,17808
2017-09-25 03:00:00-04:00,0,9,3,0,0,1520,16016,17536
2017-09-25 04:00:00-04:00,0,9,4,0,0,1539,16202,17741
2017-09-25 05:00:00-04:00,0,9,5,0,0,1608,15590,17198
2017-09-25 06:00:00-04:00,0,9,6,0,0,1620,15646,17266
2017-09-25 07:00:00-04:00,0,9,7,0,0,1549,15861,17410
2017-09-25 08:00:00-04:00,0,9,8,0,0,1459,16024,17483
2017-09-25 09:00:00-04:00,0,9,9,0,0,1344,14834,16178
2017-09-25 10:00:00-04:00,0,9,10,0,0,1163,13465,14628
2017-09-25 11:00:00-04:00,0,9,11,0,0,935,12434,13369
2017-09-25 12:00:00-04:00,0,9,12,0,0,639,10339,10978
2017-09-25 13:00:00-04:00,0,9,13,0,0,422,8100,8522
2017-09-25 14:00:00-04:00,0,9,14,0,0,277,4884,5161
2017-09-25 15:00:00-04:00,0,9,15,0,0,222,2777,2999
2017-09-25 16:00:00-04:00,0,9,16,0,0,241,1942,2183
2017-09-25 17:00:00-04:00,0,9,17,0,0,218,1360,1578
2017-09-25 18:00:00-04:00,0,9,18,0,0,432,1686,2118
2017-09-25 19:00:00-04:00,0,9,19,0,0,1127,3242,4369
2017-09-25 20:00:00-04:00,0,9,20,0,0,1558,8705,10263
2017-09-25 21:00:00-04:00,0,9,21,0,0,1471,14768,16239
2017-09-25 22:00:00-04:00,0,9,22,0,0,1301,16527,17828
2017-09-25 23:00:00-04:00,0,9,23,0,0,1199,15185,16384
2017-09-26 00:00:00-04:00,0,9,0,1,0,1183,13398,14581
2017-09-26 01:00:00-04:00,0,9,1,1,0,1125,13861,14986
2017-09-26 02:00:00-04:00,0,9,2,1,0,1252,14250,15502
2017-09-26 03:00:00-04:00,0,9,3,1,0,1493,14971,16464
2017-09-26 04:00:00-04:00,0,9,4,1,0,1528,16228,17756
2017-09-26 05:00:00-04:00,0,9,5,1,0,1690,16175,17865
2017-09-26 06:00:00-04:00,0,9,6,1,0,1843,15221,17064
2017-09-26 07:00:00-04:00,0,9,7,1,0,1730,18004,19734
2017-09-26 08:00:00-04:00,0,9,8,1,0,1459,20010,21469
2017-09-26 09:00:00-04:00,0,9,9,1,0,1211,19191,20402
2017-09-26 10:00:00-04:00,0,9,10,1,0,1070,17796,18866
2017-09-26 11:00:00-04:00,0,9,11,1,0,767,16448,17215
2017-09-26 12:00:00-04:00,0,9,12,1,0,561,13541,14102
2017-09-26 13:00:00-04:00,0,9,13,1,0,346,8954,9300
2017-09-26 14:00:00-04:00,0,9,14,1,0,230,5685,5915
2017-09-26 15:00:00-04:00,0,9,15,1,0,169,3024,3193
2017-09-26 16:00:00-04:00,0,9,16,1,0,154,1976,2130
2017-09-26 17:00:00-04:00,0,9,17,1,0,171,1348,1519
2017-09-26 18:00:00-04:00,0,9,18,1,0,402,1526,1928
2017-09-26 19:00:00-04:00,0,9,19,1,0,1074,3003,4077
2017-09-26 20:00:00-04:00,0,9,20,1,0,1467,8505,9972
2017-09-26 21:00:00-04:00,0,9,21,1,0,1545,15125,16670
2017-09-26 22:00:00-04:00,0,9,22,1,0,1266,17315,18581
2017-09-26 23:00:00-04:00,0,9,23,1,0,1152,16232,17384
2017-09-27 00:00:00-04:00,0,9,0,2,0,1187,14940,16127
2017-09-27 01:00:00-04:00,0,9,1,2,0,1197,14811,16008
2017-09-27 02:00:00-04:00,0,9,2,2,0,1335,15339,16674
2017-09-27 03:00:00-04:00,0,9,3,2,0,1437,15402,16839
2017-09-27 04:00:00-04:00,0,9,4,2,0,1679,17010,18689
2017-09-27 05:00:00-04:00,0,9,5,2,0,2014,15963,17977
2017-09-27 06:00:00-04:00,0,9,6,2,0,2113,13976,16089
2017-09-27 07:00:00-04:00,0,9,7,2,0,1971,16430,18401
2017-09-27 08:00:00-04:00,0,9,8,2,0,1719,17995,19714
2017-09-27 09:00:00-04:00,0,9,9,2,0,1505,19317,20822
2017-09-27 10:00:00-04:00,0,9,10,2,0,1314,18326,19640
2017-09-27 11:00:00-04:00,0,9,11,2,0,1041,18437,19478
2017-09-27 12:00:00-04:00,0,9,12,2,0,694,16526,17220
2017-09-27 13:00:00-04:00,0,9,13,2,0,359,11731,12090
2017-09-27 14:00:00-04:00,0,9,14,2,0,216,7209,7425
2017-09-27 15:00:00-04:00,0,9,15,2,0,172,3794,3966
2017-09-27 16:00:00-04:00,0,9,16,2,0,169,2589,2758
2017-09-27 17:00:00-04:00,0,9,17,2,0,172,1598,1770
2017-09-27 18:00:00-04:00,0,9,18,2,0,432,1684,2116
2017-09-27 19:00:00-04:00,0,9,19,2,0,1038,3218,4256
2017-09-27 20:00:00-04:00,0,9,20,2,0,1467,8866,10333
2017-09-27 21:00:00-04:00,0,9,21,2,0,1471,16017,17488
2017-09-27 22:00:00-04:00,0,9,22,2,0,1298,17870,19168
2017-09-27 23:00:00-04:00,0,9,23,2,0,1268,16741,18009
2017-09-28 00:00:00-04:00,0,9,0,3,0,1288,15381,16669
2017-09-28 01:00:00-04:00,0,9,1,3,0,1263,15608,16871
2017-09-28 02:00:00-04:00,0,9,2,3,0,1410,16163,17573
2017-09-28 03:00:00-04:00,0,9,3,3,0,1551,16147,17698
2017-09-28 04:00:00-04:00,0,9,4,3,0,1671,17511,19182
2017-09-28 05:00:00-04:00,0,9,5,3,0,1922,17267,19189
2017-09-28 06:00:00-04:00,0,9,6,3,0,2136,15518,17654
2017-09-28 07:00:00-04:00,0,9,7,3,0,2035,18940,20975
2017-09-28 08:00:00-04:00,0,9,8,3,0,1711,21778,23489
2017-09-28 09:00:00-04:00,0,9,9,3,0,1647,22377,24024
2017-09-28 10:00:00-04:00,0,9,10,3,0,1433,20870,22303
2017-09-28 11:00:00-04:00,0,9,11,3,0,1157,20579,21736
2017-09-28 12:00:00-04:00,0,9,12,3,0,790,18335,19125
2017-09-28 13:00:00-04:00,0,9,13,3,0,500,13500,14000
2017-09-28 14:00:00-04:00,0,9,14,3,0,279,8429,8708
2017-09-28 15:00:00-04:00,0,9,15,3,0,209,4591,4800
2017-09-28 16:00:00-04:00,0,9,16,3,0,187,3045,3232
2017-09-28 17:00:00-04:00,0,9,17,3,0,209,1983,2192
2017-09-28 18:00:00-04:00,0,9,18,3,0,465,1948,2413
2017-09-28 19:00:00-04:00,0,9,19,3,0,1099,3448,4547
2017-09-28 20:00:00-04:00,0,9,20,3,0,1525,8962,10487
2017-09-28 21:00:00-04:00,0,9,21,3,0,1501,16004,17505
2017-09-28 22:00:00-04:00,0,9,22,3,0,1290,17573,18863
2017-09-28 23:00:00-04:00,0,9,23,3,0,1243,16103,17346
2017-09-29 00:00:00-04:00,0,9,0,4,0,1220,15170,16390
2017-09-29 01:00:00-04:00,0,9,1,4,0,1234,15243,16477
2017-09-29 02:00:00-04:00,0,9,2,4,0,1427,15877,17304
2017-09-29 03:00:00-04:00,0,9,3,4,0,1602,15833,17435
2017-09-29 04:00:00-04:00,0,9,4,4,0,1808,17005,18813
2017-09-29 05:00:00-04:00,0,9,5,4,0,2030,16633,18663
2017-09-29 06:00:00-04:00,0,9,6,4,0,2195,14448,16643
2017-09-29 07:00:00-04:00,0,9,7,4,0,2177,17804,19981
2017-09-29 08:00:00-04:00,0,9,8,4,0,1937,20236,22173
2017-09-29 09:00:00-04:00,0,9,9,4,0,1835,21134,22969
2017-09-29 10:00:00-04:00,0,9,10,4,0,1619,21584,23203
2017-09-29 11:00:00-04:00,0,9,11,4,0,1356,20764,22120
2017-09-29 12:00:00-04:00,0,9,12,4,0,1108,19933,21041
2017-09-29 13:00:00-04:00,0,9,13,4,0,738,16925,17663
2017-09-29 14:00:00-04:00,0,9,14,4,0,509,11778,12287
2017-09-29 15:00:00-04:00,0,9,15,4,0,369,7630,7999
2017-09-29 16:00:00-04:00,0,9,16,4,0,288,4946,5234
2017-09-29 17:00:00-04:00,0,9,17,4,0,230,3077,3307
2017-09-29 18:00:00-04:00,0,9,18,4,0,457,2700,3157
2017-09-29 19:00:00-04:00,0,9,19,4,0,1049,3640,4689
2017-09-29 20:00:00-04:00,0,9,20,4,0,1515,8679,10194
2017-09-29 21:00:00-04:00,0,9,21,4,0,1532,15509,17041
2017-09-29 22:00:00-04:00,0,9,22,4,0,1441,16703,18144
2017-09-29 23:00:00-04:00,0,9,23,4,0,1307,15767,17074
2017-09-30 00:00:00-04:00,0,9,0,5,0,1253,14746,15999
2017-09-30 01:00:00-04:00,0,9,1,5,0,1187,15111,16298
2017-09-30 02:00:00-04:00,0.0001,9,2,5,0,1427,15754,17181
2017-09-30 03:00:00-04:00,0,9,3,5,0,1700,15773,17473
2017-09-30 04:00:00-04:00,0,9,4,5,0,1917,17142,19059
2017-09-30 05:00:00-04:00,0,9,5,5,0,2241,16147,18388
2017-09-30 06:00:00-04:00,0,9,6,5,0,2423,14799,17222
2017-09-30 07:00:00-04:00,0,9,7,5,0,2328,18135,20463
2017-09-30 08:00:00-04:00,0,9,8,5,0,2080,20729,22809
2017-09-30 09:00:00-04:00,0,9,9,5,0,2080,20430,22510
2017-09-30 10:00:00-04:00,0,9,10,5,0,2053,18363,20416
2017-09-30 11:00:00-04:00,0,9,11,5,0,2047,17928,19975
2017-09-30 12:00:00-04:00,0,9,12,5,0,1887,17840,19727
2017-09-30 13:00:00-04:00,0.0001,9,13,5,0,1670,15796,17466
2017-09-30 14:00:00-04:00,0,9,14,5,0,1288,14659,15947
2017-09-30 15:00:00-04:00,0,9,15,5,0,1059,12428,13487
2017-09-30 16:00:00-04:00,0,9,16,5,0,780,10483,11263
2017-09-30 17:00:00-04:00,0,9,17,5,0,406,7507,7913
2017-09-30 18:00:00-04:00,0,9,18,5,0,407,5027,5434
2017-09-30 19:00:00-04:00,0,9,19,5,0,555,2604,3159
2017-09-30 20:00:00-04:00,0,9,20,5,0,789,3588,4377
2017-09-30 21:00:00-04:00,0,9,21,5,0,1164,5150,6314
2017-09-30 22:00:00-04:00,0,9,22,5,0,1364,8061,9425
2017-09-30 23:00:00-04:00,0,9,23,5,0,1468,11831,13299
